Date,WaterYear,WYday,Drought,Period_year,Period_year_cat,InflowTotal,InflowTotal_cum,InflowTotal_sum,Outflow,Outflow_cum,Outflow_sum
1974-10-01,1975,1,W,1,1,25969,25969,12476550,18352,18352,10028269
1974-10-02,1975,2,W,1,1,26144,52113,12476550,19503,37855,10028269
1974-10-03,1975,3,W,1,1,25655,77768,12476550,16916,54771,10028269
1974-10-04,1975,4,W,1,1,25387,103155,12476550,17625,72396,10028269
1974-10-05,1975,5,W,1,1,25515,128670,12476550,17926,90322,10028269
1974-10-06,1975,6,W,1,1,25407,154077,12476550,17829,108151,10028269
1974-10-07,1975,7,W,1,1,25181,179258,12476550,17869,126020,10028269
1974-10-08,1975,8,W,1,1,25248,204506,12476550,18846,144866,10028269
1974-10-09,1975,9,W,1,1,25370,229876,12476550,19024,163890,10028269
1974-10-10,1975,10,W,1,1,25200,255076,12476550,18604,182494,10028269
1974-10-11,1975,11,W,1,1,25121,280197,12476550,18850,201344,10028269
1974-10-12,1975,12,W,1,1,25283,305480,12476550,18270,219614,10028269
1974-10-13,1975,13,W,1,1,25067,330547,12476550,18738,238352,10028269
1974-10-14,1975,14,W,1,1,24466,355013,12476550,17671,256023,10028269
1974-10-15,1975,15,W,1,1,23874,378887,12476550,17010,273033,10028269
1974-10-16,1975,16,W,1,1,23244,402131,12476550,16416,289449,10028269
1974-10-17,1975,17,W,1,1,23496,425627,12476550,15607,305056,10028269
1974-10-18,1975,18,W,1,1,23623,449250,12476550,17725,322781,10028269
1974-10-19,1975,19,W,1,1,23124,472374,12476550,15333,338114,10028269
1974-10-20,1975,20,W,1,1,23140,495514,12476550,17375,355489,10028269
1974-10-21,1975,21,W,1,1,23472,518986,12476550,15420,370909,10028269
1974-10-22,1975,22,W,1,1,24132,543118,12476550,17971,388880,10028269
1974-10-23,1975,23,W,1,1,25531,568649,12476550,19373,408253,10028269
1974-10-24,1975,24,W,1,1,26111,594760,12476550,20655,428908,10028269
1974-10-25,1975,25,W,1,1,25110,619870,12476550,19588,448496,10028269
1974-10-26,1975,26,W,1,1,22738,642608,12476550,16884,465380,10028269
1974-10-27,1975,27,W,1,1,21747,664355,12476550,16579,481959,10028269
1974-10-28,1975,28,W,1,1,21853,686208,12476550,20321,502280,10028269
1974-10-29,1975,29,W,1,1,22739,708947,12476550,22551,524831,10028269
1974-10-30,1975,30,W,1,1,23482,732429,12476550,22580,547411,10028269
1974-10-31,1975,31,W,1,1,23913,756342,12476550,27000,574411,10028269
1974-11-01,1975,32,W,1,1,24462,780804,12476550,28726,603137,10028269
1974-11-02,1975,33,W,1,1,25005,805809,12476550,25070,628207,10028269
1974-11-03,1975,34,W,1,1,25681,831490,12476550,25806,654013,10028269
1974-11-04,1975,35,W,1,1,25268,856758,12476550,27086,681099,10028269
1974-11-05,1975,36,W,1,1,24091,880849,12476550,20342,701441,10028269
1974-11-06,1975,37,W,1,1,22486,903335,12476550,20710,722151,10028269
1974-11-07,1975,38,W,1,1,20961,924296,12476550,17791,739942,10028269
1974-11-08,1975,39,W,1,1,20883,945179,12476550,18227,758169,10028269
1974-11-09,1975,40,W,1,1,20597,965776,12476550,17182,775351,10028269
1974-11-10,1975,41,W,1,1,20882,986658,12476550,17849,793200,10028269
1974-11-11,1975,42,W,1,1,21414,1008072,12476550,19436,812636,10028269
1974-11-12,1975,43,W,1,1,22295,1030367,12476550,18119,830755,10028269
1974-11-13,1975,44,W,1,1,22858,1053225,12476550,19984,850739,10028269
1974-11-14,1975,45,W,1,1,23167,1076392,12476550,20060,870799,10028269
1974-11-15,1975,46,W,1,1,25107,1101499,12476550,20984,891783,10028269
1974-11-16,1975,47,W,1,1,26636,1128135,12476550,22936,914719,10028269
1974-11-17,1975,48,W,1,1,27197,1155332,12476550,21981,936700,10028269
1974-11-18,1975,49,W,1,1,27291,1182623,12476550,23188,959888,10028269
1974-11-19,1975,50,W,1,1,27685,1210308,12476550,24252,984140,10028269
1974-11-20,1975,51,W,1,1,28275,1238583,12476550,25204,1009344,10028269
1974-11-21,1975,52,W,1,1,28616,1267199,12476550,23649,1032993,10028269
1974-11-22,1975,53,W,1,1,30261,1297460,12476550,28161,1061154,10028269
1974-11-23,1975,54,W,1,1,31564,1329024,12476550,28964,1090118,10028269
1974-11-24,1975,55,W,1,1,32034,1361058,12476550,28318,1118436,10028269
1974-11-25,1975,56,W,1,1,32363,1393421,12476550,28822,1147258,10028269
1974-11-26,1975,57,W,1,1,32850,1426271,12476550,30835,1178093,10028269
1974-11-27,1975,58,W,1,1,33276,1459547,12476550,29888,1207981,10028269
1974-11-28,1975,59,W,1,1,33650,1493197,12476550,28315,1236296,10028269
1974-11-29,1975,60,W,1,1,33842,1527039,12476550,28994,1265290,10028269
1974-11-30,1975,61,W,1,1,33657,1560696,12476550,28859,1294149,10028269
1974-12-01,1975,62,W,1,1,33864,1594560,12476550,28288,1322437,10028269
1974-12-02,1975,63,W,1,1,34113,1628673,12476550,29564,1352001,10028269
1974-12-03,1975,64,W,1,1,34978,1663651,12476550,42109,1394110,10028269
1974-12-04,1975,65,W,1,1,36348,1699999,12476550,43658,1437768,10028269
1974-12-05,1975,66,W,1,1,40314,1740313,12476550,48172,1485940,10028269
1974-12-06,1975,67,W,1,1,44033,1784346,12476550,51882,1537822,10028269
1974-12-07,1975,68,W,1,1,42489,1826835,12476550,49211,1587033,10028269
1974-12-08,1975,69,W,1,1,39766,1866601,12476550,34477,1621510,10028269
1974-12-09,1975,70,W,1,1,37781,1904382,12476550,32969,1654479,10028269
1974-12-10,1975,71,W,1,1,36604,1940986,12476550,31174,1685653,10028269
1974-12-11,1975,72,W,1,1,34696,1975682,12476550,30556,1716209,10028269
1974-12-12,1975,73,W,1,1,32327,2008009,12476550,30064,1746273,10028269
1974-12-13,1975,74,W,1,1,30977,2038986,12476550,25930,1772203,10028269
1974-12-14,1975,75,W,1,1,30353,2069339,12476550,25143,1797346,10028269
1974-12-15,1975,76,W,1,1,29359,2098698,12476550,22948,1820294,10028269
1974-12-16,1975,77,W,1,1,28942,2127640,12476550,25331,1845625,10028269
1974-12-17,1975,78,W,1,1,28218,2155858,12476550,22196,1867821,10028269
1974-12-18,1975,79,W,1,1,27330,2183188,12476550,22015,1889836,10028269
1974-12-19,1975,80,W,1,1,26808,2209996,12476550,22130,1911966,10028269
1974-12-20,1975,81,W,1,1,25985,2235981,12476550,21502,1933468,10028269
1974-12-21,1975,82,W,1,1,25108,2261089,12476550,19315,1952783,10028269
1974-12-22,1975,83,W,1,1,24457,2285546,12476550,18085,1970868,10028269
1974-12-23,1975,84,W,1,1,23699,2309245,12476550,17529,1988397,10028269
1974-12-24,1975,85,W,1,1,23039,2332284,12476550,17889,2006286,10028269
1974-12-25,1975,86,W,1,1,23042,2355326,12476550,17494,2023780,10028269
1974-12-26,1975,87,W,1,1,23104,2378430,12476550,17581,2041361,10028269
1974-12-27,1975,88,W,1,1,22563,2400993,12476550,17265,2058626,10028269
1974-12-28,1975,89,W,1,1,24906,2425899,12476550,22194,2080820,10028269
1974-12-29,1975,90,W,1,1,27465,2453364,12476550,24925,2105745,10028269
1974-12-30,1975,91,W,1,1,30822,2484186,12476550,28490,2134235,10028269
1974-12-31,1975,92,W,1,1,28870,2513056,12476550,28463,2162698,10028269
1975-01-01,1975,93,W,1,1,26400,2539456,12476550,25737,2188435,10028269
1975-01-02,1975,94,W,1,1,24555,2564011,12476550,21258,2209693,10028269
1975-01-03,1975,95,W,1,1,22642,2586653,12476550,19031,2228724,10028269
1975-01-04,1975,96,W,1,1,22910,2609563,12476550,18168,2246892,10028269
1975-01-05,1975,97,W,1,1,23013,2632576,12476550,16759,2263651,10028269
1975-01-06,1975,98,W,1,1,22481,2655057,12476550,18164,2281815,10028269
1975-01-07,1975,99,W,1,1,22721,2677778,12476550,18829,2300644,10028269
1975-01-08,1975,100,W,1,1,26354,2704132,12476550,22119,2322763,10028269
1975-01-09,1975,101,W,1,1,30300,2734432,12476550,26894,2349657,10028269
1975-01-10,1975,102,W,1,1,32173,2766605,12476550,28475,2378132,10028269
1975-01-11,1975,103,W,1,1,31117,2797722,12476550,25537,2403669,10028269
1975-01-12,1975,104,W,1,1,28860,2826582,12476550,21430,2425099,10028269
1975-01-13,1975,105,W,1,1,26346,2852928,12476550,19156,2444255,10028269
1975-01-14,1975,106,W,1,1,24081,2877009,12476550,18309,2462564,10028269
1975-01-15,1975,107,W,1,1,23653,2900662,12476550,17398,2479962,10028269
1975-01-16,1975,108,W,1,1,23018,2923680,12476550,16925,2496887,10028269
1975-01-17,1975,109,W,1,1,22710,2946390,12476550,16674,2513561,10028269
1975-01-18,1975,110,W,1,1,22145,2968535,12476550,14033,2527594,10028269
1975-01-19,1975,111,W,1,1,21756,2990291,12476550,13250,2540844,10028269
1975-01-20,1975,112,W,1,1,20984,3011275,12476550,13256,2554100,10028269
1975-01-21,1975,113,W,1,1,20959,3032234,12476550,14086,2568186,10028269
1975-01-22,1975,114,W,1,1,22010,3054244,12476550,15498,2583684,10028269
1975-01-23,1975,115,W,1,1,22287,3076531,12476550,15691,2599375,10028269
1975-01-24,1975,116,W,1,1,22100,3098631,12476550,15689,2615064,10028269
1975-01-25,1975,117,W,1,1,21690,3120321,12476550,13920,2628984,10028269
1975-01-26,1975,118,W,1,1,21287,3141608,12476550,12539,2641523,10028269
1975-01-27,1975,119,W,1,1,20497,3162105,12476550,12439,2653962,10028269
1975-01-28,1975,120,W,1,1,19641,3181746,12476550,12783,2666745,10028269
1975-01-29,1975,121,W,1,1,20429,3202175,12476550,13478,2680223,10028269
1975-01-30,1975,122,W,1,1,20200,3222375,12476550,12365,2692588,10028269
1975-01-31,1975,123,W,1,1,20429,3242804,12476550,12276,2704864,10028269
1975-02-01,1975,124,W,1,1,23495,3266299,12476550,17868,2722732,10028269
1975-02-02,1975,125,W,1,1,31317,3297616,12476550,31513,2754245,10028269
1975-02-03,1975,126,W,1,1,44583,3342199,12476550,45345,2799590,10028269
1975-02-04,1975,127,W,1,1,48762,3390961,12476550,51595,2851185,10028269
1975-02-05,1975,128,W,1,1,50233,3441194,12476550,54090,2905275,10028269
1975-02-06,1975,129,W,1,1,46569,3487763,12476550,47677,2952952,10028269
1975-02-07,1975,130,W,1,1,43563,3531326,12476550,40132,2993084,10028269
1975-02-08,1975,131,W,1,1,43444,3574770,12476550,39702,3032786,10028269
1975-02-09,1975,132,W,1,1,54101,3628871,12476550,54516,3087302,10028269
1975-02-10,1975,133,W,1,1,64636,3693507,12476550,67911,3155213,10028269
1975-02-11,1975,134,W,1,1,65606,3759113,12476550,69523,3224736,10028269
1975-02-12,1975,135,W,1,1,66563,3825676,12476550,69727,3294463,10028269
1975-02-13,1975,136,W,1,1,78148,3903824,12476550,84966,3379429,10028269
1975-02-14,1975,137,W,1,1,92584,3996408,12476550,92127,3471556,10028269
1975-02-15,1975,138,W,1,1,101520,4097928,12476550,97271,3568827,10028269
1975-02-16,1975,139,W,1,1,104568,4202496,12476550,100709,3669536,10028269
1975-02-17,1975,140,W,1,1,93941,4296437,12476550,90374,3759910,10028269
1975-02-18,1975,141,W,1,1,82077,4378514,12476550,75428,3835338,10028269
1975-02-19,1975,142,W,1,1,74733,4453247,12476550,67578,3902916,10028269
1975-02-20,1975,143,W,1,1,68394,4521641,12476550,60500,3963416,10028269
1975-02-21,1975,144,W,1,1,63087,4584728,12476550,56448,4019864,10028269
1975-02-22,1975,145,W,1,1,59078,4643806,12476550,52070,4071934,10028269
1975-02-23,1975,146,W,1,1,55658,4699464,12476550,46761,4118695,10028269
1975-02-24,1975,147,W,1,1,52174,4751638,12476550,44506,4163201,10028269
1975-02-25,1975,148,W,1,1,48514,4800152,12476550,42809,4206010,10028269
1975-02-26,1975,149,W,1,1,46524,4846676,12476550,39199,4245209,10028269
1975-02-27,1975,150,W,1,1,43594,4890270,12476550,34674,4279883,10028269
1975-02-28,1975,151,W,1,1,39299,4929569,12476550,30231,4310114,10028269
1975-03-01,1975,152,W,1,1,38037,4967606,12476550,27781,4337895,10028269
1975-03-02,1975,153,W,1,1,35775,5003381,12476550,24953,4362848,10028269
1975-03-03,1975,154,W,1,1,35122,5038503,12476550,25306,4388154,10028269
1975-03-04,1975,155,W,1,1,33934,5072437,12476550,26404,4414558,10028269
1975-03-05,1975,156,W,1,1,33890,5106327,12476550,26165,4440723,10028269
1975-03-06,1975,157,W,1,1,34068,5140395,12476550,26310,4467033,10028269
1975-03-07,1975,158,W,1,1,34106,5174501,12476550,27305,4494338,10028269
1975-03-08,1975,159,W,1,1,40943,5215444,12476550,37356,4531694,10028269
1975-03-09,1975,160,W,1,1,51279,5266723,12476550,48031,4579725,10028269
1975-03-10,1975,161,W,1,1,55181,5321904,12476550,53786,4633511,10028269
1975-03-11,1975,162,W,1,1,59992,5381896,12476550,57739,4691250,10028269
1975-03-12,1975,163,W,1,1,67207,5449103,12476550,63588,4754838,10028269
1975-03-13,1975,164,W,1,1,70548,5519651,12476550,64771,4819609,10028269
1975-03-14,1975,165,W,1,1,72998,5592649,12476550,72519,4892128,10028269
1975-03-15,1975,166,W,1,1,70777,5663426,12476550,70715,4962843,10028269
1975-03-16,1975,167,W,1,1,67566,5730992,12476550,67885,5030728,10028269
1975-03-17,1975,168,W,1,1,64758,5795750,12476550,66405,5097133,10028269
1975-03-18,1975,169,W,1,1,62287,5858037,12476550,63933,5161066,10028269
1975-03-19,1975,170,W,1,1,62857,5920894,12476550,58875,5219941,10028269
1975-03-20,1975,171,W,1,1,66967,5987861,12476550,60197,5280138,10028269
1975-03-21,1975,172,W,1,1,74252,6062113,12476550,67709,5347847,10028269
1975-03-22,1975,173,W,1,1,93170,6155283,12476550,90834,5438681,10028269
1975-03-23,1975,174,W,1,1,111207,6266490,12476550,107778,5546459,10028269
1975-03-24,1975,175,W,1,1,114673,6381163,12476550,112347,5658806,10028269
1975-03-25,1975,176,W,1,1,121317,6502480,12476550,119908,5778714,10028269
1975-03-26,1975,177,W,1,1,127364,6629844,12476550,127625,5906339,10028269
1975-03-27,1975,178,W,1,1,119079,6748923,12476550,113393,6019732,10028269
1975-03-28,1975,179,W,1,1,111911,6860834,12476550,106516,6126248,10028269
1975-03-29,1975,180,W,1,1,102410,6963244,12476550,94922,6221170,10028269
1975-03-30,1975,181,W,1,1,92991,7056235,12476550,83138,6304308,10028269
1975-03-31,1975,182,W,1,1,85523,7141758,12476550,77664,6381972,10028269
1975-04-01,1975,183,W,1,1,75745,7217503,12476550,67833,6449805,10028269
1975-04-02,1975,184,W,1,1,67230,7284733,12476550,59476,6509281,10028269
1975-04-03,1975,185,W,1,1,59372,7344105,12476550,51187,6560468,10028269
1975-04-04,1975,186,W,1,1,52808,7396913,12476550,45639,6606107,10028269
1975-04-05,1975,187,W,1,1,49685,7446598,12476550,43544,6649651,10028269
1975-04-06,1975,188,W,1,1,49201,7495799,12476550,42608,6692259,10028269
1975-04-07,1975,189,W,1,1,49203,7545002,12476550,43644,6735903,10028269
1975-04-08,1975,190,W,1,1,48054,7593056,12476550,44682,6780585,10028269
1975-04-09,1975,191,W,1,1,46956,7640012,12476550,43153,6823738,10028269
1975-04-10,1975,192,W,1,1,46227,7686239,12476550,40210,6863948,10028269
1975-04-11,1975,193,W,1,1,43393,7729632,12476550,37501,6901449,10028269
1975-04-12,1975,194,W,1,1,40130,7769762,12476550,32635,6934084,10028269
1975-04-13,1975,195,W,1,1,37890,7807652,12476550,29702,6963786,10028269
1975-04-14,1975,196,W,1,1,36750,7844402,12476550,29603,6993389,10028269
1975-04-15,1975,197,W,1,1,35701,7880103,12476550,29789,7023178,10028269
1975-04-16,1975,198,W,1,1,35817,7915920,12476550,30874,7054052,10028269
1975-04-17,1975,199,W,1,1,36311,7952231,12476550,31548,7085600,10028269
1975-04-18,1975,200,W,1,1,34883,7987114,12476550,30497,7116097,10028269
1975-04-19,1975,201,W,1,1,34086,8021200,12476550,29119,7145216,10028269
1975-04-20,1975,202,W,1,1,33553,8054753,12476550,27037,7172253,10028269
1975-04-21,1975,203,W,1,1,32610,8087363,12476550,25316,7197569,10028269
1975-04-22,1975,204,W,1,1,31596,8118959,12476550,23284,7220853,10028269
1975-04-23,1975,205,W,1,1,30575,8149534,12476550,21928,7242781,10028269
1975-04-24,1975,206,W,1,1,30170,8179704,12476550,21329,7264110,10028269
1975-04-25,1975,207,W,1,1,31407,8211111,12476550,22938,7287048,10028269
1975-04-26,1975,208,W,1,1,33629,8244740,12476550,24474,7311522,10028269
1975-04-27,1975,209,W,1,1,35308,8280048,12476550,26739,7338261,10028269
1975-04-28,1975,210,W,1,1,35660,8315708,12476550,26083,7364344,10028269
1975-04-29,1975,211,W,1,1,35476,8351184,12476550,26775,7391119,10028269
1975-04-30,1975,212,W,1,1,34758,8385942,12476550,26431,7417550,10028269
1975-05-01,1975,213,W,1,1,34046,8419988,12476550,25735,7443285,10028269
1975-05-02,1975,214,W,1,1,33911,8453899,12476550,25461,7468746,10028269
1975-05-03,1975,215,W,1,1,34369,8488268,12476550,24553,7493299,10028269
1975-05-04,1975,216,W,1,1,36298,8524566,12476550,26732,7520031,10028269
1975-05-05,1975,217,W,1,1,37493,8562059,12476550,27882,7547913,10028269
1975-05-06,1975,218,W,1,1,38393,8600452,12476550,28784,7576697,10028269
1975-05-07,1975,219,W,1,1,37976,8638428,12476550,28526,7605223,10028269
1975-05-08,1975,220,W,1,1,37017,8675445,12476550,27310,7632533,10028269
1975-05-09,1975,221,W,1,1,36378,8711823,12476550,26853,7659386,10028269
1975-05-10,1975,222,W,1,1,36832,8748655,12476550,26002,7685388,10028269
1975-05-11,1975,223,W,1,1,37326,8785981,12476550,24789,7710177,10028269
1975-05-12,1975,224,W,1,1,38015,8823996,12476550,27130,7737307,10028269
1975-05-13,1975,225,W,1,1,38496,8862492,12476550,28948,7766255,10028269
1975-05-14,1975,226,W,1,1,39949,8902441,12476550,30533,7796788,10028269
1975-05-15,1975,227,W,1,1,40698,8943139,12476550,34335,7831123,10028269
1975-05-16,1975,228,W,1,1,41245,8984384,12476550,34930,7866053,10028269
1975-05-17,1975,229,W,1,1,41927,9026311,12476550,35602,7901655,10028269
1975-05-18,1975,230,W,1,1,41821,9068132,12476550,35586,7937241,10028269
1975-05-19,1975,231,W,1,1,41266,9109398,12476550,35272,7972513,10028269
1975-05-20,1975,232,W,1,1,41599,9150997,12476550,35348,8007861,10028269
1975-05-21,1975,233,W,1,1,42872,9193869,12476550,36449,8044310,10028269
1975-05-22,1975,234,W,1,1,41381,9235250,12476550,35049,8079359,10028269
1975-05-23,1975,235,W,1,1,38309,9273559,12476550,31700,8111059,10028269
1975-05-24,1975,236,W,1,1,34985,9308544,12476550,28370,8139429,10028269
1975-05-25,1975,237,W,1,1,32158,9340702,12476550,25416,8164845,10028269
1975-05-26,1975,238,W,1,1,30993,9371695,12476550,24407,8189252,10028269
1975-05-27,1975,239,W,1,1,30530,9402225,12476550,23947,8213199,10028269
1975-05-28,1975,240,W,1,1,30905,9433130,12476550,24108,8237307,10028269
1975-05-29,1975,241,W,1,1,31491,9464621,12476550,23906,8261213,10028269
1975-05-30,1975,242,W,1,1,31180,9495801,12476550,24516,8285729,10028269
1975-05-31,1975,243,W,1,1,31314,9527115,12476550,24491,8310220,10028269
1975-06-01,1975,244,W,1,1,31896,9559011,12476550,24905,8335125,10028269
1975-06-02,1975,245,W,1,1,32567,9591578,12476550,25249,8360374,10028269
1975-06-03,1975,246,W,1,1,33481,9625059,12476550,25768,8386142,10028269
1975-06-04,1975,247,W,1,1,34197,9659256,12476550,26492,8412634,10028269
1975-06-05,1975,248,W,1,1,34745,9694001,12476550,26877,8439511,10028269
1975-06-06,1975,249,W,1,1,35821,9729822,12476550,27813,8467324,10028269
1975-06-07,1975,250,W,1,1,38043,9767865,12476550,30109,8497433,10028269
1975-06-08,1975,251,W,1,1,39388,9807253,12476550,31324,8528757,10028269
1975-06-09,1975,252,W,1,1,40238,9847491,12476550,32124,8560881,10028269
1975-06-10,1975,253,W,1,1,40352,9887843,12476550,32258,8593139,10028269
1975-06-11,1975,254,W,1,1,39684,9927527,12476550,31516,8624655,10028269
1975-06-12,1975,255,W,1,1,38244,9965771,12476550,30011,8654666,10028269
1975-06-13,1975,256,W,1,1,35222,10000993,12476550,26947,8681613,10028269
1975-06-14,1975,257,W,1,1,33198,10034191,12476550,24890,8706503,10028269
1975-06-15,1975,258,W,1,1,33105,10067296,12476550,24732,8731235,10028269
1975-06-16,1975,259,W,1,1,33202,10100498,12476550,24850,8756085,10028269
1975-06-17,1975,260,W,1,1,33218,10133716,12476550,24772,8780857,10028269
1975-06-18,1975,261,W,1,1,32836,10166552,12476550,24351,8805208,10028269
1975-06-19,1975,262,W,1,1,31283,10197835,12476550,22772,8827980,10028269
1975-06-20,1975,263,W,1,1,29130,10226965,12476550,20540,8848520,10028269
1975-06-21,1975,264,W,1,1,26108,10253073,12476550,17570,8866090,10028269
1975-06-22,1975,265,W,1,1,24354,10277427,12476550,15739,8881829,10028269
1975-06-23,1975,266,W,1,1,23579,10301006,12476550,15390,8897219,10028269
1975-06-24,1975,267,W,1,1,22695,10323701,12476550,13995,8911214,10028269
1975-06-25,1975,268,W,1,1,21839,10345540,12476550,13329,8924543,10028269
1975-06-26,1975,269,W,1,1,21605,10367145,12476550,12960,8937503,10028269
1975-06-27,1975,270,W,1,1,21843,10388988,12476550,13576,8951079,10028269
1975-06-28,1975,271,W,1,1,20814,10409802,12476550,12405,8963484,10028269
1975-06-29,1975,272,W,1,1,19966,10429768,12476550,10915,8974399,10028269
1975-06-30,1975,273,W,1,1,19974,10449742,12476550,11066,8985465,10028269
1975-07-01,1975,274,W,1,1,19485,10469227,12476550,10043,8995508,10028269
1975-07-02,1975,275,W,1,1,19055,10488282,12476550,9565,9005073,10028269
1975-07-03,1975,276,W,1,1,18987,10507269,12476550,9473,9014546,10028269
1975-07-04,1975,277,W,1,1,18979,10526248,12476550,9377,9023923,10028269
1975-07-05,1975,278,W,1,1,18910,10545158,12476550,9184,9033107,10028269
1975-07-06,1975,279,W,1,1,18875,10564033,12476550,9227,9042334,10028269
1975-07-07,1975,280,W,1,1,18769,10582802,12476550,9148,9051482,10028269
1975-07-08,1975,281,W,1,1,18703,10601505,12476550,9120,9060602,10028269
1975-07-09,1975,282,W,1,1,18705,10620210,12476550,9167,9069769,10028269
1975-07-10,1975,283,W,1,1,18449,10638659,12476550,8890,9078659,10028269
1975-07-11,1975,284,W,1,1,17893,10656552,12476550,8179,9086838,10028269
1975-07-12,1975,285,W,1,1,18519,10675071,12476550,8921,9095759,10028269
1975-07-13,1975,286,W,1,1,19644,10694715,12476550,10139,9105898,10028269
1975-07-14,1975,287,W,1,1,20792,10715507,12476550,11172,9117070,10028269
1975-07-15,1975,288,W,1,1,21395,10736902,12476550,12012,9129082,10028269
1975-07-16,1975,289,W,1,1,21490,10758392,12476550,12626,9141708,10028269
1975-07-17,1975,290,W,1,1,21988,10780380,12476550,13061,9154769,10028269
1975-07-18,1975,291,W,1,1,22715,10803095,12476550,13723,9168492,10028269
1975-07-19,1975,292,W,1,1,22608,10825703,12476550,13780,9182272,10028269
1975-07-20,1975,293,W,1,1,22335,10848038,12476550,13335,9195607,10028269
1975-07-21,1975,294,W,1,1,22311,10870349,12476550,13125,9208732,10028269
1975-07-22,1975,295,W,1,1,22070,10892419,12476550,12557,9221289,10028269
1975-07-23,1975,296,W,1,1,22279,10914698,12476550,12784,9234073,10028269
1975-07-24,1975,297,W,1,1,22078,10936776,12476550,12694,9246767,10028269
1975-07-25,1975,298,W,1,1,21747,10958523,12476550,12426,9259193,10028269
1975-07-26,1975,299,W,1,1,21596,10980119,12476550,11953,9271146,10028269
1975-07-27,1975,300,W,1,1,21756,11001875,12476550,12268,9283414,10028269
1975-07-28,1975,301,W,1,1,21415,11023290,12476550,12061,9295475,10028269
1975-07-29,1975,302,W,1,1,21442,11044732,12476550,11523,9306998,10028269
1975-07-30,1975,303,W,1,1,21355,11066087,12476550,11795,9318793,10028269
1975-07-31,1975,304,W,1,1,21175,11087262,12476550,11674,9330467,10028269
1975-08-01,1975,305,W,1,1,21039,11108301,12476550,9232,9339699,10028269
1975-08-02,1975,306,W,1,1,21094,11129395,12476550,7783,9347482,10028269
1975-08-03,1975,307,W,1,1,20936,11150331,12476550,6162,9353644,10028269
1975-08-04,1975,308,W,1,1,20651,11170982,12476550,7380,9361024,10028269
1975-08-05,1975,309,W,1,1,20821,11191803,12476550,7872,9368896,10028269
1975-08-06,1975,310,W,1,1,21059,11212862,12476550,9208,9378104,10028269
1975-08-07,1975,311,W,1,1,20895,11233757,12476550,8563,9386667,10028269
1975-08-08,1975,312,W,1,1,20623,11254380,12476550,8679,9395346,10028269
1975-08-09,1975,313,W,1,1,20671,11275051,12476550,6887,9402233,10028269
1975-08-10,1975,314,W,1,1,20696,11295747,12476550,6277,9408510,10028269
1975-08-11,1975,315,W,1,1,20571,11316318,12476550,6573,9415083,10028269
1975-08-12,1975,316,W,1,1,20331,11336649,12476550,7509,9422592,10028269
1975-08-13,1975,317,W,1,1,20251,11356900,12476550,7766,9430358,10028269
1975-08-14,1975,318,W,1,1,20427,11377327,12476550,7374,9437732,10028269
1975-08-15,1975,319,W,1,1,20487,11397814,12476550,7689,9445421,10028269
1975-08-16,1975,320,W,1,1,20269,11418083,12476550,7031,9452452,10028269
1975-08-17,1975,321,W,1,1,20312,11438395,12476550,5840,9458292,10028269
1975-08-18,1975,322,W,1,1,21360,11459755,12476550,10471,9468763,10028269
1975-08-19,1975,323,W,1,1,22324,11482079,12476550,13577,9482340,10028269
1975-08-20,1975,324,W,1,1,23150,11505229,12476550,14155,9496495,10028269
1975-08-21,1975,325,W,1,1,23604,11528833,12476550,14521,9511016,10028269
1975-08-22,1975,326,W,1,1,23894,11552727,12476550,15034,9526050,10028269
1975-08-23,1975,327,W,1,1,23773,11576500,12476550,12125,9538175,10028269
1975-08-24,1975,328,W,1,1,23548,11600048,12476550,9453,9547628,10028269
1975-08-25,1975,329,W,1,1,23134,11623182,12476550,10745,9558373,10028269
1975-08-26,1975,330,W,1,1,22869,11646051,12476550,11271,9569644,10028269
1975-08-27,1975,331,W,1,1,22913,11668964,12476550,12132,9581776,10028269
1975-08-28,1975,332,W,1,1,22812,11691776,12476550,12026,9593802,10028269
1975-08-29,1975,333,W,1,1,22836,11714612,12476550,11626,9605428,10028269
1975-08-30,1975,334,W,1,1,23021,11737633,12476550,10260,9615688,10028269
1975-08-31,1975,335,W,1,1,23754,11761387,12476550,10003,9625691,10028269
1975-09-01,1975,336,W,1,1,24521,11785908,12476550,12815,9638506,10028269
1975-09-02,1975,337,W,1,1,24253,11810161,12476550,12736,9651242,10028269
1975-09-03,1975,338,W,1,1,24425,11834586,12476550,12979,9664221,10028269
1975-09-04,1975,339,W,1,1,24623,11859209,12476550,13151,9677372,10028269
1975-09-05,1975,340,W,1,1,24296,11883505,12476550,12777,9690149,10028269
1975-09-06,1975,341,W,1,1,24344,11907849,12476550,11910,9702059,10028269
1975-09-07,1975,342,W,1,1,24398,11932247,12476550,10911,9712970,10028269
1975-09-08,1975,343,W,1,1,24226,11956473,12476550,12481,9725451,10028269
1975-09-09,1975,344,W,1,1,23612,11980085,12476550,12548,9737999,10028269
1975-09-10,1975,345,W,1,1,23811,12003896,12476550,12877,9750876,10028269
1975-09-11,1975,346,W,1,1,24387,12028283,12476550,13618,9764494,10028269
1975-09-12,1975,347,W,1,1,24883,12053166,12476550,14652,9779146,10028269
1975-09-13,1975,348,W,1,1,25098,12078264,12476550,14431,9793577,10028269
1975-09-14,1975,349,W,1,1,25095,12103359,12476550,12839,9806416,10028269
1975-09-15,1975,350,W,1,1,25324,12128683,12476550,15127,9821543,10028269
1975-09-16,1975,351,W,1,1,25315,12153998,12476550,16038,9837581,10028269
1975-09-17,1975,352,W,1,1,24908,12178906,12476550,15453,9853034,10028269
1975-09-18,1975,353,W,1,1,24525,12203431,12476550,14786,9867820,10028269
1975-09-19,1975,354,W,1,1,24448,12227879,12476550,14996,9882816,10028269
1975-09-20,1975,355,W,1,1,24504,12252383,12476550,14109,9896925,10028269
1975-09-21,1975,356,W,1,1,23853,12276236,12476550,11659,9908584,10028269
1975-09-22,1975,357,W,1,1,22976,12299212,12476550,12475,9921059,10028269
1975-09-23,1975,358,W,1,1,22683,12321895,12476550,12880,9933939,10028269
1975-09-24,1975,359,W,1,1,22262,12344157,12476550,12307,9946246,10028269
1975-09-25,1975,360,W,1,1,22206,12366363,12476550,13082,9959328,10028269
1975-09-26,1975,361,W,1,1,22055,12388418,12476550,13647,9972975,10028269
1975-09-27,1975,362,W,1,1,22109,12410527,12476550,13348,9986323,10028269
1975-09-28,1975,363,W,1,1,21998,12432525,12476550,12933,9999256,10028269
1975-09-29,1975,364,W,1,1,22062,12454587,12476550,14715,10013971,10028269
1975-09-30,1975,365,W,1,1,21963,12476550,12476550,14298,10028269,10028269
1975-10-01,1976,1,D,1,1,22301,22301,6440274,14158,14158,3297469
1975-10-02,1976,2,D,1,1,22480,44781,6440274,14376,28534,3297469
1975-10-03,1976,3,D,1,1,22342,67123,6440274,14502,43036,3297469
1975-10-04,1976,4,D,1,1,22744,89867,6440274,14394,57430,3297469
1975-10-05,1976,5,D,1,1,22523,112390,6440274,12275,69705,3297469
1975-10-06,1976,6,D,1,1,22829,135219,6440274,13067,82772,3297469
1975-10-07,1976,7,D,1,1,22476,157695,6440274,12912,95684,3297469
1975-10-08,1976,8,D,1,1,21518,179213,6440274,11948,107632,3297469
1975-10-09,1976,9,D,1,1,22838,202051,6440274,13048,120680,3297469
1975-10-10,1976,10,D,1,1,24550,226601,6440274,16417,137097,3297469
1975-10-11,1976,11,D,1,1,25290,251891,6440274,19947,157044,3297469
1975-10-12,1976,12,D,1,1,25992,277883,6440274,20694,177738,3297469
1975-10-13,1976,13,D,1,1,26539,304422,6440274,22195,199933,3297469
1975-10-14,1976,14,D,1,1,25986,330408,6440274,21574,221507,3297469
1975-10-15,1976,15,D,1,1,25600,356008,6440274,20373,241880,3297469
1975-10-16,1976,16,D,1,1,25698,381706,6440274,16824,258704,3297469
1975-10-17,1976,17,D,1,1,25808,407514,6440274,16074,274778,3297469
1975-10-18,1976,18,D,1,1,25493,433007,6440274,15357,290135,3297469
1975-10-19,1976,19,D,1,1,25481,458488,6440274,14995,305130,3297469
1975-10-20,1976,20,D,1,1,25420,483908,6440274,14811,319941,3297469
1975-10-21,1976,21,D,1,1,25006,508914,6440274,14912,334853,3297469
1975-10-22,1976,22,D,1,1,24967,533881,6440274,16398,351251,3297469
1975-10-23,1976,23,D,1,1,24629,558510,6440274,15924,367175,3297469
1975-10-24,1976,24,D,1,1,24592,583102,6440274,15389,382564,3297469
1975-10-25,1976,25,D,1,1,24609,607711,6440274,14427,396991,3297469
1975-10-26,1976,26,D,1,1,24924,632635,6440274,16293,413284,3297469
1975-10-27,1976,27,D,1,1,24846,657481,6440274,19649,432933,3297469
1975-10-28,1976,28,D,1,1,25465,682946,6440274,21674,454607,3297469
1975-10-29,1976,29,D,1,1,26454,709400,6440274,20888,475495,3297469
1975-10-30,1976,30,D,1,1,27372,736772,6440274,25490,500985,3297469
1975-10-31,1976,31,D,1,1,27278,764050,6440274,22944,523929,3297469
1975-11-01,1976,32,D,1,1,27907,791957,6440274,20878,544807,3297469
1975-11-02,1976,33,D,1,1,28623,820580,6440274,21223,566030,3297469
1975-11-03,1976,34,D,1,1,27972,848552,6440274,20773,586803,3297469
1975-11-04,1976,35,D,1,1,27036,875588,6440274,18002,604805,3297469
1975-11-05,1976,36,D,1,1,26323,901911,6440274,16661,621466,3297469
1975-11-06,1976,37,D,1,1,25165,927076,6440274,15321,636787,3297469
1975-11-07,1976,38,D,1,1,23493,950569,6440274,14370,651157,3297469
1975-11-08,1976,39,D,1,1,22390,972959,6440274,12816,663973,3297469
1975-11-09,1976,40,D,1,1,22259,995218,6440274,11771,675744,3297469
1975-11-10,1976,41,D,1,1,22860,1018078,6440274,14352,690096,3297469
1975-11-11,1976,42,D,1,1,23901,1041979,6440274,16272,706368,3297469
1975-11-12,1976,43,D,1,1,24488,1066467,6440274,16315,722683,3297469
1975-11-13,1976,44,D,1,1,24804,1091271,6440274,16133,738816,3297469
1975-11-14,1976,45,D,1,1,24845,1116116,6440274,16060,754876,3297469
1975-11-15,1976,46,D,1,1,24971,1141087,6440274,14971,769847,3297469
1975-11-16,1976,47,D,1,1,25305,1166392,6440274,14857,784704,3297469
1975-11-17,1976,48,D,1,1,26270,1192662,6440274,17045,801749,3297469
1975-11-18,1976,49,D,1,1,27294,1219956,6440274,18813,820562,3297469
1975-11-19,1976,50,D,1,1,27491,1247447,6440274,18647,839209,3297469
1975-11-20,1976,51,D,1,1,27179,1274626,6440274,17467,856676,3297469
1975-11-21,1976,52,D,1,1,26807,1301433,6440274,16795,873471,3297469
1975-11-22,1976,53,D,1,1,27371,1328804,6440274,17411,890882,3297469
1975-11-23,1976,54,D,1,1,28671,1357475,6440274,18133,909015,3297469
1975-11-24,1976,55,D,1,1,29838,1387313,6440274,20395,929410,3297469
1975-11-25,1976,56,D,1,1,30518,1417831,6440274,21486,950896,3297469
1975-11-26,1976,57,D,1,1,31138,1448969,6440274,22110,973006,3297469
1975-11-27,1976,58,D,1,1,31486,1480455,6440274,21734,994740,3297469
1975-11-28,1976,59,D,1,1,31706,1512161,6440274,21994,1016734,3297469
1975-11-29,1976,60,D,1,1,31752,1543913,6440274,22499,1039233,3297469
1975-11-30,1976,61,D,1,1,31906,1575819,6440274,22330,1061563,3297469
1975-12-01,1976,62,D,1,1,31896,1607715,6440274,22224,1083787,3297469
1975-12-02,1976,63,D,1,1,31734,1639449,6440274,22458,1106245,3297469
1975-12-03,1976,64,D,1,1,31652,1671101,6440274,22430,1128675,3297469
1975-12-04,1976,65,D,1,1,31785,1702886,6440274,22685,1151360,3297469
1975-12-05,1976,66,D,1,1,31878,1734764,6440274,22435,1173795,3297469
1975-12-06,1976,67,D,1,1,32403,1767167,6440274,23067,1196862,3297469
1975-12-07,1976,68,D,1,1,33381,1800548,6440274,22890,1219752,3297469
1975-12-08,1976,69,D,1,1,34593,1835141,6440274,26024,1245776,3297469
1975-12-09,1976,70,D,1,1,33989,1869130,6440274,25139,1270915,3297469
1975-12-10,1976,71,D,1,1,32921,1902051,6440274,22742,1293657,3297469
1975-12-11,1976,72,D,1,1,32137,1934188,6440274,21670,1315327,3297469
1975-12-12,1976,73,D,1,1,31564,1965752,6440274,21225,1336552,3297469
1975-12-13,1976,74,D,1,1,31167,1996919,6440274,21368,1357920,3297469
1975-12-14,1976,75,D,1,1,31218,2028137,6440274,21360,1379280,3297469
1975-12-15,1976,76,D,1,1,31189,2059326,6440274,21251,1400531,3297469
1975-12-16,1976,77,D,1,1,30651,2089977,6440274,20884,1421415,3297469
1975-12-17,1976,78,D,1,1,30225,2120202,6440274,19724,1441139,3297469
1975-12-18,1976,79,D,1,1,29982,2150184,6440274,20445,1461584,3297469
1975-12-19,1976,80,D,1,1,29593,2179777,6440274,20800,1482384,3297469
1975-12-20,1976,81,D,1,1,29124,2208901,6440274,18752,1501136,3297469
1975-12-21,1976,82,D,1,1,28697,2237598,6440274,18049,1519185,3297469
1975-12-22,1976,83,D,1,1,28556,2266154,6440274,19081,1538266,3297469
1975-12-23,1976,84,D,1,1,27100,2293254,6440274,17730,1555996,3297469
1975-12-24,1976,85,D,1,1,26849,2320103,6440274,18160,1574156,3297469
1975-12-25,1976,86,D,1,1,26458,2346561,6440274,17484,1591640,3297469
1975-12-26,1976,87,D,1,1,25863,2372424,6440274,17028,1608668,3297469
1975-12-27,1976,88,D,1,1,25050,2397474,6440274,14515,1623183,3297469
1975-12-28,1976,89,D,1,1,25400,2422874,6440274,14593,1637776,3297469
1975-12-29,1976,90,D,1,1,25080,2447954,6440274,14731,1652507,3297469
1975-12-30,1976,91,D,1,1,23727,2471681,6440274,13600,1666107,3297469
1975-12-31,1976,92,D,1,1,24028,2495709,6440274,14026,1680133,3297469
1976-01-01,1976,93,D,1,1,24161,2519870,6440274,15261,1695394,3297469
1976-01-02,1976,94,D,1,1,23940,2543810,6440274,15088,1710482,3297469
1976-01-03,1976,95,D,1,1,22756,2566566,6440274,11984,1722466,3297469
1976-01-04,1976,96,D,1,1,22766,2589332,6440274,11312,1733778,3297469
1976-01-05,1976,97,D,1,1,22170,2611502,6440274,11761,1745539,3297469
1976-01-06,1976,98,D,1,1,21302,2632804,6440274,12101,1757640,3297469
1976-01-07,1976,99,D,1,1,21606,2654410,6440274,12664,1770304,3297469
1976-01-08,1976,100,D,1,1,21280,2675690,6440274,12122,1782426,3297469
1976-01-09,1976,101,D,1,1,20721,2696411,6440274,12471,1794897,3297469
1976-01-10,1976,102,D,1,1,20478,2716889,6440274,13518,1808415,3297469
1976-01-11,1976,103,D,1,1,20823,2737712,6440274,12209,1820624,3297469
1976-01-12,1976,104,D,1,1,20679,2758391,6440274,11454,1832078,3297469
1976-01-13,1976,105,D,1,1,19458,2777849,6440274,10911,1842989,3297469
1976-01-14,1976,106,D,1,1,19420,2797269,6440274,11350,1854339,3297469
1976-01-15,1976,107,D,1,1,18854,2816123,6440274,9427,1863766,3297469
1976-01-16,1976,108,D,1,1,18500,2834623,6440274,9199,1872965,3297469
1976-01-17,1976,109,D,1,1,18027,2852650,6440274,8239,1881204,3297469
1976-01-18,1976,110,D,1,1,17630,2870280,6440274,7424,1888628,3297469
1976-01-19,1976,111,D,1,1,17504,2887784,6440274,8404,1897032,3297469
1976-01-20,1976,112,D,1,1,17192,2904976,6440274,8988,1906020,3297469
1976-01-21,1976,113,D,1,1,17834,2922810,6440274,9192,1915212,3297469
1976-01-22,1976,114,D,1,1,17840,2940650,6440274,9206,1924418,3297469
1976-01-23,1976,115,D,1,1,17387,2958037,6440274,7846,1932264,3297469
1976-01-24,1976,116,D,1,1,16294,2974331,6440274,5653,1937917,3297469
1976-01-25,1976,117,D,1,1,15377,2989708,6440274,4872,1942789,3297469
1976-01-26,1976,118,D,1,1,14735,3004443,6440274,4390,1947179,3297469
1976-01-27,1976,119,D,1,1,14265,3018708,6440274,5150,1952329,3297469
1976-01-28,1976,120,D,1,1,13781,3032489,6440274,4253,1956582,3297469
1976-01-29,1976,121,D,1,1,13515,3046004,6440274,3877,1960459,3297469
1976-01-30,1976,122,D,1,1,13364,3059368,6440274,4067,1964526,3297469
1976-01-31,1976,123,D,1,1,13408,3072776,6440274,4211,1968737,3297469
1976-02-01,1976,124,D,1,1,13576,3086352,6440274,4413,1973150,3297469
1976-02-02,1976,125,D,1,1,13935,3100287,6440274,4641,1977791,3297469
1976-02-03,1976,126,D,1,1,13871,3114158,6440274,4661,1982452,3297469
1976-02-04,1976,127,D,1,1,14222,3128380,6440274,5735,1988187,3297469
1976-02-05,1976,128,D,1,1,14548,3142928,6440274,6986,1995173,3297469
1976-02-06,1976,129,D,1,1,15233,3158161,6440274,8614,2003787,3297469
1976-02-07,1976,130,D,1,1,15527,3173688,6440274,8981,2012768,3297469
1976-02-08,1976,131,D,1,1,15425,3189113,6440274,9432,2022200,3297469
1976-02-09,1976,132,D,1,1,15296,3204409,6440274,9797,2031997,3297469
1976-02-10,1976,133,D,1,1,15297,3219706,6440274,10758,2042755,3297469
1976-02-11,1976,134,D,1,1,14655,3234361,6440274,7873,2050628,3297469
1976-02-12,1976,135,D,1,1,14272,3248633,6440274,7436,2058064,3297469
1976-02-13,1976,136,D,1,1,14079,3262712,6440274,6778,2064842,3297469
1976-02-14,1976,137,D,1,1,14443,3277155,6440274,8913,2073755,3297469
1976-02-15,1976,138,D,1,1,14727,3291882,6440274,9853,2083608,3297469
1976-02-16,1976,139,D,1,1,15144,3307026,6440274,9876,2093484,3297469
1976-02-17,1976,140,D,1,1,15774,3322800,6440274,10957,2104441,3297469
1976-02-18,1976,141,D,1,1,16291,3339091,6440274,10513,2114954,3297469
1976-02-19,1976,142,D,1,1,16585,3355676,6440274,8713,2123667,3297469
1976-02-20,1976,143,D,1,1,16581,3372257,6440274,8677,2132344,3297469
1976-02-21,1976,144,D,1,1,15771,3388028,6440274,7667,2140011,3297469
1976-02-22,1976,145,D,1,1,14875,3402903,6440274,6063,2146074,3297469
1976-02-23,1976,146,D,1,1,14249,3417152,6440274,5853,2151927,3297469
1976-02-24,1976,147,D,1,1,14628,3431780,6440274,5779,2157706,3297469
1976-02-25,1976,148,D,1,1,14876,3446656,6440274,6008,2163714,3297469
1976-02-26,1976,149,D,1,1,14766,3461422,6440274,5211,2168925,3297469
1976-02-27,1976,150,D,1,1,14569,3475991,6440274,4627,2173552,3297469
1976-02-28,1976,151,D,1,1,15374,3491365,6440274,5086,2178638,3297469
1976-02-29,1976,152,D,1,1,18754,3510119,6440274,6767,2185405,3297469
1976-03-01,1976,153,D,1,1,21927,3532046,6440274,13373,2198778,3297469
1976-03-02,1976,154,D,1,1,27849,3559895,6440274,19813,2218591,3297469
1976-03-03,1976,155,D,1,1,30310,3590205,6440274,25253,2243844,3297469
1976-03-04,1976,156,D,1,1,27630,3617835,6440274,22844,2266688,3297469
1976-03-05,1976,157,D,1,1,24835,3642670,6440274,19984,2286672,3297469
1976-03-06,1976,158,D,1,1,22380,3665050,6440274,14964,2301636,3297469
1976-03-07,1976,159,D,1,1,20232,3685282,6440274,12050,2313686,3297469
1976-03-08,1976,160,D,1,1,18252,3703534,6440274,7173,2320859,3297469
1976-03-09,1976,161,D,1,1,16783,3720317,6440274,5821,2326680,3297469
1976-03-10,1976,162,D,1,1,16157,3736474,6440274,5341,2332021,3297469
1976-03-11,1976,163,D,1,1,15679,3752153,6440274,5389,2337410,3297469
1976-03-12,1976,164,D,1,1,15533,3767686,6440274,5545,2342955,3297469
1976-03-13,1976,165,D,1,1,15319,3783005,6440274,4752,2347707,3297469
1976-03-14,1976,166,D,1,1,15401,3798406,6440274,4885,2352592,3297469
1976-03-15,1976,167,D,1,1,15225,3813631,6440274,5132,2357724,3297469
1976-03-16,1976,168,D,1,1,14623,3828254,6440274,4279,2362003,3297469
1976-03-17,1976,169,D,1,1,14177,3842431,6440274,3625,2365628,3297469
1976-03-18,1976,170,D,1,1,14087,3856518,6440274,3860,2369488,3297469
1976-03-19,1976,171,D,1,1,13942,3870460,6440274,4292,2373780,3297469
1976-03-20,1976,172,D,1,1,13712,3884172,6440274,4238,2378018,3297469
1976-03-21,1976,173,D,1,1,13610,3897782,6440274,4123,2382141,3297469
1976-03-22,1976,174,D,1,1,13599,3911381,6440274,4335,2386476,3297469
1976-03-23,1976,175,D,1,1,13298,3924679,6440274,4495,2390971,3297469
1976-03-24,1976,176,D,1,1,13245,3937924,6440274,4643,2395614,3297469
1976-03-25,1976,177,D,1,1,12703,3950627,6440274,3558,2399172,3297469
1976-03-26,1976,178,D,1,1,12480,3963107,6440274,3660,2402832,3297469
1976-03-27,1976,179,D,1,1,12158,3975265,6440274,3603,2406435,3297469
1976-03-28,1976,180,D,1,1,12113,3987378,6440274,3683,2410118,3297469
1976-03-29,1976,181,D,1,1,12601,3999979,6440274,4265,2414383,3297469
1976-03-30,1976,182,D,1,1,12465,4012444,6440274,6064,2420447,3297469
1976-03-31,1976,183,D,1,1,12819,4025263,6440274,6392,2426839,3297469
1976-04-01,1976,184,D,1,1,12730,4037993,6440274,5732,2432571,3297469
1976-04-02,1976,185,D,1,1,12644,4050637,6440274,5669,2438240,3297469
1976-04-03,1976,186,D,1,1,13000,4063637,6440274,5985,2444225,3297469
1976-04-04,1976,187,D,1,1,13689,4077326,6440274,6696,2450921,3297469
1976-04-05,1976,188,D,1,1,14544,4091870,6440274,7523,2458444,3297469
1976-04-06,1976,189,D,1,1,14952,4106822,6440274,7903,2466347,3297469
1976-04-07,1976,190,D,1,1,15141,4121963,6440274,12699,2479046,3297469
1976-04-08,1976,191,D,1,1,16540,4138503,6440274,16411,2495457,3297469
1976-04-09,1976,192,D,1,1,17948,4156451,6440274,17982,2513439,3297469
1976-04-10,1976,193,D,1,1,20098,4176549,6440274,22816,2536255,3297469
1976-04-11,1976,194,D,1,1,21193,4197742,6440274,23715,2559970,3297469
1976-04-12,1976,195,D,1,1,20174,4217916,6440274,17849,2577819,3297469
1976-04-13,1976,196,D,1,1,18364,4236280,6440274,14580,2592399,3297469
1976-04-14,1976,197,D,1,1,16914,4253194,6440274,13119,2605518,3297469
1976-04-15,1976,198,D,1,1,16136,4269330,6440274,9028,2614546,3297469
1976-04-16,1976,199,D,1,1,15101,4284431,6440274,7800,2622346,3297469
1976-04-17,1976,200,D,1,1,14091,4298522,6440274,6743,2629089,3297469
1976-04-18,1976,201,D,1,1,13765,4312287,6440274,6400,2635489,3297469
1976-04-19,1976,202,D,1,1,13571,4325858,6440274,6137,2641626,3297469
1976-04-20,1976,203,D,1,1,12997,4338855,6440274,5050,2646676,3297469
1976-04-21,1976,204,D,1,1,12174,4351029,6440274,3460,2650136,3297469
1976-04-22,1976,205,D,1,1,11584,4362613,6440274,3858,2653994,3297469
1976-04-23,1976,206,D,1,1,11117,4373730,6440274,4342,2658336,3297469
1976-04-24,1976,207,D,1,1,11004,4384734,6440274,4454,2662790,3297469
1976-04-25,1976,208,D,1,1,11097,4395831,6440274,4511,2667301,3297469
1976-04-26,1976,209,D,1,1,11425,4407256,6440274,3794,2671095,3297469
1976-04-27,1976,210,D,1,1,11287,4418543,6440274,4205,2675300,3297469
1976-04-28,1976,211,D,1,1,10873,4429416,6440274,4588,2679888,3297469
1976-04-29,1976,212,D,1,1,10859,4440275,6440274,4757,2684645,3297469
1976-04-30,1976,213,D,1,1,10980,4451255,6440274,4062,2688707,3297469
1976-05-01,1976,214,D,1,1,11380,4462635,6440274,3985,2692692,3297469
1976-05-02,1976,215,D,1,1,11748,4474383,6440274,4389,2697081,3297469
1976-05-03,1976,216,D,1,1,11805,4486188,6440274,4892,2701973,3297469
1976-05-04,1976,217,D,1,1,11656,4497844,6440274,4692,2706665,3297469
1976-05-05,1976,218,D,1,1,11313,4509157,6440274,3879,2710544,3297469
1976-05-06,1976,219,D,1,1,11204,4520361,6440274,3888,2714432,3297469
1976-05-07,1976,220,D,1,1,11854,4532215,6440274,3882,2718314,3297469
1976-05-08,1976,221,D,1,1,12306,4544521,6440274,3738,2722052,3297469
1976-05-09,1976,222,D,1,1,11919,4556440,6440274,3599,2725651,3297469
1976-05-10,1976,223,D,1,1,12074,4568514,6440274,4150,2729801,3297469
1976-05-11,1976,224,D,1,1,11886,4580400,6440274,3927,2733728,3297469
1976-05-12,1976,225,D,1,1,11983,4592383,6440274,3780,2737508,3297469
1976-05-13,1976,226,D,1,1,12227,4604610,6440274,3831,2741339,3297469
1976-05-14,1976,227,D,1,1,12228,4616838,6440274,3478,2744817,3297469
1976-05-15,1976,228,D,1,1,11894,4628732,6440274,3141,2747958,3297469
1976-05-16,1976,229,D,1,1,12158,4640890,6440274,3576,2751534,3297469
1976-05-17,1976,230,D,1,1,12365,4653255,6440274,3726,2755260,3297469
1976-05-18,1976,231,D,1,1,12156,4665411,6440274,3623,2758883,3297469
1976-05-19,1976,232,D,1,1,12010,4677421,6440274,3761,2762644,3297469
1976-05-20,1976,233,D,1,1,11868,4689289,6440274,3645,2766289,3297469
1976-05-21,1976,234,D,1,1,12000,4701289,6440274,4140,2770429,3297469
1976-05-22,1976,235,D,1,1,12215,4713504,6440274,4234,2774663,3297469
1976-05-23,1976,236,D,1,1,12451,4725955,6440274,4571,2779234,3297469
1976-05-24,1976,237,D,1,1,12664,4738619,6440274,4680,2783914,3297469
1976-05-25,1976,238,D,1,1,12398,4751017,6440274,3957,2787871,3297469
1976-05-26,1976,239,D,1,1,12366,4763383,6440274,3951,2791822,3297469
1976-05-27,1976,240,D,1,1,12323,4775706,6440274,3715,2795537,3297469
1976-05-28,1976,241,D,1,1,12076,4787782,6440274,4009,2799546,3297469
1976-05-29,1976,242,D,1,1,11560,4799342,6440274,3399,2802945,3297469
1976-05-30,1976,243,D,1,1,11563,4810905,6440274,3733,2806678,3297469
1976-05-31,1976,244,D,1,1,11958,4822863,6440274,4091,2810769,3297469
1976-06-01,1976,245,D,1,1,12156,4835019,6440274,4109,2814878,3297469
1976-06-02,1976,246,D,1,1,12153,4847172,6440274,3860,2818738,3297469
1976-06-03,1976,247,D,1,1,11885,4859057,6440274,3722,2822460,3297469
1976-06-04,1976,248,D,1,1,11836,4870893,6440274,3784,2826244,3297469
1976-06-05,1976,249,D,1,1,12019,4882912,6440274,3928,2830172,3297469
1976-06-06,1976,250,D,1,1,12142,4895054,6440274,4039,2834211,3297469
1976-06-07,1976,251,D,1,1,12525,4907579,6440274,4336,2838547,3297469
1976-06-08,1976,252,D,1,1,12666,4920245,6440274,4476,2843023,3297469
1976-06-09,1976,253,D,1,1,12937,4933182,6440274,4269,2847292,3297469
1976-06-10,1976,254,D,1,1,12932,4946114,6440274,4281,2851573,3297469
1976-06-11,1976,255,D,1,1,12941,4959055,6440274,4191,2855764,3297469
1976-06-12,1976,256,D,1,1,12795,4971850,6440274,3676,2859440,3297469
1976-06-13,1976,257,D,1,1,12673,4984523,6440274,3547,2862987,3297469
1976-06-14,1976,258,D,1,1,12542,4997065,6440274,3236,2866223,3297469
1976-06-15,1976,259,D,1,1,12276,5009341,6440274,3150,2869373,3297469
1976-06-16,1976,260,D,1,1,11746,5021087,6440274,2914,2872287,3297469
1976-06-17,1976,261,D,1,1,11338,5032425,6440274,2992,2875279,3297469
1976-06-18,1976,262,D,1,1,11180,5043605,6440274,3477,2878756,3297469
1976-06-19,1976,263,D,1,1,10996,5054601,6440274,3579,2882335,3297469
1976-06-20,1976,264,D,1,1,11458,5066059,6440274,3991,2886326,3297469
1976-06-21,1976,265,D,1,1,11734,5077793,6440274,4416,2890742,3297469
1976-06-22,1976,266,D,1,1,11312,5089105,6440274,3882,2894624,3297469
1976-06-23,1976,267,D,1,1,10875,5099980,6440274,3592,2898216,3297469
1976-06-24,1976,268,D,1,1,10565,5110545,6440274,3345,2901561,3297469
1976-06-25,1976,269,D,1,1,10737,5121282,6440274,3701,2905262,3297469
1976-06-26,1976,270,D,1,1,10798,5132080,6440274,3666,2908928,3297469
1976-06-27,1976,271,D,1,1,10824,5142904,6440274,3591,2912519,3297469
1976-06-28,1976,272,D,1,1,11019,5153923,6440274,3692,2916211,3297469
1976-06-29,1976,273,D,1,1,11224,5165147,6440274,3944,2920155,3297469
1976-06-30,1976,274,D,1,1,11173,5176320,6440274,3868,2924023,3297469
1976-07-01,1976,275,D,1,1,11168,5187488,6440274,3649,2927672,3297469
1976-07-02,1976,276,D,1,1,11098,5198586,6440274,4063,2931735,3297469
1976-07-03,1976,277,D,1,1,11355,5209941,6440274,3944,2935679,3297469
1976-07-04,1976,278,D,1,1,11690,5221631,6440274,4434,2940113,3297469
1976-07-05,1976,279,D,1,1,12000,5233631,6440274,3927,2944040,3297469
1976-07-06,1976,280,D,1,1,12070,5245701,6440274,4922,2948962,3297469
1976-07-07,1976,281,D,1,1,12140,5257841,6440274,4770,2953732,3297469
1976-07-08,1976,282,D,1,1,12190,5270031,6440274,4939,2958671,3297469
1976-07-09,1976,283,D,1,1,12255,5282286,6440274,4895,2963566,3297469
1976-07-10,1976,284,D,1,1,12219,5294505,6440274,4831,2968397,3297469
1976-07-11,1976,285,D,1,1,12428,5306933,6440274,5026,2973423,3297469
1976-07-12,1976,286,D,1,1,13099,5320032,6440274,4983,2978406,3297469
1976-07-13,1976,287,D,1,1,13175,5333207,6440274,3988,2982394,3297469
1976-07-14,1976,288,D,1,1,13099,5346306,6440274,3672,2986066,3297469
1976-07-15,1976,289,D,1,1,12897,5359203,6440274,3754,2989820,3297469
1976-07-16,1976,290,D,1,1,12788,5371991,6440274,3857,2993677,3297469
1976-07-17,1976,291,D,1,1,12690,5384681,6440274,4008,2997685,3297469
1976-07-18,1976,292,D,1,1,13152,5397833,6440274,4460,3002145,3297469
1976-07-19,1976,293,D,1,1,13424,5411257,6440274,4484,3006629,3297469
1976-07-20,1976,294,D,1,1,13252,5424509,6440274,4139,3010768,3297469
1976-07-21,1976,295,D,1,1,13202,5437711,6440274,3677,3014445,3297469
1976-07-22,1976,296,D,1,1,13208,5450919,6440274,3857,3018302,3297469
1976-07-23,1976,297,D,1,1,13104,5464023,6440274,3786,3022088,3297469
1976-07-24,1976,298,D,1,1,13289,5477312,6440274,4009,3026097,3297469
1976-07-25,1976,299,D,1,1,13410,5490722,6440274,4163,3030260,3297469
1976-07-26,1976,300,D,1,1,13653,5504375,6440274,3934,3034194,3297469
1976-07-27,1976,301,D,1,1,13848,5518223,6440274,3903,3038097,3297469
1976-07-28,1976,302,D,1,1,13716,5531939,6440274,3746,3041843,3297469
1976-07-29,1976,303,D,1,1,13665,5545604,6440274,3809,3045652,3297469
1976-07-30,1976,304,D,1,1,13815,5559419,6440274,4061,3049713,3297469
1976-07-31,1976,305,D,1,1,13812,5573231,6440274,4067,3053780,3297469
1976-08-01,1976,306,D,1,1,13892,5587123,6440274,4073,3057853,3297469
1976-08-02,1976,307,D,1,1,14291,5601414,6440274,4242,3062095,3297469
1976-08-03,1976,308,D,1,1,14540,5615954,6440274,5070,3067165,3297469
1976-08-04,1976,309,D,1,1,14073,5630027,6440274,4439,3071604,3297469
1976-08-05,1976,310,D,1,1,13631,5643658,6440274,3974,3075578,3297469
1976-08-06,1976,311,D,1,1,13589,5657247,6440274,3812,3079390,3297469
1976-08-07,1976,312,D,1,1,13585,5670832,6440274,4038,3083428,3297469
1976-08-08,1976,313,D,1,1,13651,5684483,6440274,4092,3087520,3297469
1976-08-09,1976,314,D,1,1,13948,5698431,6440274,4406,3091926,3297469
1976-08-10,1976,315,D,1,1,13529,5711960,6440274,4028,3095954,3297469
1976-08-11,1976,316,D,1,1,13288,5725248,6440274,4022,3099976,3297469
1976-08-12,1976,317,D,1,1,12765,5738013,6440274,3739,3103715,3297469
1976-08-13,1976,318,D,1,1,12568,5750581,6440274,3625,3107340,3297469
1976-08-14,1976,319,D,1,1,13204,5763785,6440274,4359,3111699,3297469
1976-08-15,1976,320,D,1,1,14613,5778398,6440274,7333,3119032,3297469
1976-08-16,1976,321,D,1,1,15174,5793572,6440274,7131,3126163,3297469
1976-08-17,1976,322,D,1,1,15459,5809031,6440274,6736,3132899,3297469
1976-08-18,1976,323,D,1,1,15419,5824450,6440274,6369,3139268,3297469
1976-08-19,1976,324,D,1,1,15752,5840202,6440274,6368,3145636,3297469
1976-08-20,1976,325,D,1,1,16055,5856257,6440274,4555,3150191,3297469
1976-08-21,1976,326,D,1,1,16567,5872824,6440274,4494,3154685,3297469
1976-08-22,1976,327,D,1,1,16540,5889364,6440274,5086,3159771,3297469
1976-08-23,1976,328,D,1,1,16108,5905472,6440274,5420,3165191,3297469
1976-08-24,1976,329,D,1,1,15713,5921185,6440274,4012,3169203,3297469
1976-08-25,1976,330,D,1,1,14939,5936124,6440274,3358,3172561,3297469
1976-08-26,1976,331,D,1,1,14312,5950436,6440274,3466,3176027,3297469
1976-08-27,1976,332,D,1,1,13969,5964405,6440274,2456,3178483,3297469
1976-08-28,1976,333,D,1,1,14086,5978491,6440274,2973,3181456,3297469
1976-08-29,1976,334,D,1,1,14605,5993096,6440274,3112,3184568,3297469
1976-08-30,1976,335,D,1,1,14636,6007732,6440274,2954,3187522,3297469
1976-08-31,1976,336,D,1,1,14411,6022143,6440274,2458,3189980,3297469
1976-09-01,1976,337,D,1,1,14411,6036554,6440274,2582,3192562,3297469
1976-09-02,1976,338,D,1,1,14635,6051189,6440274,2605,3195167,3297469
1976-09-03,1976,339,D,1,1,14631,6065820,6440274,2950,3198117,3297469
1976-09-04,1976,340,D,1,1,14701,6080521,6440274,2728,3200845,3297469
1976-09-05,1976,341,D,1,1,15021,6095542,6440274,2826,3203671,3297469
1976-09-06,1976,342,D,1,1,15225,6110767,6440274,3034,3206705,3297469
1976-09-07,1976,343,D,1,1,15143,6125910,6440274,2341,3209046,3297469
1976-09-08,1976,344,D,1,1,14414,6140324,6440274,2631,3211677,3297469
1976-09-09,1976,345,D,1,1,14127,6154451,6440274,2260,3213937,3297469
1976-09-10,1976,346,D,1,1,14153,6168604,6440274,2353,3216290,3297469
1976-09-11,1976,347,D,1,1,14810,6183414,6440274,2375,3218665,3297469
1976-09-12,1976,348,D,1,1,16120,6199534,6440274,3418,3222083,3297469
1976-09-13,1976,349,D,1,1,15528,6215062,6440274,2781,3224864,3297469
1976-09-14,1976,350,D,1,1,15347,6230409,6440274,3696,3228560,3297469
1976-09-15,1976,351,D,1,1,15279,6245688,6440274,4178,3232738,3297469
1976-09-16,1976,352,D,1,1,15152,6260840,6440274,3286,3236024,3297469
1976-09-17,1976,353,D,1,1,14700,6275540,6440274,3499,3239523,3297469
1976-09-18,1976,354,D,1,1,14376,6289916,6440274,2927,3242450,3297469
1976-09-19,1976,355,D,1,1,13858,6303774,6440274,2767,3245217,3297469
1976-09-20,1976,356,D,1,1,13219,6316993,6440274,2617,3247834,3297469
1976-09-21,1976,357,D,1,1,12604,6329597,6440274,2899,3250733,3297469
1976-09-22,1976,358,D,1,1,12613,6342210,6440274,3727,3254460,3297469
1976-09-23,1976,359,D,1,1,11902,6354112,6440274,2989,3257449,3297469
1976-09-24,1976,360,D,1,1,11977,6366089,6440274,2523,3259972,3297469
1976-09-25,1976,361,D,1,1,12039,6378128,6440274,2668,3262640,3297469
1976-09-26,1976,362,D,1,1,12702,6390830,6440274,3305,3265945,3297469
1976-09-27,1976,363,D,1,1,12289,6403119,6440274,2467,3268412,3297469
1976-09-28,1976,364,D,1,1,12109,6415228,6440274,9516,3277928,3297469
1976-09-29,1976,365,D,1,1,12608,6427836,6440274,10201,3288129,3297469
1976-09-30,1976,366,D,1,1,12438,6440274,6440274,9340,3297469,3297469
1976-10-01,1977,1,D,2,2,12379,12379,3002755,9272,9272,1248821
1976-10-02,1977,2,D,2,2,12074,24453,3002755,10982,20254,1248821
1976-10-03,1977,3,D,2,2,11737,36190,3002755,3966,24220,1248821
1976-10-04,1977,4,D,2,2,11424,47614,3002755,3776,27996,1248821
1976-10-05,1977,5,D,2,2,11102,58716,3002755,3746,31742,1248821
1976-10-06,1977,6,D,2,2,10711,69427,3002755,3555,35297,1248821
1976-10-07,1977,7,D,2,2,10371,79798,3002755,2112,37409,1248821
1976-10-08,1977,8,D,2,2,10163,89961,3002755,2462,39871,1248821
1976-10-09,1977,9,D,2,2,9839,99800,3002755,2620,42491,1248821
1976-10-10,1977,10,D,2,2,9388,109188,3002755,2411,44902,1248821
1976-10-11,1977,11,D,2,2,9078,118266,3002755,2431,47333,1248821
1976-10-12,1977,12,D,2,2,8910,127176,3002755,2402,49735,1248821
1976-10-13,1977,13,D,2,2,8721,135897,3002755,2150,51885,1248821
1976-10-14,1977,14,D,2,2,8461,144358,3002755,2066,53951,1248821
1976-10-15,1977,15,D,2,2,8520,152878,3002755,2217,56168,1248821
1976-10-16,1977,16,D,2,2,8498,161376,3002755,2752,58920,1248821
1976-10-17,1977,17,D,2,2,8337,169713,3002755,2133,61053,1248821
1976-10-18,1977,18,D,2,2,8289,178002,3002755,2642,63695,1248821
1976-10-19,1977,19,D,2,2,8330,186332,3002755,3800,67495,1248821
1976-10-20,1977,20,D,2,2,7971,194303,3002755,3556,71051,1248821
1976-10-21,1977,21,D,2,2,8192,202495,3002755,3741,74792,1248821
1976-10-22,1977,22,D,2,2,8552,211047,3002755,3904,78696,1248821
1976-10-23,1977,23,D,2,2,8800,219847,3002755,4030,82726,1248821
1976-10-24,1977,24,D,2,2,9099,228946,3002755,4071,86797,1248821
1976-10-25,1977,25,D,2,2,9021,237967,3002755,3780,90577,1248821
1976-10-26,1977,26,D,2,2,8543,246510,3002755,3113,93690,1248821
1976-10-27,1977,27,D,2,2,8813,255323,3002755,3387,97077,1248821
1976-10-28,1977,28,D,2,2,8913,264236,3002755,3460,100537,1248821
1976-10-29,1977,29,D,2,2,9024,273260,3002755,3619,104156,1248821
1976-10-30,1977,30,D,2,2,9209,282469,3002755,3929,108085,1248821
1976-10-31,1977,31,D,2,2,9101,291570,3002755,3871,111956,1248821
1976-11-01,1977,32,D,2,2,9399,300969,3002755,3462,115418,1248821
1976-11-02,1977,33,D,2,2,8990,309959,3002755,2643,118061,1248821
1976-11-03,1977,34,D,2,2,8792,318751,3002755,2371,120432,1248821
1976-11-04,1977,35,D,2,2,8492,327243,3002755,2143,122575,1248821
1976-11-05,1977,36,D,2,2,8346,335589,3002755,2196,124771,1248821
1976-11-06,1977,37,D,2,2,8393,343982,3002755,2542,127313,1248821
1976-11-07,1977,38,D,2,2,8418,352400,3002755,2565,129878,1248821
1976-11-08,1977,39,D,2,2,8368,360768,3002755,2536,132414,1248821
1976-11-09,1977,40,D,2,2,8246,369014,3002755,2394,134808,1248821
1976-11-10,1977,41,D,2,2,8449,377463,3002755,2741,137549,1248821
1976-11-11,1977,42,D,2,2,8442,385905,3002755,2793,140342,1248821
1976-11-12,1977,43,D,2,2,8681,394586,3002755,4369,144711,1248821
1976-11-13,1977,44,D,2,2,9023,403609,3002755,4626,149337,1248821
1976-11-14,1977,45,D,2,2,9477,413086,3002755,7034,156371,1248821
1976-11-15,1977,46,D,2,2,9477,422563,3002755,6836,163207,1248821
1976-11-16,1977,47,D,2,2,9441,432004,3002755,7034,170241,1248821
1976-11-17,1977,48,D,2,2,9459,441463,3002755,5682,175923,1248821
1976-11-18,1977,49,D,2,2,9536,450999,3002755,5597,181520,1248821
1976-11-19,1977,50,D,2,2,9722,460721,3002755,4002,185522,1248821
1976-11-20,1977,51,D,2,2,9558,470279,3002755,3320,188842,1248821
1976-11-21,1977,52,D,2,2,9327,479606,3002755,3076,191918,1248821
1976-11-22,1977,53,D,2,2,9262,488868,3002755,3890,195808,1248821
1976-11-23,1977,54,D,2,2,9449,498317,3002755,4808,200616,1248821
1976-11-24,1977,55,D,2,2,9329,507646,3002755,3190,203806,1248821
1976-11-25,1977,56,D,2,2,9457,517103,3002755,3200,207006,1248821
1976-11-26,1977,57,D,2,2,9262,526365,3002755,3026,210032,1248821
1976-11-27,1977,58,D,2,2,9021,535386,3002755,2735,212767,1248821
1976-11-28,1977,59,D,2,2,9380,544766,3002755,2964,215731,1248821
1976-11-29,1977,60,D,2,2,9290,554056,3002755,2486,218217,1248821
1976-11-30,1977,61,D,2,2,9288,563344,3002755,3042,221259,1248821
1976-12-01,1977,62,D,2,2,9308,572652,3002755,3281,224540,1248821
1976-12-02,1977,63,D,2,2,9308,581960,3002755,3683,228223,1248821
1976-12-03,1977,64,D,2,2,9084,591044,3002755,3579,231802,1248821
1976-12-04,1977,65,D,2,2,8861,599905,3002755,3272,235074,1248821
1976-12-05,1977,66,D,2,2,8668,608573,3002755,3008,238082,1248821
1976-12-06,1977,67,D,2,2,8598,617171,3002755,3148,241230,1248821
1976-12-07,1977,68,D,2,2,9106,626277,3002755,2774,244004,1248821
1976-12-08,1977,69,D,2,2,9157,635434,3002755,2798,246802,1248821
1976-12-09,1977,70,D,2,2,8875,644309,3002755,3605,250407,1248821
1976-12-10,1977,71,D,2,2,9011,653320,3002755,3848,254255,1248821
1976-12-11,1977,72,D,2,2,8779,662099,3002755,3684,257939,1248821
1976-12-12,1977,73,D,2,2,8814,670913,3002755,3808,261747,1248821
1976-12-13,1977,74,D,2,2,8897,679810,3002755,3860,265607,1248821
1976-12-14,1977,75,D,2,2,8919,688729,3002755,3799,269406,1248821
1976-12-15,1977,76,D,2,2,8851,697580,3002755,3747,273153,1248821
1976-12-16,1977,77,D,2,2,8555,706135,3002755,3482,276635,1248821
1976-12-17,1977,78,D,2,2,8313,714448,3002755,5153,281788,1248821
1976-12-18,1977,79,D,2,2,8351,722799,3002755,5411,287199,1248821
1976-12-19,1977,80,D,2,2,8499,731298,3002755,5749,292948,1248821
1976-12-20,1977,81,D,2,2,8527,739825,3002755,5437,298385,1248821
1976-12-21,1977,82,D,2,2,8475,748300,3002755,5340,303725,1248821
1976-12-22,1977,83,D,2,2,8508,756808,3002755,4569,308294,1248821
1976-12-23,1977,84,D,2,2,8546,765354,3002755,3591,311885,1248821
1976-12-24,1977,85,D,2,2,8748,774102,3002755,3615,315500,1248821
1976-12-25,1977,86,D,2,2,8803,782905,3002755,3753,319253,1248821
1976-12-26,1977,87,D,2,2,8841,791746,3002755,3868,323121,1248821
1976-12-27,1977,88,D,2,2,8907,800653,3002755,3862,326983,1248821
1976-12-28,1977,89,D,2,2,8615,809268,3002755,3355,330338,1248821
1976-12-29,1977,90,D,2,2,8280,817548,3002755,3643,333981,1248821
1976-12-30,1977,91,D,2,2,8510,826058,3002755,7848,341829,1248821
1976-12-31,1977,92,D,2,2,9061,835119,3002755,10035,351864,1248821
1977-01-01,1977,93,D,2,2,10025,845144,3002755,10282,362146,1248821
1977-01-02,1977,94,D,2,2,11424,856568,3002755,12430,374576,1248821
1977-01-03,1977,95,D,2,2,12043,868611,3002755,14201,388777,1248821
1977-01-04,1977,96,D,2,2,13335,881946,3002755,10370,399147,1248821
1977-01-05,1977,97,D,2,2,14908,896854,3002755,9016,408163,1248821
1977-01-06,1977,98,D,2,2,13487,910341,3002755,5904,414067,1248821
1977-01-07,1977,99,D,2,2,11866,922207,3002755,3416,417483,1248821
1977-01-08,1977,100,D,2,2,10684,932891,3002755,2313,419796,1248821
1977-01-09,1977,101,D,2,2,10237,943128,3002755,3330,423126,1248821
1977-01-10,1977,102,D,2,2,9766,952894,3002755,3115,426241,1248821
1977-01-11,1977,103,D,2,2,9537,962431,3002755,2671,428912,1248821
1977-01-12,1977,104,D,2,2,9594,972025,3002755,5812,434724,1248821
1977-01-13,1977,105,D,2,2,9921,981946,3002755,6072,440796,1248821
1977-01-14,1977,106,D,2,2,10129,992075,3002755,6140,446936,1248821
1977-01-15,1977,107,D,2,2,10305,1002380,3002755,6167,453103,1248821
1977-01-16,1977,108,D,2,2,10484,1012864,3002755,6099,459202,1248821
1977-01-17,1977,109,D,2,2,10615,1023479,3002755,3168,462370,1248821
1977-01-18,1977,110,D,2,2,10446,1033925,3002755,3408,465778,1248821
1977-01-19,1977,111,D,2,2,10336,1044261,3002755,1901,467679,1248821
1977-01-20,1977,112,D,2,2,10286,1054547,3002755,2003,469682,1248821
1977-01-21,1977,113,D,2,2,10286,1064833,3002755,2555,472237,1248821
1977-01-22,1977,114,D,2,2,10484,1075317,3002755,3168,475405,1248821
1977-01-23,1977,115,D,2,2,10763,1086080,3002755,2342,477747,1248821
1977-01-24,1977,116,D,2,2,10872,1096952,3002755,3206,480953,1248821
1977-01-25,1977,117,D,2,2,11094,1108046,3002755,1802,482755,1248821
1977-01-26,1977,118,D,2,2,11430,1119476,3002755,1200,483955,1248821
1977-01-27,1977,119,D,2,2,11462,1130938,3002755,1091,485046,1248821
1977-01-28,1977,120,D,2,2,11181,1142119,3002755,853,485899,1248821
1977-01-29,1977,121,D,2,2,10900,1153019,3002755,333,486232,1248821
1977-01-30,1977,122,D,2,2,10765,1163784,3002755,415,486647,1248821
1977-01-31,1977,123,D,2,2,10659,1174443,3002755,458,487105,1248821
1977-02-01,1977,124,D,2,2,10282,1184725,3002755,1206,488311,1248821
1977-02-02,1977,125,D,2,2,10092,1194817,3002755,2596,490907,1248821
1977-02-03,1977,126,D,2,2,9742,1204559,3002755,2614,493521,1248821
1977-02-04,1977,127,D,2,2,9692,1214251,3002755,2756,496277,1248821
1977-02-05,1977,128,D,2,2,9607,1223858,3002755,2631,498908,1248821
1977-02-06,1977,129,D,2,2,9663,1233521,3002755,2699,501607,1248821
1977-02-07,1977,130,D,2,2,9662,1243183,3002755,3359,504966,1248821
1977-02-08,1977,131,D,2,2,9805,1252988,3002755,3685,508651,1248821
1977-02-09,1977,132,D,2,2,9894,1262882,3002755,4754,513405,1248821
1977-02-10,1977,133,D,2,2,9788,1272670,3002755,4838,518243,1248821
1977-02-11,1977,134,D,2,2,9506,1282176,3002755,4634,522877,1248821
1977-02-12,1977,135,D,2,2,8963,1291139,3002755,4495,527372,1248821
1977-02-13,1977,136,D,2,2,8621,1299760,3002755,4588,531960,1248821
1977-02-14,1977,137,D,2,2,8362,1308122,3002755,4576,536536,1248821
1977-02-15,1977,138,D,2,2,8230,1316352,3002755,4670,541206,1248821
1977-02-16,1977,139,D,2,2,8046,1324398,3002755,4715,545921,1248821
1977-02-17,1977,140,D,2,2,7704,1332102,3002755,4469,550390,1248821
1977-02-18,1977,141,D,2,2,7610,1339712,3002755,4042,554432,1248821
1977-02-19,1977,142,D,2,2,7336,1347048,3002755,3545,557977,1248821
1977-02-20,1977,143,D,2,2,7596,1354644,3002755,5877,563854,1248821
1977-02-21,1977,144,D,2,2,8125,1362769,3002755,8021,571875,1248821
1977-02-22,1977,145,D,2,2,8515,1371284,3002755,9278,581153,1248821
1977-02-23,1977,146,D,2,2,8899,1380183,3002755,10136,591289,1248821
1977-02-24,1977,147,D,2,2,8986,1389169,3002755,10355,601644,1248821
1977-02-25,1977,148,D,2,2,8876,1398045,3002755,8210,609854,1248821
1977-02-26,1977,149,D,2,2,8474,1406519,3002755,6023,615877,1248821
1977-02-27,1977,150,D,2,2,7852,1414371,3002755,4834,620711,1248821
1977-02-28,1977,151,D,2,2,7391,1421762,3002755,2985,623696,1248821
1977-03-01,1977,152,D,2,2,7172,1428934,3002755,2655,626351,1248821
1977-03-02,1977,153,D,2,2,6651,1435585,3002755,2489,628840,1248821
1977-03-03,1977,154,D,2,2,6118,1441703,3002755,1923,630763,1248821
1977-03-04,1977,155,D,2,2,6054,1447757,3002755,2098,632861,1248821
1977-03-05,1977,156,D,2,2,5984,1453741,3002755,2163,635024,1248821
1977-03-06,1977,157,D,2,2,6270,1460011,3002755,2476,637500,1248821
1977-03-07,1977,158,D,2,2,6492,1466503,3002755,2392,639892,1248821
1977-03-08,1977,159,D,2,2,6798,1473301,3002755,2171,642063,1248821
1977-03-09,1977,160,D,2,2,7095,1480396,3002755,2702,644765,1248821
1977-03-10,1977,161,D,2,2,6707,1487103,3002755,1931,646696,1248821
1977-03-11,1977,162,D,2,2,6670,1493773,3002755,1492,648188,1248821
1977-03-12,1977,163,D,2,2,6737,1500510,3002755,1728,649916,1248821
1977-03-13,1977,164,D,2,2,6857,1507367,3002755,2670,652586,1248821
1977-03-14,1977,165,D,2,2,6808,1514175,3002755,2578,655164,1248821
1977-03-15,1977,166,D,2,2,7127,1521302,3002755,2567,657731,1248821
1977-03-16,1977,167,D,2,2,7626,1528928,3002755,7073,664804,1248821
1977-03-17,1977,168,D,2,2,8737,1537665,3002755,7866,672670,1248821
1977-03-18,1977,169,D,2,2,9179,1546844,3002755,7218,679888,1248821
1977-03-19,1977,170,D,2,2,9105,1555949,3002755,6665,686553,1248821
1977-03-20,1977,171,D,2,2,8941,1564890,3002755,6125,692678,1248821
1977-03-21,1977,172,D,2,2,8525,1573415,3002755,2173,694851,1248821
1977-03-22,1977,173,D,2,2,7600,1581015,3002755,1268,696119,1248821
1977-03-23,1977,174,D,2,2,7508,1588523,3002755,1755,697874,1248821
1977-03-24,1977,175,D,2,2,7205,1595728,3002755,2333,700207,1248821
1977-03-25,1977,176,D,2,2,6992,1602720,3002755,3290,703497,1248821
1977-03-26,1977,177,D,2,2,7237,1609957,3002755,2894,706391,1248821
1977-03-27,1977,178,D,2,2,7228,1617185,3002755,2858,709249,1248821
1977-03-28,1977,179,D,2,2,7055,1624240,3002755,2713,711962,1248821
1977-03-29,1977,180,D,2,2,6706,1630946,3002755,2168,714130,1248821
1977-03-30,1977,181,D,2,2,6416,1637362,3002755,1426,715556,1248821
1977-03-31,1977,182,D,2,2,6051,1643413,3002755,1365,716921,1248821
1977-04-01,1977,183,D,2,2,6235,1649648,3002755,1667,718588,1248821
1977-04-02,1977,184,D,2,2,6254,1655902,3002755,2172,720760,1248821
1977-04-03,1977,185,D,2,2,6512,1662414,3002755,2327,723087,1248821
1977-04-04,1977,186,D,2,2,6552,1668966,3002755,2307,725394,1248821
1977-04-05,1977,187,D,2,2,6351,1675317,3002755,3218,728612,1248821
1977-04-06,1977,188,D,2,2,6009,1681326,3002755,3071,731683,1248821
1977-04-07,1977,189,D,2,2,5924,1687250,3002755,3199,734882,1248821
1977-04-08,1977,190,D,2,2,5872,1693122,3002755,3427,738309,1248821
1977-04-09,1977,191,D,2,2,5768,1698890,3002755,3118,741427,1248821
1977-04-10,1977,192,D,2,2,5699,1704589,3002755,2658,744085,1248821
1977-04-11,1977,193,D,2,2,6151,1710740,3002755,3224,747309,1248821
1977-04-12,1977,194,D,2,2,6381,1717121,3002755,3134,750443,1248821
1977-04-13,1977,195,D,2,2,6354,1723475,3002755,3176,753619,1248821
1977-04-14,1977,196,D,2,2,5414,1728889,3002755,2440,756059,1248821
1977-04-15,1977,197,D,2,2,5384,1734273,3002755,2579,758638,1248821
1977-04-16,1977,198,D,2,2,5877,1740150,3002755,3075,761713,1248821
1977-04-17,1977,199,D,2,2,6280,1746430,3002755,3313,765026,1248821
1977-04-18,1977,200,D,2,2,6317,1752747,3002755,3184,768210,1248821
1977-04-19,1977,201,D,2,2,6368,1759115,3002755,2734,770944,1248821
1977-04-20,1977,202,D,2,2,6508,1765623,3002755,2664,773608,1248821
1977-04-21,1977,203,D,2,2,6266,1771889,3002755,3031,776639,1248821
1977-04-22,1977,204,D,2,2,5941,1777830,3002755,3133,779772,1248821
1977-04-23,1977,205,D,2,2,5428,1783258,3002755,2623,782395,1248821
1977-04-24,1977,206,D,2,2,5907,1789165,3002755,3061,785456,1248821
1977-04-25,1977,207,D,2,2,6513,1795678,3002755,3669,789125,1248821
1977-04-26,1977,208,D,2,2,6354,1802032,3002755,3062,792187,1248821
1977-04-27,1977,209,D,2,2,6633,1808665,3002755,3290,795477,1248821
1977-04-28,1977,210,D,2,2,6787,1815452,3002755,3293,798770,1248821
1977-04-29,1977,211,D,2,2,6870,1822322,3002755,3410,802180,1248821
1977-04-30,1977,212,D,2,2,7053,1829375,3002755,4052,806232,1248821
1977-05-01,1977,213,D,2,2,8149,1837524,3002755,9569,815801,1248821
1977-05-02,1977,214,D,2,2,9142,1846666,3002755,9689,825490,1248821
1977-05-03,1977,215,D,2,2,9089,1855755,3002755,8954,834444,1248821
1977-05-04,1977,216,D,2,2,9270,1865025,3002755,8992,843436,1248821
1977-05-05,1977,217,D,2,2,8988,1874013,3002755,8473,851909,1248821
1977-05-06,1977,218,D,2,2,8619,1882632,3002755,3551,855460,1248821
1977-05-07,1977,219,D,2,2,7879,1890511,3002755,3438,858898,1248821
1977-05-08,1977,220,D,2,2,7782,1898293,3002755,3848,862746,1248821
1977-05-09,1977,221,D,2,2,7941,1906234,3002755,4490,867236,1248821
1977-05-10,1977,222,D,2,2,8524,1914758,3002755,4726,871962,1248821
1977-05-11,1977,223,D,2,2,9052,1923810,3002755,3634,875596,1248821
1977-05-12,1977,224,D,2,2,9212,1933022,3002755,4565,880161,1248821
1977-05-13,1977,225,D,2,2,9749,1942771,3002755,4781,884942,1248821
1977-05-14,1977,226,D,2,2,10449,1953220,3002755,3723,888665,1248821
1977-05-15,1977,227,D,2,2,9124,1962344,3002755,2392,891057,1248821
1977-05-16,1977,228,D,2,2,8702,1971046,3002755,2993,894050,1248821
1977-05-17,1977,229,D,2,2,7990,1979036,3002755,1221,895271,1248821
1977-05-18,1977,230,D,2,2,7460,1986496,3002755,1500,896771,1248821
1977-05-19,1977,231,D,2,2,7054,1993550,3002755,2235,899006,1248821
1977-05-20,1977,232,D,2,2,7373,2000923,3002755,2538,901544,1248821
1977-05-21,1977,233,D,2,2,7474,2008397,3002755,2507,904051,1248821
1977-05-22,1977,234,D,2,2,7800,2016197,3002755,3530,907581,1248821
1977-05-23,1977,235,D,2,2,7547,2023744,3002755,3337,910918,1248821
1977-05-24,1977,236,D,2,2,6966,2030710,3002755,1940,912858,1248821
1977-05-25,1977,237,D,2,2,7119,2037829,3002755,2339,915197,1248821
1977-05-26,1977,238,D,2,2,6981,2044810,3002755,2477,917674,1248821
1977-05-27,1977,239,D,2,2,6995,2051805,3002755,2644,920318,1248821
1977-05-28,1977,240,D,2,2,7028,2058833,3002755,2188,922506,1248821
1977-05-29,1977,241,D,2,2,6783,2065616,3002755,1883,924389,1248821
1977-05-30,1977,242,D,2,2,6458,2072074,3002755,1652,926041,1248821
1977-05-31,1977,243,D,2,2,6197,2078271,3002755,1381,927422,1248821
1977-06-01,1977,244,D,2,2,5957,2084228,3002755,1628,929050,1248821
1977-06-02,1977,245,D,2,2,5956,2090184,3002755,1753,930803,1248821
1977-06-03,1977,246,D,2,2,5958,2096142,3002755,1855,932658,1248821
1977-06-04,1977,247,D,2,2,5892,2102034,3002755,1895,934553,1248821
1977-06-05,1977,248,D,2,2,5897,2107931,3002755,1986,936539,1248821
1977-06-06,1977,249,D,2,2,6278,2114209,3002755,1695,938234,1248821
1977-06-07,1977,250,D,2,2,6482,2120691,3002755,1634,939868,1248821
1977-06-08,1977,251,D,2,2,6555,2127246,3002755,1498,941366,1248821
1977-06-09,1977,252,D,2,2,6706,2133952,3002755,2186,943552,1248821
1977-06-10,1977,253,D,2,2,6167,2140119,3002755,1995,945547,1248821
1977-06-11,1977,254,D,2,2,6240,2146359,3002755,2200,947747,1248821
1977-06-12,1977,255,D,2,2,6605,2152964,3002755,2360,950107,1248821
1977-06-13,1977,256,D,2,2,7048,2160012,3002755,2626,952733,1248821
1977-06-14,1977,257,D,2,2,7087,2167099,3002755,2823,955556,1248821
1977-06-15,1977,258,D,2,2,6643,2173742,3002755,2320,957876,1248821
1977-06-16,1977,259,D,2,2,7004,2180746,3002755,2680,960556,1248821
1977-06-17,1977,260,D,2,2,7590,2188336,3002755,3283,963839,1248821
1977-06-18,1977,261,D,2,2,7449,2195785,3002755,2752,966591,1248821
1977-06-19,1977,262,D,2,2,7735,2203520,3002755,2878,969469,1248821
1977-06-20,1977,263,D,2,2,7706,2211226,3002755,2455,971924,1248821
1977-06-21,1977,264,D,2,2,7409,2218635,3002755,2039,973963,1248821
1977-06-22,1977,265,D,2,2,7409,2226044,3002755,2003,975966,1248821
1977-06-23,1977,266,D,2,2,7408,2233452,3002755,2174,978140,1248821
1977-06-24,1977,267,D,2,2,7265,2240717,3002755,2228,980368,1248821
1977-06-25,1977,268,D,2,2,7334,2248051,3002755,2513,982881,1248821
1977-06-26,1977,269,D,2,2,7911,2255962,3002755,3234,986115,1248821
1977-06-27,1977,270,D,2,2,8333,2264295,3002755,3335,989450,1248821
1977-06-28,1977,271,D,2,2,8192,2272487,3002755,3238,992688,1248821
1977-06-29,1977,272,D,2,2,8119,2280606,3002755,3113,995801,1248821
1977-06-30,1977,273,D,2,2,7886,2288492,3002755,3116,998917,1248821
1977-07-01,1977,274,D,2,2,8069,2296561,3002755,3310,1002227,1248821
1977-07-02,1977,275,D,2,2,8876,2305437,3002755,4155,1006382,1248821
1977-07-03,1977,276,D,2,2,9170,2314607,3002755,3927,1010309,1248821
1977-07-04,1977,277,D,2,2,9356,2323963,3002755,3778,1014087,1248821
1977-07-05,1977,278,D,2,2,9065,2333028,3002755,2805,1016892,1248821
1977-07-06,1977,279,D,2,2,8609,2341637,3002755,2058,1018950,1248821
1977-07-07,1977,280,D,2,2,8295,2349932,3002755,1591,1020541,1248821
1977-07-08,1977,281,D,2,2,8246,2358178,3002755,2101,1022642,1248821
1977-07-09,1977,282,D,2,2,8406,2366584,3002755,2530,1025172,1248821
1977-07-10,1977,283,D,2,2,8129,2374713,3002755,2241,1027413,1248821
1977-07-11,1977,284,D,2,2,8270,2382983,3002755,2292,1029705,1248821
1977-07-12,1977,285,D,2,2,8323,2391306,3002755,3159,1032864,1248821
1977-07-13,1977,286,D,2,2,8219,2399525,3002755,3102,1035966,1248821
1977-07-14,1977,287,D,2,2,7985,2407510,3002755,3182,1039148,1248821
1977-07-15,1977,288,D,2,2,7687,2415197,3002755,2932,1042080,1248821
1977-07-16,1977,289,D,2,2,7672,2422869,3002755,2928,1045008,1248821
1977-07-17,1977,290,D,2,2,7681,2430550,3002755,2937,1047945,1248821
1977-07-18,1977,291,D,2,2,7918,2438468,3002755,3166,1051111,1248821
1977-07-19,1977,292,D,2,2,8006,2446474,3002755,3246,1054357,1248821
1977-07-20,1977,293,D,2,2,7983,2454457,3002755,3271,1057628,1248821
1977-07-21,1977,294,D,2,2,8203,2462660,3002755,3196,1060824,1248821
1977-07-22,1977,295,D,2,2,8494,2471154,3002755,3336,1064160,1248821
1977-07-23,1977,296,D,2,2,8702,2479856,3002755,3452,1067612,1248821
1977-07-24,1977,297,D,2,2,9199,2489055,3002755,3297,1070909,1248821
1977-07-25,1977,298,D,2,2,9196,2498251,3002755,2972,1073881,1248821
1977-07-26,1977,299,D,2,2,9060,2507311,3002755,2464,1076345,1248821
1977-07-27,1977,300,D,2,2,8794,2516105,3002755,2936,1079281,1248821
1977-07-28,1977,301,D,2,2,8552,2524657,3002755,3556,1082837,1248821
1977-07-29,1977,302,D,2,2,8213,2532870,3002755,3577,1086414,1248821
1977-07-30,1977,303,D,2,2,8099,2540969,3002755,3468,1089882,1248821
1977-07-31,1977,304,D,2,2,8207,2549176,3002755,3560,1093442,1248821
1977-08-01,1977,305,D,2,2,8413,2557589,3002755,3768,1097210,1248821
1977-08-02,1977,306,D,2,2,8437,2566026,3002755,3788,1100998,1248821
1977-08-03,1977,307,D,2,2,8489,2574515,3002755,3901,1104899,1248821
1977-08-04,1977,308,D,2,2,8553,2583068,3002755,3159,1108058,1248821
1977-08-05,1977,309,D,2,2,8510,2591578,3002755,2813,1110871,1248821
1977-08-06,1977,310,D,2,2,8669,2600247,3002755,2983,1113854,1248821
1977-08-07,1977,311,D,2,2,8375,2608622,3002755,2756,1116610,1248821
1977-08-08,1977,312,D,2,2,8180,2616802,3002755,2756,1119366,1248821
1977-08-09,1977,313,D,2,2,8251,2625053,3002755,2798,1122164,1248821
1977-08-10,1977,314,D,2,2,8183,2633236,3002755,2978,1125142,1248821
1977-08-11,1977,315,D,2,2,7855,2641091,3002755,2964,1128106,1248821
1977-08-12,1977,316,D,2,2,7711,2648802,3002755,3271,1131377,1248821
1977-08-13,1977,317,D,2,2,7777,2656579,3002755,3396,1134773,1248821
1977-08-14,1977,318,D,2,2,7728,2664307,3002755,3329,1138102,1248821
1977-08-15,1977,319,D,2,2,7610,2671917,3002755,2692,1140794,1248821
1977-08-16,1977,320,D,2,2,7363,2679280,3002755,2296,1143090,1248821
1977-08-17,1977,321,D,2,2,7371,2686651,3002755,2427,1145517,1248821
1977-08-18,1977,322,D,2,2,7208,2693859,3002755,1825,1147342,1248821
1977-08-19,1977,323,D,2,2,7213,2701072,3002755,1218,1148560,1248821
1977-08-20,1977,324,D,2,2,7333,2708405,3002755,1522,1150082,1248821
1977-08-21,1977,325,D,2,2,7152,2715557,3002755,1277,1151359,1248821
1977-08-22,1977,326,D,2,2,7239,2722796,3002755,1221,1152580,1248821
1977-08-23,1977,327,D,2,2,7442,2730238,3002755,1655,1154235,1248821
1977-08-24,1977,328,D,2,2,8020,2738258,3002755,2689,1156924,1248821
1977-08-25,1977,329,D,2,2,7741,2745999,3002755,2197,1159121,1248821
1977-08-26,1977,330,D,2,2,7565,2753564,3002755,2119,1161240,1248821
1977-08-27,1977,331,D,2,2,7796,2761360,3002755,1809,1163049,1248821
1977-08-28,1977,332,D,2,2,7515,2768875,3002755,1156,1164205,1248821
1977-08-29,1977,333,D,2,2,7674,2776549,3002755,807,1165012,1248821
1977-08-30,1977,334,D,2,2,7678,2784227,3002755,676,1165688,1248821
1977-08-31,1977,335,D,2,2,7620,2791847,3002755,1615,1167303,1248821
1977-09-01,1977,336,D,2,2,7768,2799615,3002755,2454,1169757,1248821
1977-09-02,1977,337,D,2,2,7529,2807144,3002755,1894,1171651,1248821
1977-09-03,1977,338,D,2,2,7455,2814599,3002755,1833,1173484,1248821
1977-09-04,1977,339,D,2,2,7613,2822212,3002755,2006,1175490,1248821
1977-09-05,1977,340,D,2,2,7781,2829993,3002755,1803,1177293,1248821
1977-09-06,1977,341,D,2,2,7727,2837720,3002755,1406,1178699,1248821
1977-09-07,1977,342,D,2,2,7400,2845120,3002755,1649,1180348,1248821
1977-09-08,1977,343,D,2,2,7364,2852484,3002755,2271,1182619,1248821
1977-09-09,1977,344,D,2,2,7632,2860116,3002755,2511,1185130,1248821
1977-09-10,1977,345,D,2,2,7922,2868038,3002755,3196,1188326,1248821
1977-09-11,1977,346,D,2,2,7781,2875819,3002755,3045,1191371,1248821
1977-09-12,1977,347,D,2,2,7464,2883283,3002755,2717,1194088,1248821
1977-09-13,1977,348,D,2,2,7167,2890450,3002755,2482,1196570,1248821
1977-09-14,1977,349,D,2,2,7181,2897631,3002755,2846,1199416,1248821
1977-09-15,1977,350,D,2,2,6600,2904231,3002755,2202,1201618,1248821
1977-09-16,1977,351,D,2,2,6472,2910703,3002755,2270,1203888,1248821
1977-09-17,1977,352,D,2,2,6341,2917044,3002755,2257,1206145,1248821
1977-09-18,1977,353,D,2,2,6390,2923434,3002755,2526,1208671,1248821
1977-09-19,1977,354,D,2,2,7126,2930560,3002755,4844,1213515,1248821
1977-09-20,1977,355,D,2,2,7341,2937901,3002755,4969,1218484,1248821
1977-09-21,1977,356,D,2,2,7042,2944943,3002755,3896,1222380,1248821
1977-09-22,1977,357,D,2,2,7529,2952472,3002755,4359,1226739,1248821
1977-09-23,1977,358,D,2,2,7438,2959910,3002755,4027,1230766,1248821
1977-09-24,1977,359,D,2,2,6666,2966576,3002755,2437,1233203,1248821
1977-09-25,1977,360,D,2,2,6185,2972761,3002755,2307,1235510,1248821
1977-09-26,1977,361,D,2,2,6355,2979116,3002755,2700,1238210,1248821
1977-09-27,1977,362,D,2,2,6086,2985202,3002755,2532,1240742,1248821
1977-09-28,1977,363,D,2,2,5880,2991082,3002755,2682,1243424,1248821
1977-09-29,1977,364,D,2,2,6071,2997153,3002755,3029,1246453,1248821
1977-09-30,1977,365,D,2,2,5602,3002755,3002755,2368,1248821,1248821
1977-10-01,1978,1,N,1,1,5555,5555,13158315,1984,1984,10744901
1977-10-02,1978,2,N,1,1,5496,11051,13158315,1745,3729,10744901
1977-10-03,1978,3,N,1,1,5334,16385,13158315,1777,5506,10744901
1977-10-04,1978,4,N,1,1,5195,21580,13158315,1624,7130,10744901
1977-10-05,1978,5,N,1,1,5092,26672,13158315,2001,9131,10744901
1977-10-06,1978,6,N,1,1,5005,31677,13158315,1937,11068,10744901
1977-10-07,1978,7,N,1,1,4914,36591,13158315,1688,12756,10744901
1977-10-08,1978,8,N,1,1,4752,41343,13158315,1457,14213,10744901
1977-10-09,1978,9,N,1,1,4625,45968,13158315,1534,15747,10744901
1977-10-10,1978,10,N,1,1,4602,50570,13158315,1490,17237,10744901
1977-10-11,1978,11,N,1,1,4672,55242,13158315,1474,18711,10744901
1977-10-12,1978,12,N,1,1,4509,59751,13158315,1174,19885,10744901
1977-10-13,1978,13,N,1,1,4371,64122,13158315,1381,21266,10744901
1977-10-14,1978,14,N,1,1,4283,68405,13158315,1620,22886,10744901
1977-10-15,1978,15,N,1,1,4226,72631,13158315,1831,24717,10744901
1977-10-16,1978,16,N,1,1,4278,76909,13158315,2099,26816,10744901
1977-10-17,1978,17,N,1,1,4265,81174,13158315,2056,28872,10744901
1977-10-18,1978,18,N,1,1,4343,85517,13158315,2090,30962,10744901
1977-10-19,1978,19,N,1,1,4434,89951,13158315,2230,33192,10744901
1977-10-20,1978,20,N,1,1,4554,94505,13158315,2343,35535,10744901
1977-10-21,1978,21,N,1,1,4560,99065,13158315,2048,37583,10744901
1977-10-22,1978,22,N,1,1,4560,103625,13158315,1591,39174,10744901
1977-10-23,1978,23,N,1,1,4481,108106,13158315,1870,41044,10744901
1977-10-24,1978,24,N,1,1,4382,112488,13158315,1892,42936,10744901
1977-10-25,1978,25,N,1,1,4387,116875,13158315,2158,45094,10744901
1977-10-26,1978,26,N,1,1,4542,121417,13158315,2469,47563,10744901
1977-10-27,1978,27,N,1,1,4774,126191,13158315,2828,50391,10744901
1977-10-28,1978,28,N,1,1,4994,131185,13158315,2907,53298,10744901
1977-10-29,1978,29,N,1,1,5164,136349,13158315,3375,56673,10744901
1977-10-30,1978,30,N,1,1,5341,141690,13158315,3549,60222,10744901
1977-10-31,1978,31,N,1,1,5539,147229,13158315,3201,63423,10744901
1977-11-01,1978,32,N,1,1,5712,152941,13158315,2941,66364,10744901
1977-11-02,1978,33,N,1,1,5711,158652,13158315,2401,68765,10744901
1977-11-03,1978,34,N,1,1,5955,164607,13158315,2539,71304,10744901
1977-11-04,1978,35,N,1,1,6160,170767,13158315,2895,74199,10744901
1977-11-05,1978,36,N,1,1,6381,177148,13158315,5336,79535,10744901
1977-11-06,1978,37,N,1,1,6474,183622,13158315,5794,85329,10744901
1977-11-07,1978,38,N,1,1,6591,190213,13158315,5126,90455,10744901
1977-11-08,1978,39,N,1,1,6643,196856,13158315,5118,95573,10744901
1977-11-09,1978,40,N,1,1,6722,203578,13158315,5629,101202,10744901
1977-11-10,1978,41,N,1,1,6684,210262,13158315,3056,104258,10744901
1977-11-11,1978,42,N,1,1,6730,216992,13158315,3172,107430,10744901
1977-11-12,1978,43,N,1,1,6989,223981,13158315,4368,111798,10744901
1977-11-13,1978,44,N,1,1,6713,230694,13158315,3958,115756,10744901
1977-11-14,1978,45,N,1,1,6773,237467,13158315,3589,119345,10744901
1977-11-15,1978,46,N,1,1,6829,244296,13158315,2576,121921,10744901
1977-11-16,1978,47,N,1,1,6763,251059,13158315,2151,124072,10744901
1977-11-17,1978,48,N,1,1,6760,257819,13158315,2221,126293,10744901
1977-11-18,1978,49,N,1,1,6594,264413,13158315,2585,128878,10744901
1977-11-19,1978,50,N,1,1,6885,271298,13158315,3849,132727,10744901
1977-11-20,1978,51,N,1,1,6762,278060,13158315,3219,135946,10744901
1977-11-21,1978,52,N,1,1,7283,285343,13158315,3478,139424,10744901
1977-11-22,1978,53,N,1,1,7691,293034,13158315,9283,148707,10744901
1977-11-23,1978,54,N,1,1,8261,301295,13158315,8105,156812,10744901
1977-11-24,1978,55,N,1,1,9224,310519,13158315,7825,164637,10744901
1977-11-25,1978,56,N,1,1,9624,320143,13158315,7264,171901,10744901
1977-11-26,1978,57,N,1,1,9220,329363,13158315,6134,178035,10744901
1977-11-27,1978,58,N,1,1,8585,337948,13158315,1866,179901,10744901
1977-11-28,1978,59,N,1,1,8306,346254,13158315,1949,181850,10744901
1977-11-29,1978,60,N,1,1,7965,354219,13158315,1032,182882,10744901
1977-11-30,1978,61,N,1,1,7553,361772,13158315,644,183526,10744901
1977-12-01,1978,62,N,1,1,7564,369336,13158315,888,184414,10744901
1977-12-02,1978,63,N,1,1,7184,376520,13158315,928,185342,10744901
1977-12-03,1978,64,N,1,1,6957,383477,13158315,1116,186458,10744901
1977-12-04,1978,65,N,1,1,6756,390233,13158315,869,187327,10744901
1977-12-05,1978,66,N,1,1,6541,396774,13158315,703,188030,10744901
1977-12-06,1978,67,N,1,1,6379,403153,13158315,1787,189817,10744901
1977-12-07,1978,68,N,1,1,6150,409303,13158315,2068,191885,10744901
1977-12-08,1978,69,N,1,1,6107,415410,13158315,1395,193280,10744901
1977-12-09,1978,70,N,1,1,5925,421335,13158315,1825,195105,10744901
1977-12-10,1978,71,N,1,1,6019,427354,13158315,2846,197951,10744901
1977-12-11,1978,72,N,1,1,6332,433686,13158315,3590,201541,10744901
1977-12-12,1978,73,N,1,1,6464,440150,13158315,5076,206617,10744901
1977-12-13,1978,74,N,1,1,6698,446848,13158315,4404,211021,10744901
1977-12-14,1978,75,N,1,1,7176,454024,13158315,4158,215179,10744901
1977-12-15,1978,76,N,1,1,8376,462400,13158315,10900,226079,10744901
1977-12-16,1978,77,N,1,1,12255,474655,13158315,11778,237857,10744901
1977-12-17,1978,78,N,1,1,20661,495316,13158315,17145,255002,10744901
1977-12-18,1978,79,N,1,1,20129,515445,13158315,21269,276271,10744901
1977-12-19,1978,80,N,1,1,23034,538479,13158315,24260,300531,10744901
1977-12-20,1978,81,N,1,1,20953,559432,13158315,15570,316101,10744901
1977-12-21,1978,82,N,1,1,16915,576347,13158315,13952,330053,10744901
1977-12-22,1978,83,N,1,1,14193,590540,13158315,8294,338347,10744901
1977-12-23,1978,84,N,1,1,13049,603589,13158315,10682,349029,10744901
1977-12-24,1978,85,N,1,1,17042,620631,13158315,11992,361021,10744901
1977-12-25,1978,86,N,1,1,23894,644525,13158315,17510,378531,10744901
1977-12-26,1978,87,N,1,1,21748,666273,13158315,15735,394266,10744901
1977-12-27,1978,88,N,1,1,17725,683998,13158315,13020,407286,10744901
1977-12-28,1978,89,N,1,1,15147,699145,13158315,6000,413286,10744901
1977-12-29,1978,90,N,1,1,15759,714904,13158315,9666,422952,10744901
1977-12-30,1978,91,N,1,1,18228,733132,13158315,13656,436608,10744901
1977-12-31,1978,92,N,1,1,16937,750069,13158315,12584,449192,10744901
1978-01-01,1978,93,N,1,1,15286,765355,13158315,9859,459051,10744901
1978-01-02,1978,94,N,1,1,13812,779167,13158315,7207,466258,10744901
1978-01-03,1978,95,N,1,1,12653,791820,13158315,3854,470112,10744901
1978-01-04,1978,96,N,1,1,12858,804678,13158315,3107,473219,10744901
1978-01-05,1978,97,N,1,1,20582,825260,13158315,11699,484918,10744901
1978-01-06,1978,98,N,1,1,45429,870689,13158315,41829,526747,10744901
1978-01-07,1978,99,N,1,1,48890,919579,13158315,44445,571192,10744901
1978-01-08,1978,100,N,1,1,41657,961236,13158315,35792,606984,10744901
1978-01-09,1978,101,N,1,1,39851,1001087,13158315,40358,647342,10744901
1978-01-10,1978,102,N,1,1,47036,1048123,13158315,49457,696799,10744901
1978-01-11,1978,103,N,1,1,47766,1095889,13158315,46511,743310,10744901
1978-01-12,1978,104,N,1,1,50647,1146536,13158315,49510,792820,10744901
1978-01-13,1978,105,N,1,1,59979,1206515,13158315,60908,853728,10744901
1978-01-14,1978,106,N,1,1,76352,1282867,13158315,75656,929384,10744901
1978-01-15,1978,107,N,1,1,106441,1389308,13158315,106583,1035967,10744901
1978-01-16,1978,108,N,1,1,132136,1521444,13158315,134232,1170199,10744901
1978-01-17,1978,109,N,1,1,171251,1692695,13158315,177315,1347514,10744901
1978-01-18,1978,110,N,1,1,174450,1867145,13158315,177545,1525059,10744901
1978-01-19,1978,111,N,1,1,168884,2036029,13158315,169662,1694721,10744901
1978-01-20,1978,112,N,1,1,147931,2183960,13158315,145964,1840685,10744901
1978-01-21,1978,113,N,1,1,128872,2312832,13158315,124815,1965500,10744901
1978-01-22,1978,114,N,1,1,112820,2425652,13158315,105316,2070816,10744901
1978-01-23,1978,115,N,1,1,97216,2522868,13158315,89774,2160590,10744901
1978-01-24,1978,116,N,1,1,79530,2602398,13158315,68969,2229559,10744901
1978-01-25,1978,117,N,1,1,69806,2672204,13158315,58870,2288429,10744901
1978-01-26,1978,118,N,1,1,60811,2733015,13158315,49867,2338296,10744901
1978-01-27,1978,119,N,1,1,52529,2785544,13158315,41795,2380091,10744901
1978-01-28,1978,120,N,1,1,46218,2831762,13158315,35465,2415556,10744901
1978-01-29,1978,121,N,1,1,41729,2873491,13158315,31082,2446638,10744901
1978-01-30,1978,122,N,1,1,39042,2912533,13158315,28471,2475109,10744901
1978-01-31,1978,123,N,1,1,35348,2947881,13158315,24951,2500060,10744901
1978-02-01,1978,124,N,1,1,31701,2979582,13158315,21084,2521144,10744901
1978-02-02,1978,125,N,1,1,28841,3008423,13158315,17722,2538866,10744901
1978-02-03,1978,126,N,1,1,26411,3034834,13158315,15135,2554001,10744901
1978-02-04,1978,127,N,1,1,24675,3059509,13158315,13485,2567486,10744901
1978-02-05,1978,128,N,1,1,25861,3085370,13158315,13896,2581382,10744901
1978-02-06,1978,129,N,1,1,29019,3114389,13158315,20824,2602206,10744901
1978-02-07,1978,130,N,1,1,53655,3168044,13158315,49807,2652013,10744901
1978-02-08,1978,131,N,1,1,69408,3237452,13158315,70144,2722157,10744901
1978-02-09,1978,132,N,1,1,79507,3316959,13158315,83538,2805695,10744901
1978-02-10,1978,133,N,1,1,97751,3414710,13158315,102991,2908686,10744901
1978-02-11,1978,134,N,1,1,118795,3533505,13158315,120846,3029532,10744901
1978-02-12,1978,135,N,1,1,107879,3641384,13158315,105364,3134896,10744901
1978-02-13,1978,136,N,1,1,106956,3748340,13158315,102312,3237208,10744901
1978-02-14,1978,137,N,1,1,104460,3852800,13158315,98286,3335494,10744901
1978-02-15,1978,138,N,1,1,97763,3950563,13158315,91501,3426995,10744901
1978-02-16,1978,139,N,1,1,90374,4040937,13158315,83900,3510895,10744901
1978-02-17,1978,140,N,1,1,85060,4125997,13158315,77831,3588726,10744901
1978-02-18,1978,141,N,1,1,81083,4207080,13158315,72108,3660834,10744901
1978-02-19,1978,142,N,1,1,77153,4284233,13158315,65989,3726823,10744901
1978-02-20,1978,143,N,1,1,71885,4356118,13158315,60511,3787334,10744901
1978-02-21,1978,144,N,1,1,64929,4421047,13158315,53457,3840791,10744901
1978-02-22,1978,145,N,1,1,57759,4478806,13158315,46373,3887164,10744901
1978-02-23,1978,146,N,1,1,52805,4531611,13158315,41495,3928659,10744901
1978-02-24,1978,147,N,1,1,48888,4580499,13158315,37414,3966073,10744901
1978-02-25,1978,148,N,1,1,43865,4624364,13158315,32807,3998880,10744901
1978-02-26,1978,149,N,1,1,39117,4663481,13158315,27733,4026613,10744901
1978-02-27,1978,150,N,1,1,35729,4699210,13158315,24521,4051134,10744901
1978-02-28,1978,151,N,1,1,32393,4731603,13158315,21366,4072500,10744901
1978-03-01,1978,152,N,1,1,31755,4763358,13158315,20413,4092913,10744901
1978-03-02,1978,153,N,1,1,33525,4796883,13158315,26152,4119065,10744901
1978-03-03,1978,154,N,1,1,41571,4838454,13158315,35912,4154977,10744901
1978-03-04,1978,155,N,1,1,60917,4899371,13158315,58355,4213332,10744901
1978-03-05,1978,156,N,1,1,86871,4986242,13158315,89352,4302684,10744901
1978-03-06,1978,157,N,1,1,104396,5090638,13158315,109750,4412434,10744901
1978-03-07,1978,158,N,1,1,142636,5233274,13158315,146479,4558913,10744901
1978-03-08,1978,159,N,1,1,148124,5381398,13158315,151260,4710173,10744901
1978-03-09,1978,160,N,1,1,145224,5526622,13158315,146986,4857159,10744901
1978-03-10,1978,161,N,1,1,142622,5669244,13158315,140974,4998133,10744901
1978-03-11,1978,162,N,1,1,143190,5812434,13158315,140947,5139080,10744901
1978-03-12,1978,163,N,1,1,144519,5956953,13158315,144503,5283583,10744901
1978-03-13,1978,164,N,1,1,140057,6097010,13158315,140025,5423608,10744901
1978-03-14,1978,165,N,1,1,134737,6231747,13158315,131658,5555266,10744901
1978-03-15,1978,166,N,1,1,128064,6359811,13158315,124823,5680089,10744901
1978-03-16,1978,167,N,1,1,122193,6482004,13158315,117993,5798082,10744901
1978-03-17,1978,168,N,1,1,115710,6597714,13158315,109166,5907248,10744901
1978-03-18,1978,169,N,1,1,105644,6703358,13158315,99969,6007217,10744901
1978-03-19,1978,170,N,1,1,91643,6795001,13158315,84290,6091507,10744901
1978-03-20,1978,171,N,1,1,83768,6878769,13158315,77525,6169032,10744901
1978-03-21,1978,172,N,1,1,75917,6954686,13158315,72993,6242025,10744901
1978-03-22,1978,173,N,1,1,68014,7022700,13158315,67881,6309906,10744901
1978-03-23,1978,174,N,1,1,61296,7083996,13158315,61625,6371531,10744901
1978-03-24,1978,175,N,1,1,56467,7140463,13158315,56919,6428450,10744901
1978-03-25,1978,176,N,1,1,53365,7193828,13158315,53349,6481799,10744901
1978-03-26,1978,177,N,1,1,50173,7244001,13158315,45440,6527239,10744901
1978-03-27,1978,178,N,1,1,48502,7292503,13158315,41156,6568395,10744901
1978-03-28,1978,179,N,1,1,47351,7339854,13158315,40139,6608534,10744901
1978-03-29,1978,180,N,1,1,46547,7386401,13158315,39673,6648207,10744901
1978-03-30,1978,181,N,1,1,45568,7431969,13158315,38397,6686604,10744901
1978-03-31,1978,182,N,1,1,45859,7477828,13158315,40073,6726677,10744901
1978-04-01,1978,183,N,1,1,46980,7524808,13158315,44148,6770825,10744901
1978-04-02,1978,184,N,1,1,47777,7572585,13158315,44563,6815388,10744901
1978-04-03,1978,185,N,1,1,51327,7623912,13158315,48032,6863420,10744901
1978-04-04,1978,186,N,1,1,54247,7678159,13158315,54610,6918030,10744901
1978-04-05,1978,187,N,1,1,54221,7732380,13158315,53946,6971976,10744901
1978-04-06,1978,188,N,1,1,58205,7790585,13158315,56480,7028456,10744901
1978-04-07,1978,189,N,1,1,66410,7856995,13158315,64673,7093129,10744901
1978-04-08,1978,190,N,1,1,71407,7928402,13158315,69650,7162779,10744901
1978-04-09,1978,191,N,1,1,72923,8001325,13158315,68940,7231719,10744901
1978-04-10,1978,192,N,1,1,73352,8074677,13158315,65815,7297534,10744901
1978-04-11,1978,193,N,1,1,72140,8146817,13158315,64666,7362200,10744901
1978-04-12,1978,194,N,1,1,70387,8217204,13158315,63926,7426126,10744901
1978-04-13,1978,195,N,1,1,68928,8286132,13158315,62230,7488356,10744901
1978-04-14,1978,196,N,1,1,66985,8353117,13158315,60926,7549282,10744901
1978-04-15,1978,197,N,1,1,65370,8418487,13158315,59533,7608815,10744901
1978-04-16,1978,198,N,1,1,66056,8484543,13158315,63639,7672454,10744901
1978-04-17,1978,199,N,1,1,67190,8551733,13158315,66659,7739113,10744901
1978-04-18,1978,200,N,1,1,66911,8618644,13158315,67729,7806842,10744901
1978-04-19,1978,201,N,1,1,65870,8684514,13158315,66312,7873154,10744901
1978-04-20,1978,202,N,1,1,64446,8748960,13158315,64626,7937780,10744901
1978-04-21,1978,203,N,1,1,63376,8812336,13158315,60776,7998556,10744901
1978-04-22,1978,204,N,1,1,61677,8874013,13158315,59073,8057629,10744901
1978-04-23,1978,205,N,1,1,59803,8933816,13158315,57196,8114825,10744901
1978-04-24,1978,206,N,1,1,57497,8991313,13158315,53454,8168279,10744901
1978-04-25,1978,207,N,1,1,58829,9050142,13158315,58457,8226736,10744901
1978-04-26,1978,208,N,1,1,65534,9115676,13158315,65278,8292014,10744901
1978-04-27,1978,209,N,1,1,69284,9184960,13158315,69088,8361102,10744901
1978-04-28,1978,210,N,1,1,70752,9255712,13158315,69838,8430940,10744901
1978-04-29,1978,211,N,1,1,68167,9323879,13158315,67869,8498809,10744901
1978-04-30,1978,212,N,1,1,66200,9390079,13158315,62972,8561781,10744901
1978-05-01,1978,213,N,1,1,66677,9456756,13158315,63349,8625130,10744901
1978-05-02,1978,214,N,1,1,66049,9522805,13158315,62713,8687843,10744901
1978-05-03,1978,215,N,1,1,66925,9589730,13158315,62616,8750459,10744901
1978-05-04,1978,216,N,1,1,66049,9655779,13158315,62604,8813063,10744901
1978-05-05,1978,217,N,1,1,64657,9720436,13158315,60258,8873321,10744901
1978-05-06,1978,218,N,1,1,63495,9783931,13158315,59680,8933001,10744901
1978-05-07,1978,219,N,1,1,62026,9845957,13158315,57215,8990216,10744901
1978-05-08,1978,220,N,1,1,59861,9905818,13158315,56370,9046586,10744901
1978-05-09,1978,221,N,1,1,58204,9964022,13158315,53342,9099928,10744901
1978-05-10,1978,222,N,1,1,55937,10019959,13158315,51648,9151576,10744901
1978-05-11,1978,223,N,1,1,53061,10073020,13158315,49453,9201029,10744901
1978-05-12,1978,224,N,1,1,48503,10121523,13158315,43757,9244786,10744901
1978-05-13,1978,225,N,1,1,45946,10167469,13158315,40769,9285555,10744901
1978-05-14,1978,226,N,1,1,44122,10211591,13158315,38856,9324411,10744901
1978-05-15,1978,227,N,1,1,42929,10254520,13158315,37084,9361495,10744901
1978-05-16,1978,228,N,1,1,41381,10295901,13158315,35638,9397133,10744901
1978-05-17,1978,229,N,1,1,40643,10336544,13158315,34601,9431734,10744901
1978-05-18,1978,230,N,1,1,40233,10376777,13158315,33909,9465643,10744901
1978-05-19,1978,231,N,1,1,37804,10414581,13158315,32727,9498370,10744901
1978-05-20,1978,232,N,1,1,37086,10451667,13158315,29817,9528187,10744901
1978-05-21,1978,233,N,1,1,36703,10488370,13158315,29301,9557488,10744901
1978-05-22,1978,234,N,1,1,36305,10524675,13158315,29642,9587130,10744901
1978-05-23,1978,235,N,1,1,36372,10561047,13158315,30038,9617168,10744901
1978-05-24,1978,236,N,1,1,36635,10597682,13158315,30573,9647741,10744901
1978-05-25,1978,237,N,1,1,36484,10634166,13158315,30001,9677742,10744901
1978-05-26,1978,238,N,1,1,34280,10668446,13158315,27439,9705181,10744901
1978-05-27,1978,239,N,1,1,33625,10702071,13158315,26986,9732167,10744901
1978-05-28,1978,240,N,1,1,31827,10733898,13158315,24477,9756644,10744901
1978-05-29,1978,241,N,1,1,30256,10764154,13158315,22863,9779507,10744901
1978-05-30,1978,242,N,1,1,29780,10793934,13158315,23267,9802774,10744901
1978-05-31,1978,243,N,1,1,29770,10823704,13158315,22532,9825306,10744901
1978-06-01,1978,244,N,1,1,28721,10852425,13158315,19288,9844594,10744901
1978-06-02,1978,245,N,1,1,26541,10878966,13158315,17972,9862566,10744901
1978-06-03,1978,246,N,1,1,25415,10904381,13158315,15582,9878148,10744901
1978-06-04,1978,247,N,1,1,24703,10929084,13158315,13523,9891671,10744901
1978-06-05,1978,248,N,1,1,24267,10953351,13158315,14641,9906312,10744901
1978-06-06,1978,249,N,1,1,24399,10977750,13158315,15436,9921748,10744901
1978-06-07,1978,250,N,1,1,24482,11002232,13158315,15037,9936785,10744901
1978-06-08,1978,251,N,1,1,24169,11026401,13158315,14843,9951628,10744901
1978-06-09,1978,252,N,1,1,22321,11048722,13158315,12593,9964221,10744901
1978-06-10,1978,253,N,1,1,21568,11070290,13158315,10770,9974991,10744901
1978-06-11,1978,254,N,1,1,21480,11091770,13158315,9893,9984884,10744901
1978-06-12,1978,255,N,1,1,21300,11113070,13158315,8645,9993529,10744901
1978-06-13,1978,256,N,1,1,20284,11133354,13158315,8279,10001808,10744901
1978-06-14,1978,257,N,1,1,19126,11152480,13158315,7369,10009177,10744901
1978-06-15,1978,258,N,1,1,18670,11171150,13158315,6903,10016080,10744901
1978-06-16,1978,259,N,1,1,19312,11190462,13158315,7490,10023570,10744901
1978-06-17,1978,260,N,1,1,19907,11210369,13158315,6379,10029949,10744901
1978-06-18,1978,261,N,1,1,20513,11230882,13158315,5481,10035430,10744901
1978-06-19,1978,262,N,1,1,20100,11250982,13158315,6722,10042152,10744901
1978-06-20,1978,263,N,1,1,19246,11270228,13158315,6781,10048933,10744901
1978-06-21,1978,264,N,1,1,17891,11288119,13158315,5774,10054707,10744901
1978-06-22,1978,265,N,1,1,16840,11304959,13158315,4508,10059215,10744901
1978-06-23,1978,266,N,1,1,16484,11321443,13158315,4609,10063824,10744901
1978-06-24,1978,267,N,1,1,16247,11337690,13158315,4546,10068370,10744901
1978-06-25,1978,268,N,1,1,16643,11354333,13158315,4527,10072897,10744901
1978-06-26,1978,269,N,1,1,16795,11371128,13158315,4157,10077054,10744901
1978-06-27,1978,270,N,1,1,16764,11387892,13158315,4176,10081230,10744901
1978-06-28,1978,271,N,1,1,16631,11404523,13158315,4528,10085758,10744901
1978-06-29,1978,272,N,1,1,16541,11421064,13158315,4313,10090071,10744901
1978-06-30,1978,273,N,1,1,16233,11437297,13158315,3597,10093668,10744901
1978-07-01,1978,274,N,1,1,16297,11453594,13158315,3636,10097304,10744901
1978-07-02,1978,275,N,1,1,16130,11469724,13158315,3473,10100777,10744901
1978-07-03,1978,276,N,1,1,16007,11485731,13158315,3346,10104123,10744901
1978-07-04,1978,277,N,1,1,16308,11502039,13158315,3415,10107538,10744901
1978-07-05,1978,278,N,1,1,16432,11518471,13158315,3005,10110543,10744901
1978-07-06,1978,279,N,1,1,16038,11534509,13158315,2963,10113506,10744901
1978-07-07,1978,280,N,1,1,16304,11550813,13158315,4245,10117751,10744901
1978-07-08,1978,281,N,1,1,16199,11567012,13158315,4018,10121769,10744901
1978-07-09,1978,282,N,1,1,15935,11582947,13158315,4045,10125814,10744901
1978-07-10,1978,283,N,1,1,16004,11598951,13158315,4138,10129952,10744901
1978-07-11,1978,284,N,1,1,16002,11614953,13158315,4412,10134364,10744901
1978-07-12,1978,285,N,1,1,16187,11631140,13158315,4598,10138962,10744901
1978-07-13,1978,286,N,1,1,16219,11647359,13158315,4338,10143300,10744901
1978-07-14,1978,287,N,1,1,16073,11663432,13158315,3978,10147278,10744901
1978-07-15,1978,288,N,1,1,16219,11679651,13158315,4297,10151575,10744901
1978-07-16,1978,289,N,1,1,16431,11696082,13158315,4538,10156113,10744901
1978-07-17,1978,290,N,1,1,16930,11713012,13158315,4514,10160627,10744901
1978-07-18,1978,291,N,1,1,16769,11729781,13158315,4111,10164738,10744901
1978-07-19,1978,292,N,1,1,16615,11746396,13158315,4268,10169006,10744901
1978-07-20,1978,293,N,1,1,16657,11763053,13158315,4384,10173390,10744901
1978-07-21,1978,294,N,1,1,16573,11779626,13158315,4041,10177431,10744901
1978-07-22,1978,295,N,1,1,16602,11796228,13158315,4043,10181474,10744901
1978-07-23,1978,296,N,1,1,17147,11813375,13158315,4695,10186169,10744901
1978-07-24,1978,297,N,1,1,16754,11830129,13158315,4743,10190912,10744901
1978-07-25,1978,298,N,1,1,16608,11846737,13158315,4725,10195637,10744901
1978-07-26,1978,299,N,1,1,16642,11863379,13158315,4522,10200159,10744901
1978-07-27,1978,300,N,1,1,16711,11880090,13158315,4638,10204797,10744901
1978-07-28,1978,301,N,1,1,16653,11896743,13158315,4468,10209265,10744901
1978-07-29,1978,302,N,1,1,16468,11913211,13158315,1320,10210585,10744901
1978-07-30,1978,303,N,1,1,16251,11929462,13158315,970,10211555,10744901
1978-07-31,1978,304,N,1,1,16658,11946120,13158315,1575,10213130,10744901
1978-08-01,1978,305,N,1,1,16922,11963042,13158315,3936,10217066,10744901
1978-08-02,1978,306,N,1,1,17585,11980627,13158315,8335,10225401,10744901
1978-08-03,1978,307,N,1,1,17740,11998367,13158315,8571,10233972,10744901
1978-08-04,1978,308,N,1,1,17445,12015812,13158315,7981,10241953,10744901
1978-08-05,1978,309,N,1,1,17784,12033596,13158315,5117,10247070,10744901
1978-08-06,1978,310,N,1,1,18323,12051919,13158315,5132,10252202,10744901
1978-08-07,1978,311,N,1,1,18548,12070467,13158315,5171,10257373,10744901
1978-08-08,1978,312,N,1,1,18573,12089040,13158315,5004,10262377,10744901
1978-08-09,1978,313,N,1,1,18695,12107735,13158315,6078,10268455,10744901
1978-08-10,1978,314,N,1,1,18886,12126621,13158315,5804,10274259,10744901
1978-08-11,1978,315,N,1,1,18890,12145511,13158315,5814,10280073,10744901
1978-08-12,1978,316,N,1,1,18652,12164163,13158315,5587,10285660,10744901
1978-08-13,1978,317,N,1,1,18446,12182609,13158315,5818,10291478,10744901
1978-08-14,1978,318,N,1,1,18276,12200885,13158315,5762,10297240,10744901
1978-08-15,1978,319,N,1,1,18482,12219367,13158315,5741,10302981,10744901
1978-08-16,1978,320,N,1,1,17895,12237262,13158315,5751,10308732,10744901
1978-08-17,1978,321,N,1,1,17160,12254422,13158315,5819,10314551,10744901
1978-08-18,1978,322,N,1,1,17229,12271651,13158315,5795,10320346,10744901
1978-08-19,1978,323,N,1,1,17260,12288911,13158315,5905,10326251,10744901
1978-08-20,1978,324,N,1,1,17349,12306260,13158315,5946,10332197,10744901
1978-08-21,1978,325,N,1,1,17301,12323561,13158315,5823,10338020,10744901
1978-08-22,1978,326,N,1,1,16827,12340388,13158315,5615,10343635,10744901
1978-08-23,1978,327,N,1,1,16556,12356944,13158315,5020,10348655,10744901
1978-08-24,1978,328,N,1,1,16784,12373728,13158315,5316,10353971,10744901
1978-08-25,1978,329,N,1,1,16899,12390627,13158315,5466,10359437,10744901
1978-08-26,1978,330,N,1,1,17862,12408489,13158315,5526,10364963,10744901
1978-08-27,1978,331,N,1,1,18810,12427299,13158315,5242,10370205,10744901
1978-08-28,1978,332,N,1,1,19674,12446973,13158315,5431,10375636,10744901
1978-08-29,1978,333,N,1,1,20177,12467150,13158315,5672,10381308,10744901
1978-08-30,1978,334,N,1,1,20609,12487759,13158315,5979,10387287,10744901
1978-08-31,1978,335,N,1,1,20645,12508404,13158315,6075,10393362,10744901
1978-09-01,1978,336,N,1,1,20610,12529014,13158315,6274,10399636,10744901
1978-09-02,1978,337,N,1,1,20520,12549534,13158315,5828,10405464,10744901
1978-09-03,1978,338,N,1,1,20654,12570188,13158315,6106,10411570,10744901
1978-09-04,1978,339,N,1,1,20915,12591103,13158315,7783,10419353,10744901
1978-09-05,1978,340,N,1,1,21128,12612231,13158315,7860,10427213,10744901
1978-09-06,1978,341,N,1,1,21888,12634119,13158315,10919,10438132,10744901
1978-09-07,1978,342,N,1,1,22599,12656718,13158315,13606,10451738,10744901
1978-09-08,1978,343,N,1,1,23160,12679878,13158315,13119,10464857,10744901
1978-09-09,1978,344,N,1,1,23088,12702966,13158315,11601,10476458,10744901
1978-09-10,1978,345,N,1,1,23811,12726777,13158315,13135,10489593,10744901
1978-09-11,1978,346,N,1,1,24257,12751034,13158315,13294,10502887,10744901
1978-09-12,1978,347,N,1,1,24418,12775452,13158315,13752,10516639,10744901
1978-09-13,1978,348,N,1,1,24455,12799907,13158315,13635,10530274,10744901
1978-09-14,1978,349,N,1,1,22616,12822523,13158315,11434,10541708,10744901
1978-09-15,1978,350,N,1,1,22573,12845096,13158315,11371,10553079,10744901
1978-09-16,1978,351,N,1,1,23052,12868148,13158315,12778,10565857,10744901
1978-09-17,1978,352,N,1,1,22621,12890769,13158315,12781,10578638,10744901
1978-09-18,1978,353,N,1,1,22129,12912898,13158315,12963,10591601,10744901
1978-09-19,1978,354,N,1,1,21629,12934527,13158315,13485,10605086,10744901
1978-09-20,1978,355,N,1,1,21050,12955577,13158315,12722,10617808,10744901
1978-09-21,1978,356,N,1,1,20586,12976163,13158315,12906,10630714,10744901
1978-09-22,1978,357,N,1,1,20500,12996663,13158315,12953,10643667,10744901
1978-09-23,1978,358,N,1,1,20366,13017029,13158315,12963,10656630,10744901
1978-09-24,1978,359,N,1,1,20455,13037484,13158315,12748,10669378,10744901
1978-09-25,1978,360,N,1,1,20472,13057956,13158315,12900,10682278,10744901
1978-09-26,1978,361,N,1,1,20277,13078233,13158315,12964,10695242,10744901
1978-09-27,1978,362,N,1,1,20162,13098395,13158315,13318,10708560,10744901
1978-09-28,1978,363,N,1,1,20063,13118458,13158315,12378,10720938,10744901
1978-09-29,1978,364,N,1,1,19854,13138312,13158315,12236,10733174,10744901
1978-09-30,1978,365,N,1,1,20003,13158315,13158315,11727,10744901,10744901
1978-10-01,1979,1,N,2,2,19905,19905,8452028,11237,11237,5748938
1978-10-02,1979,2,N,2,2,19723,39628,8452028,16335,27572,5748938
1978-10-03,1979,3,N,2,2,19449,59077,8452028,16449,44021,5748938
1978-10-04,1979,4,N,2,2,19536,78613,8452028,16533,60554,5748938
1978-10-05,1979,5,N,2,2,18702,97315,8452028,15549,76103,5748938
1978-10-06,1979,6,N,2,2,18404,115719,8452028,10027,86130,5748938
1978-10-07,1979,7,N,2,2,18314,134033,8452028,9951,96081,5748938
1978-10-08,1979,8,N,2,2,18122,152155,8452028,9733,105814,5748938
1978-10-09,1979,9,N,2,2,18419,170574,8452028,10060,115874,5748938
1978-10-10,1979,10,N,2,2,17552,188126,8452028,11111,126985,5748938
1978-10-11,1979,11,N,2,2,16573,204699,8452028,10178,137163,5748938
1978-10-12,1979,12,N,2,2,16688,221387,8452028,9983,147146,5748938
1978-10-13,1979,13,N,2,2,16550,237937,8452028,9546,156692,5748938
1978-10-14,1979,14,N,2,2,16144,254081,8452028,8947,165639,5748938
1978-10-15,1979,15,N,2,2,16070,270151,8452028,7928,173567,5748938
1978-10-16,1979,16,N,2,2,15854,286005,8452028,8453,182020,5748938
1978-10-17,1979,17,N,2,2,15438,301443,8452028,8163,190183,5748938
1978-10-18,1979,18,N,2,2,14979,316422,8452028,7433,197616,5748938
1978-10-19,1979,19,N,2,2,14947,331369,8452028,8038,205654,5748938
1978-10-20,1979,20,N,2,2,14907,346276,8452028,8026,213680,5748938
1978-10-21,1979,21,N,2,2,14843,361119,8452028,7957,221637,5748938
1978-10-22,1979,22,N,2,2,14627,375746,8452028,7736,229373,5748938
1978-10-23,1979,23,N,2,2,14795,390541,8452028,7719,237092,5748938
1978-10-24,1979,24,N,2,2,15082,405623,8452028,7042,244134,5748938
1978-10-25,1979,25,N,2,2,15345,420968,8452028,7190,251324,5748938
1978-10-26,1979,26,N,2,2,15634,436602,8452028,8364,259688,5748938
1978-10-27,1979,27,N,2,2,16042,452644,8452028,8893,268581,5748938
1978-10-28,1979,28,N,2,2,15705,468349,8452028,7301,275882,5748938
1978-10-29,1979,29,N,2,2,15864,484213,8452028,6679,282561,5748938
1978-10-30,1979,30,N,2,2,15568,499781,8452028,7124,289685,5748938
1978-10-31,1979,31,N,2,2,15427,515208,8452028,7914,297599,5748938
1978-11-01,1979,32,N,2,2,15710,530918,8452028,8544,306143,5748938
1978-11-02,1979,33,N,2,2,15578,546496,8452028,8487,314630,5748938
1978-11-03,1979,34,N,2,2,16065,562561,8452028,9131,323761,5748938
1978-11-04,1979,35,N,2,2,16028,578589,8452028,8357,332118,5748938
1978-11-05,1979,36,N,2,2,15933,594522,8452028,6882,339000,5748938
1978-11-06,1979,37,N,2,2,15875,610397,8452028,7547,346547,5748938
1978-11-07,1979,38,N,2,2,15602,625999,8452028,9261,355808,5748938
1978-11-08,1979,39,N,2,2,15371,641370,8452028,8966,364774,5748938
1978-11-09,1979,40,N,2,2,15329,656699,8452028,8509,373283,5748938
1978-11-10,1979,41,N,2,2,15456,672155,8452028,7466,380749,5748938
1978-11-11,1979,42,N,2,2,15540,687695,8452028,8431,389180,5748938
1978-11-12,1979,43,N,2,2,15710,703405,8452028,8981,398161,5748938
1978-11-13,1979,44,N,2,2,15693,719098,8452028,11380,409541,5748938
1978-11-14,1979,45,N,2,2,15686,734784,8452028,11152,420693,5748938
1978-11-15,1979,46,N,2,2,15706,750490,8452028,11066,431759,5748938
1978-11-16,1979,47,N,2,2,15541,766031,8452028,10792,442551,5748938
1978-11-17,1979,48,N,2,2,15579,781610,8452028,10848,453399,5748938
1978-11-18,1979,49,N,2,2,15421,797031,8452028,7276,460675,5748938
1978-11-19,1979,50,N,2,2,15612,812643,8452028,6596,467271,5748938
1978-11-20,1979,51,N,2,2,16544,829187,8452028,8607,475878,5748938
1978-11-21,1979,52,N,2,2,17841,847028,8452028,15190,491068,5748938
1978-11-22,1979,53,N,2,2,19505,866533,8452028,20521,511589,5748938
1978-11-23,1979,54,N,2,2,19831,886364,8452028,22300,533889,5748938
1978-11-24,1979,55,N,2,2,19169,905533,8452028,21401,555290,5748938
1978-11-25,1979,56,N,2,2,18115,923648,8452028,18474,573764,5748938
1978-11-26,1979,57,N,2,2,17378,941026,8452028,13408,587172,5748938
1978-11-27,1979,58,N,2,2,16881,957907,8452028,10281,597453,5748938
1978-11-28,1979,59,N,2,2,16528,974435,8452028,9413,606866,5748938
1978-11-29,1979,60,N,2,2,16492,990927,8452028,9263,616129,5748938
1978-11-30,1979,61,N,2,2,16707,1007634,8452028,9312,625441,5748938
1978-12-01,1979,62,N,2,2,16695,1024329,8452028,10025,635466,5748938
1978-12-02,1979,63,N,2,2,16720,1041049,8452028,10225,645691,5748938
1978-12-03,1979,64,N,2,2,16986,1058035,8452028,9246,654937,5748938
1978-12-04,1979,65,N,2,2,16843,1074878,8452028,10070,665007,5748938
1978-12-05,1979,66,N,2,2,16279,1091157,8452028,10713,675720,5748938
1978-12-06,1979,67,N,2,2,16022,1107179,8452028,9855,685575,5748938
1978-12-07,1979,68,N,2,2,16048,1123227,8452028,9618,695193,5748938
1978-12-08,1979,69,N,2,2,16151,1139378,8452028,9001,704194,5748938
1978-12-09,1979,70,N,2,2,16008,1155386,8452028,8092,712286,5748938
1978-12-10,1979,71,N,2,2,16026,1171412,8452028,7327,719613,5748938
1978-12-11,1979,72,N,2,2,16043,1187455,8452028,8109,727722,5748938
1978-12-12,1979,73,N,2,2,16096,1203551,8452028,8366,736088,5748938
1978-12-13,1979,74,N,2,2,16132,1219683,8452028,7964,744052,5748938
1978-12-14,1979,75,N,2,2,15950,1235633,8452028,7878,751930,5748938
1978-12-15,1979,76,N,2,2,15873,1251506,8452028,7915,759845,5748938
1978-12-16,1979,77,N,2,2,15750,1267256,8452028,6722,766567,5748938
1978-12-17,1979,78,N,2,2,16051,1283307,8452028,5918,772485,5748938
1978-12-18,1979,79,N,2,2,16363,1299670,8452028,8529,781014,5748938
1978-12-19,1979,80,N,2,2,16685,1316355,8452028,11154,792168,5748938
1978-12-20,1979,81,N,2,2,16646,1333001,8452028,10630,802798,5748938
1978-12-21,1979,82,N,2,2,16238,1349239,8452028,11303,814101,5748938
1978-12-22,1979,83,N,2,2,16645,1365884,8452028,10100,824201,5748938
1978-12-23,1979,84,N,2,2,16922,1382806,8452028,8274,832475,5748938
1978-12-24,1979,85,N,2,2,17069,1399875,8452028,8049,840524,5748938
1978-12-25,1979,86,N,2,2,16544,1416419,8452028,7388,847912,5748938
1978-12-26,1979,87,N,2,2,15953,1432372,8452028,7519,855431,5748938
1978-12-27,1979,88,N,2,2,15642,1448014,8452028,7335,862766,5748938
1978-12-28,1979,89,N,2,2,16313,1464327,8452028,9011,871777,5748938
1978-12-29,1979,90,N,2,2,16513,1480840,8452028,8615,880392,5748938
1978-12-30,1979,91,N,2,2,16522,1497362,8452028,8529,888921,5748938
1978-12-31,1979,92,N,2,2,16648,1514010,8452028,8691,897612,5748938
1979-01-01,1979,93,N,2,2,16279,1530289,8452028,9502,907114,5748938
1979-01-02,1979,94,N,2,2,15590,1545879,8452028,10202,917316,5748938
1979-01-03,1979,95,N,2,2,15468,1561347,8452028,9970,927286,5748938
1979-01-04,1979,96,N,2,2,16826,1578173,8452028,11336,938622,5748938
1979-01-05,1979,97,N,2,2,17084,1595257,8452028,7988,946610,5748938
1979-01-06,1979,98,N,2,2,17015,1612272,8452028,8797,955407,5748938
1979-01-07,1979,99,N,2,2,16979,1629251,8452028,9983,965390,5748938
1979-01-08,1979,100,N,2,2,17083,1646334,8452028,12201,977591,5748938
1979-01-09,1979,101,N,2,2,17825,1664159,8452028,19976,997567,5748938
1979-01-10,1979,102,N,2,2,20288,1684447,8452028,23152,1020719,5748938
1979-01-11,1979,103,N,2,2,27279,1711726,8452028,36932,1057651,5748938
1979-01-12,1979,104,N,2,2,43621,1755347,8452028,59302,1116953,5748938
1979-01-13,1979,105,N,2,2,46262,1801609,8452028,59010,1175963,5748938
1979-01-14,1979,106,N,2,2,45835,1847444,8452028,52839,1228802,5748938
1979-01-15,1979,107,N,2,2,51987,1899431,8452028,65795,1294597,5748938
1979-01-16,1979,108,N,2,2,58990,1958421,8452028,64662,1359259,5748938
1979-01-17,1979,109,N,2,2,59953,2018374,8452028,63748,1423007,5748938
1979-01-18,1979,110,N,2,2,57721,2076095,8452028,63206,1486213,5748938
1979-01-19,1979,111,N,2,2,51360,2127455,8452028,55203,1541416,5748938
1979-01-20,1979,112,N,2,2,44671,2172126,8452028,43000,1584416,5748938
1979-01-21,1979,113,N,2,2,38792,2210918,8452028,35943,1620359,5748938
1979-01-22,1979,114,N,2,2,34125,2245043,8452028,31122,1651481,5748938
1979-01-23,1979,115,N,2,2,30291,2275334,8452028,25826,1677307,5748938
1979-01-24,1979,116,N,2,2,27753,2303087,8452028,23108,1700415,5748938
1979-01-25,1979,117,N,2,2,27301,2330388,8452028,23429,1723844,5748938
1979-01-26,1979,118,N,2,2,25738,2356126,8452028,22621,1746465,5748938
1979-01-27,1979,119,N,2,2,24608,2380734,8452028,21202,1767667,5748938
1979-01-28,1979,120,N,2,2,23283,2404017,8452028,19402,1787069,5748938
1979-01-29,1979,121,N,2,2,22009,2426026,8452028,19429,1806498,5748938
1979-01-30,1979,122,N,2,2,21020,2447046,8452028,19153,1825651,5748938
1979-01-31,1979,123,N,2,2,21485,2468531,8452028,18157,1843808,5748938
1979-02-01,1979,124,N,2,2,21553,2490084,8452028,19086,1862894,5748938
1979-02-02,1979,125,N,2,2,21316,2511400,8452028,18569,1881463,5748938
1979-02-03,1979,126,N,2,2,20718,2532118,8452028,18200,1899663,5748938
1979-02-04,1979,127,N,2,2,19946,2552064,8452028,17531,1917194,5748938
1979-02-05,1979,128,N,2,2,19258,2571322,8452028,15506,1932700,5748938
1979-02-06,1979,129,N,2,2,18098,2589420,8452028,14457,1947157,5748938
1979-02-07,1979,130,N,2,2,18028,2607448,8452028,14694,1961851,5748938
1979-02-08,1979,131,N,2,2,17780,2625228,8452028,14764,1976615,5748938
1979-02-09,1979,132,N,2,2,17405,2642633,8452028,14450,1991065,5748938
1979-02-10,1979,133,N,2,2,16972,2659605,8452028,14009,2005074,5748938
1979-02-11,1979,134,N,2,2,16547,2676152,8452028,12220,2017294,5748938
1979-02-12,1979,135,N,2,2,16193,2692345,8452028,11640,2028934,5748938
1979-02-13,1979,136,N,2,2,16698,2709043,8452028,13541,2042475,5748938
1979-02-14,1979,137,N,2,2,24605,2733648,8452028,24462,2066937,5748938
1979-02-15,1979,138,N,2,2,41288,2774936,8452028,41444,2108381,5748938
1979-02-16,1979,139,N,2,2,49102,2824038,8452028,50879,2159260,5748938
1979-02-17,1979,140,N,2,2,52048,2876086,8452028,53919,2213179,5748938
1979-02-18,1979,141,N,2,2,53439,2929525,8452028,53910,2267089,5748938
1979-02-19,1979,142,N,2,2,59088,2988613,8452028,59275,2326364,5748938
1979-02-20,1979,143,N,2,2,61906,3050519,8452028,63099,2389463,5748938
1979-02-21,1979,144,N,2,2,76124,3126643,8452028,81317,2470780,5748938
1979-02-22,1979,145,N,2,2,84371,3211014,8452028,91489,2562269,5748938
1979-02-23,1979,146,N,2,2,99085,3310099,8452028,111315,2673584,5748938
1979-02-24,1979,147,N,2,2,101046,3411145,8452028,111282,2784866,5748938
1979-02-25,1979,148,N,2,2,99672,3510817,8452028,109266,2894132,5748938
1979-02-26,1979,149,N,2,2,93053,3603870,8452028,97710,2991842,5748938
1979-02-27,1979,150,N,2,2,78651,3682521,8452028,81960,3073802,5748938
1979-02-28,1979,151,N,2,2,65140,3747661,8452028,67556,3141358,5748938
1979-03-01,1979,152,N,2,2,67592,3815253,8452028,69111,3210469,5748938
1979-03-02,1979,153,N,2,2,73585,3888838,8452028,75136,3285605,5748938
1979-03-03,1979,154,N,2,2,72982,3961820,8452028,73194,3358799,5748938
1979-03-04,1979,155,N,2,2,65621,4027441,8452028,65116,3423915,5748938
1979-03-05,1979,156,N,2,2,58219,4085660,8452028,54158,3478073,5748938
1979-03-06,1979,157,N,2,2,51606,4137266,8452028,47485,3525558,5748938
1979-03-07,1979,158,N,2,2,48555,4185821,8452028,44110,3569668,5748938
1979-03-08,1979,159,N,2,2,45194,4231015,8452028,39494,3609162,5748938
1979-03-09,1979,160,N,2,2,42671,4273686,8452028,36611,3645773,5748938
1979-03-10,1979,161,N,2,2,40334,4314020,8452028,34471,3680244,5748938
1979-03-11,1979,162,N,2,2,38292,4352312,8452028,32355,3712599,5748938
1979-03-12,1979,163,N,2,2,36197,4388509,8452028,30449,3743048,5748938
1979-03-13,1979,164,N,2,2,33579,4422088,8452028,25419,3768467,5748938
1979-03-14,1979,165,N,2,2,31673,4453761,8452028,23713,3792180,5748938
1979-03-15,1979,166,N,2,2,30703,4484464,8452028,22352,3814532,5748938
1979-03-16,1979,167,N,2,2,33744,4518208,8452028,28216,3842748,5748938
1979-03-17,1979,168,N,2,2,34617,4552825,8452028,30125,3872873,5748938
1979-03-18,1979,169,N,2,2,38029,4590854,8452028,32979,3905852,5748938
1979-03-19,1979,170,N,2,2,39406,4630260,8452028,35029,3940881,5748938
1979-03-20,1979,171,N,2,2,39012,4669272,8452028,35563,3976444,5748938
1979-03-21,1979,172,N,2,2,37593,4706865,8452028,32737,4009181,5748938
1979-03-22,1979,173,N,2,2,34086,4740951,8452028,29301,4038482,5748938
1979-03-23,1979,174,N,2,2,31351,4772302,8452028,27981,4066463,5748938
1979-03-24,1979,175,N,2,2,29514,4801816,8452028,26242,4092705,5748938
1979-03-25,1979,176,N,2,2,27488,4829304,8452028,22912,4115617,5748938
1979-03-26,1979,177,N,2,2,25819,4855123,8452028,20542,4136159,5748938
1979-03-27,1979,178,N,2,2,25721,4880844,8452028,22629,4158788,5748938
1979-03-28,1979,179,N,2,2,31527,4912371,8452028,33004,4191792,5748938
1979-03-29,1979,180,N,2,2,41679,4954050,8452028,42982,4234774,5748938
1979-03-30,1979,181,N,2,2,43388,4997438,8452028,44854,4279628,5748938
1979-03-31,1979,182,N,2,2,40646,5038084,8452028,42421,4322049,5748938
1979-04-01,1979,183,N,2,2,37890,5075974,8452028,38120,4360169,5748938
1979-04-02,1979,184,N,2,2,35088,5111062,8452028,31485,4391654,5748938
1979-04-03,1979,185,N,2,2,32985,5144047,8452028,29343,4420997,5748938
1979-04-04,1979,186,N,2,2,32158,5176205,8452028,27708,4448705,5748938
1979-04-05,1979,187,N,2,2,30383,5206588,8452028,25165,4473870,5748938
1979-04-06,1979,188,N,2,2,27957,5234545,8452028,22525,4496395,5748938
1979-04-07,1979,189,N,2,2,25605,5260150,8452028,20637,4517032,5748938
1979-04-08,1979,190,N,2,2,24484,5284634,8452028,18807,4535839,5748938
1979-04-09,1979,191,N,2,2,23324,5307958,8452028,17132,4552971,5748938
1979-04-10,1979,192,N,2,2,21845,5329803,8452028,16064,4569035,5748938
1979-04-11,1979,193,N,2,2,20884,5350687,8452028,14200,4583235,5748938
1979-04-12,1979,194,N,2,2,20435,5371122,8452028,12607,4595842,5748938
1979-04-13,1979,195,N,2,2,19033,5390155,8452028,9718,4605560,5748938
1979-04-14,1979,196,N,2,2,17584,5407739,8452028,7611,4613171,5748938
1979-04-15,1979,197,N,2,2,16677,5424416,8452028,7307,4620478,5748938
1979-04-16,1979,198,N,2,2,16586,5441002,8452028,8012,4628490,5748938
1979-04-17,1979,199,N,2,2,16777,5457779,8452028,8858,4637348,5748938
1979-04-18,1979,200,N,2,2,17087,5474866,8452028,9624,4646972,5748938
1979-04-19,1979,201,N,2,2,16843,5491709,8452028,9155,4656127,5748938
1979-04-20,1979,202,N,2,2,16167,5507876,8452028,7990,4664117,5748938
1979-04-21,1979,203,N,2,2,14642,5522518,8452028,7362,4671479,5748938
1979-04-22,1979,204,N,2,2,13522,5536040,8452028,6199,4677678,5748938
1979-04-23,1979,205,N,2,2,14464,5550504,8452028,7805,4685483,5748938
1979-04-24,1979,206,N,2,2,16644,5567148,8452028,9017,4694500,5748938
1979-04-25,1979,207,N,2,2,18294,5585442,8452028,9473,4703973,5748938
1979-04-26,1979,208,N,2,2,19814,5605256,8452028,9351,4713324,5748938
1979-04-27,1979,209,N,2,2,20373,5625629,8452028,11174,4724498,5748938
1979-04-28,1979,210,N,2,2,20618,5646247,8452028,11092,4735590,5748938
1979-04-29,1979,211,N,2,2,20673,5666920,8452028,10408,4745998,5748938
1979-04-30,1979,212,N,2,2,19705,5686625,8452028,10589,4756587,5748938
1979-05-01,1979,213,N,2,2,18049,5704674,8452028,11823,4768410,5748938
1979-05-02,1979,214,N,2,2,18136,5722810,8452028,9687,4778097,5748938
1979-05-03,1979,215,N,2,2,18290,5741100,8452028,11785,4789882,5748938
1979-05-04,1979,216,N,2,2,17608,5758708,8452028,8180,4798062,5748938
1979-05-05,1979,217,N,2,2,16277,5774985,8452028,7184,4805246,5748938
1979-05-06,1979,218,N,2,2,16382,5791367,8452028,7992,4813238,5748938
1979-05-07,1979,219,N,2,2,17505,5808872,8452028,8727,4821965,5748938
1979-05-08,1979,220,N,2,2,20850,5829722,8452028,11896,4833861,5748938
1979-05-09,1979,221,N,2,2,23050,5852772,8452028,14818,4848679,5748938
1979-05-10,1979,222,N,2,2,23364,5876136,8452028,14964,4863643,5748938
1979-05-11,1979,223,N,2,2,22163,5898299,8452028,13047,4876690,5748938
1979-05-12,1979,224,N,2,2,19868,5918167,8452028,11692,4888382,5748938
1979-05-13,1979,225,N,2,2,18968,5937135,8452028,10362,4898744,5748938
1979-05-14,1979,226,N,2,2,19513,5956648,8452028,10929,4909673,5748938
1979-05-15,1979,227,N,2,2,20292,5976940,8452028,11322,4920995,5748938
1979-05-16,1979,228,N,2,2,20950,5997890,8452028,11979,4932974,5748938
1979-05-17,1979,229,N,2,2,21158,6019048,8452028,12110,4945084,5748938
1979-05-18,1979,230,N,2,2,21695,6040743,8452028,12573,4957657,5748938
1979-05-19,1979,231,N,2,2,22907,6063650,8452028,13499,4971156,5748938
1979-05-20,1979,232,N,2,2,24436,6088086,8452028,14813,4985969,5748938
1979-05-21,1979,233,N,2,2,24984,6113070,8452028,15990,5001959,5748938
1979-05-22,1979,234,N,2,2,25056,6138126,8452028,16543,5018502,5748938
1979-05-23,1979,235,N,2,2,26210,6164336,8452028,17832,5036334,5748938
1979-05-24,1979,236,N,2,2,26880,6191216,8452028,18620,5054954,5748938
1979-05-25,1979,237,N,2,2,27774,6218990,8452028,18994,5073948,5748938
1979-05-26,1979,238,N,2,2,27549,6246539,8452028,19109,5093057,5748938
1979-05-27,1979,239,N,2,2,25769,6272308,8452028,17348,5110405,5748938
1979-05-28,1979,240,N,2,2,25216,6297524,8452028,16657,5127062,5748938
1979-05-29,1979,241,N,2,2,24595,6322119,8452028,16491,5143553,5748938
1979-05-30,1979,242,N,2,2,24213,6346332,8452028,15275,5158828,5748938
1979-05-31,1979,243,N,2,2,23468,6369800,8452028,14235,5173063,5748938
1979-06-01,1979,244,N,2,2,21394,6391194,8452028,10808,5183871,5748938
1979-06-02,1979,245,N,2,2,18354,6409548,8452028,6381,5190252,5748938
1979-06-03,1979,246,N,2,2,17244,6426792,8452028,5699,5195951,5748938
1979-06-04,1979,247,N,2,2,16988,6443780,8452028,5932,5201883,5748938
1979-06-05,1979,248,N,2,2,15900,6459680,8452028,5732,5207615,5748938
1979-06-06,1979,249,N,2,2,15370,6475050,8452028,5929,5213544,5748938
1979-06-07,1979,250,N,2,2,15458,6490508,8452028,5487,5219031,5748938
1979-06-08,1979,251,N,2,2,16262,6506770,8452028,6039,5225070,5748938
1979-06-09,1979,252,N,2,2,16335,6523105,8452028,5970,5231040,5748938
1979-06-10,1979,253,N,2,2,15908,6539013,8452028,5591,5236631,5748938
1979-06-11,1979,254,N,2,2,15298,6554311,8452028,5880,5242511,5748938
1979-06-12,1979,255,N,2,2,14714,6569025,8452028,5961,5248472,5748938
1979-06-13,1979,256,N,2,2,14728,6583753,8452028,5391,5253863,5748938
1979-06-14,1979,257,N,2,2,15046,6598799,8452028,5726,5259589,5748938
1979-06-15,1979,258,N,2,2,15228,6614027,8452028,5769,5265358,5748938
1979-06-16,1979,259,N,2,2,15086,6629113,8452028,5294,5270652,5748938
1979-06-17,1979,260,N,2,2,14323,6643436,8452028,4447,5275099,5748938
1979-06-18,1979,261,N,2,2,14156,6657592,8452028,4360,5279459,5748938
1979-06-19,1979,262,N,2,2,14231,6671823,8452028,4085,5283544,5748938
1979-06-20,1979,263,N,2,2,14158,6685981,8452028,3814,5287358,5748938
1979-06-21,1979,264,N,2,2,14144,6700125,8452028,4242,5291600,5748938
1979-06-22,1979,265,N,2,2,14264,6714389,8452028,4163,5295763,5748938
1979-06-23,1979,266,N,2,2,13875,6728264,8452028,4078,5299841,5748938
1979-06-24,1979,267,N,2,2,14226,6742490,8452028,4478,5304319,5748938
1979-06-25,1979,268,N,2,2,14747,6757237,8452028,5214,5309533,5748938
1979-06-26,1979,269,N,2,2,14615,6771852,8452028,4621,5314154,5748938
1979-06-27,1979,270,N,2,2,14390,6786242,8452028,4217,5318371,5748938
1979-06-28,1979,271,N,2,2,14943,6801185,8452028,4552,5322923,5748938
1979-06-29,1979,272,N,2,2,15232,6816417,8452028,4323,5327246,5748938
1979-06-30,1979,273,N,2,2,15787,6832204,8452028,5290,5332536,5748938
1979-07-01,1979,274,N,2,2,16632,6848836,8452028,4985,5337521,5748938
1979-07-02,1979,275,N,2,2,17278,6866114,8452028,4120,5341641,5748938
1979-07-03,1979,276,N,2,2,17945,6884059,8452028,4745,5346386,5748938
1979-07-04,1979,277,N,2,2,18354,6902413,8452028,3989,5350375,5748938
1979-07-05,1979,278,N,2,2,18330,6920743,8452028,4109,5354484,5748938
1979-07-06,1979,279,N,2,2,18210,6938953,8452028,3956,5358440,5748938
1979-07-07,1979,280,N,2,2,18186,6957139,8452028,3923,5362363,5748938
1979-07-08,1979,281,N,2,2,18216,6975355,8452028,4052,5366415,5748938
1979-07-09,1979,282,N,2,2,18534,6993889,8452028,4325,5370740,5748938
1979-07-10,1979,283,N,2,2,18560,7012449,8452028,4205,5374945,5748938
1979-07-11,1979,284,N,2,2,18547,7030996,8452028,4165,5379110,5748938
1979-07-12,1979,285,N,2,2,18083,7049079,8452028,3802,5382912,5748938
1979-07-13,1979,286,N,2,2,17604,7066683,8452028,3033,5385945,5748938
1979-07-14,1979,287,N,2,2,17130,7083813,8452028,3139,5389084,5748938
1979-07-15,1979,288,N,2,2,17258,7101071,8452028,3754,5392838,5748938
1979-07-16,1979,289,N,2,2,17085,7118156,8452028,4130,5396968,5748938
1979-07-17,1979,290,N,2,2,16947,7135103,8452028,3919,5400887,5748938
1979-07-18,1979,291,N,2,2,16597,7151700,8452028,3994,5404881,5748938
1979-07-19,1979,292,N,2,2,16746,7168446,8452028,4266,5409147,5748938
1979-07-20,1979,293,N,2,2,17478,7185924,8452028,4736,5413883,5748938
1979-07-21,1979,294,N,2,2,18797,7204721,8452028,7532,5421415,5748938
1979-07-22,1979,295,N,2,2,19677,7224398,8452028,12100,5433515,5748938
1979-07-23,1979,296,N,2,2,20072,7244470,8452028,11771,5445286,5748938
1979-07-24,1979,297,N,2,2,19856,7264326,8452028,10361,5455647,5748938
1979-07-25,1979,298,N,2,2,19419,7283745,8452028,9681,5465328,5748938
1979-07-26,1979,299,N,2,2,19386,7303131,8452028,9442,5474770,5748938
1979-07-27,1979,300,N,2,2,19147,7322278,8452028,4359,5479129,5748938
1979-07-28,1979,301,N,2,2,18711,7340989,8452028,4195,5483324,5748938
1979-07-29,1979,302,N,2,2,18512,7359501,8452028,3767,5487091,5748938
1979-07-30,1979,303,N,2,2,18842,7378343,8452028,4226,5491317,5748938
1979-07-31,1979,304,N,2,2,18820,7397163,8452028,4416,5495733,5748938
1979-08-01,1979,305,N,2,2,18981,7416144,8452028,4046,5499779,5748938
1979-08-02,1979,306,N,2,2,18920,7435064,8452028,3683,5503462,5748938
1979-08-03,1979,307,N,2,2,18947,7454011,8452028,4350,5507812,5748938
1979-08-04,1979,308,N,2,2,18856,7472867,8452028,4896,5512708,5748938
1979-08-05,1979,309,N,2,2,18830,7491697,8452028,5569,5518277,5748938
1979-08-06,1979,310,N,2,2,19280,7510977,8452028,5776,5524053,5748938
1979-08-07,1979,311,N,2,2,19345,7530322,8452028,5397,5529450,5748938
1979-08-08,1979,312,N,2,2,19367,7549689,8452028,5358,5534808,5748938
1979-08-09,1979,313,N,2,2,19417,7569106,8452028,5209,5540017,5748938
1979-08-10,1979,314,N,2,2,19139,7588245,8452028,4894,5544911,5748938
1979-08-11,1979,315,N,2,2,18732,7606977,8452028,4395,5549306,5748938
1979-08-12,1979,316,N,2,2,18724,7625701,8452028,5302,5554608,5748938
1979-08-13,1979,317,N,2,2,18906,7644607,8452028,4911,5559519,5748938
1979-08-14,1979,318,N,2,2,18438,7663045,8452028,3604,5563123,5748938
1979-08-15,1979,319,N,2,2,18149,7681194,8452028,3661,5566784,5748938
1979-08-16,1979,320,N,2,2,17657,7698851,8452028,3174,5569958,5748938
1979-08-17,1979,321,N,2,2,17668,7716519,8452028,3348,5573306,5748938
1979-08-18,1979,322,N,2,2,17590,7734109,8452028,2663,5575969,5748938
1979-08-19,1979,323,N,2,2,17559,7751668,8452028,2989,5578958,5748938
1979-08-20,1979,324,N,2,2,17605,7769273,8452028,3128,5582086,5748938
1979-08-21,1979,325,N,2,2,17276,7786549,8452028,2436,5584522,5748938
1979-08-22,1979,326,N,2,2,16645,7803194,8452028,2573,5587095,5748938
1979-08-23,1979,327,N,2,2,16337,7819531,8452028,1934,5589029,5748938
1979-08-24,1979,328,N,2,2,16336,7835867,8452028,2064,5591093,5748938
1979-08-25,1979,329,N,2,2,15853,7851720,8452028,1624,5592717,5748938
1979-08-26,1979,330,N,2,2,15857,7867577,8452028,1338,5594055,5748938
1979-08-27,1979,331,N,2,2,15614,7883191,8452028,1228,5595283,5748938
1979-08-28,1979,332,N,2,2,15036,7898227,8452028,740,5596023,5748938
1979-08-29,1979,333,N,2,2,14948,7913175,8452028,859,5596882,5748938
1979-08-30,1979,334,N,2,2,15032,7928207,8452028,1097,5597979,5748938
1979-08-31,1979,335,N,2,2,15267,7943474,8452028,1808,5599787,5748938
1979-09-01,1979,336,N,2,2,15996,7959470,8452028,3044,5602831,5748938
1979-09-02,1979,337,N,2,2,16516,7975986,8452028,3636,5606467,5748938
1979-09-03,1979,338,N,2,2,16783,7992769,8452028,3099,5609566,5748938
1979-09-04,1979,339,N,2,2,16641,8009410,8452028,2973,5612539,5748938
1979-09-05,1979,340,N,2,2,16902,8026312,8452028,3096,5615635,5748938
1979-09-06,1979,341,N,2,2,16893,8043205,8452028,2886,5618521,5748938
1979-09-07,1979,342,N,2,2,17094,8060299,8452028,3157,5621678,5748938
1979-09-08,1979,343,N,2,2,17591,8077890,8452028,4652,5626330,5748938
1979-09-09,1979,344,N,2,2,18119,8096009,8452028,5682,5632012,5748938
1979-09-10,1979,345,N,2,2,18380,8114389,8452028,5460,5637472,5748938
1979-09-11,1979,346,N,2,2,17825,8132214,8452028,5228,5642700,5748938
1979-09-12,1979,347,N,2,2,17760,8149974,8452028,6297,5648997,5748938
1979-09-13,1979,348,N,2,2,17558,8167532,8452028,6959,5655956,5748938
1979-09-14,1979,349,N,2,2,17285,8184817,8452028,7247,5663203,5748938
1979-09-15,1979,350,N,2,2,17057,8201874,8452028,7355,5670558,5748938
1979-09-16,1979,351,N,2,2,17318,8219192,8452028,6743,5677301,5748938
1979-09-17,1979,352,N,2,2,17327,8236519,8452028,6649,5683950,5748938
1979-09-18,1979,353,N,2,2,17065,8253584,8452028,6430,5690380,5748938
1979-09-19,1979,354,N,2,2,16758,8270342,8452028,6014,5696394,5748938
1979-09-20,1979,355,N,2,2,16790,8287132,8452028,5301,5701695,5748938
1979-09-21,1979,356,N,2,2,16691,8303823,8452028,5625,5707320,5748938
1979-09-22,1979,357,N,2,2,16814,8320637,8452028,4772,5712092,5748938
1979-09-23,1979,358,N,2,2,16882,8337519,8452028,4540,5716632,5748938
1979-09-24,1979,359,N,2,2,17043,8354562,8452028,4166,5720798,5748938
1979-09-25,1979,360,N,2,2,16612,8371174,8452028,5143,5725941,5748938
1979-09-26,1979,361,N,2,2,15844,8387018,8452028,4099,5730040,5748938
1979-09-27,1979,362,N,2,2,16090,8403108,8452028,4161,5734201,5748938
1979-09-28,1979,363,N,2,2,16065,8419173,8452028,4835,5739036,5748938
1979-09-29,1979,364,N,2,2,16160,8435333,8452028,4757,5743793,5748938
1979-09-30,1979,365,N,2,2,16695,8452028,8452028,5145,5748938,5748938
1979-10-01,1980,1,N,3,3+,16222,16222,16847528,4855,4855,14175678
1979-10-02,1980,2,N,3,3+,15431,31653,16847528,5706,10561,14175678
1979-10-03,1980,3,N,3,3+,15907,47560,16847528,5777,16338,14175678
1979-10-04,1980,4,N,3,3+,15992,63552,16847528,4916,21254,14175678
1979-10-05,1980,5,N,3,3+,15888,79440,16847528,5563,26817,14175678
1979-10-06,1980,6,N,3,3+,15600,95040,16847528,5247,32064,14175678
1979-10-07,1980,7,N,3,3+,15330,110370,16847528,4572,36636,14175678
1979-10-08,1980,8,N,3,3+,16179,126549,16847528,5903,42539,14175678
1979-10-09,1980,9,N,3,3+,15869,142418,16847528,6023,48562,14175678
1979-10-10,1980,10,N,3,3+,15797,158215,16847528,5697,54259,14175678
1979-10-11,1980,11,N,3,3+,15911,174126,16847528,7239,61498,14175678
1979-10-12,1980,12,N,3,3+,16519,190645,16847528,8419,69917,14175678
1979-10-13,1980,13,N,3,3+,16502,207147,16847528,6732,76649,14175678
1979-10-14,1980,14,N,3,3+,16588,223735,16847528,6696,83345,14175678
1979-10-15,1980,15,N,3,3+,15962,239697,16847528,7338,90683,14175678
1979-10-16,1980,16,N,3,3+,15038,254735,16847528,6930,97613,14175678
1979-10-17,1980,17,N,3,3+,15259,269994,16847528,7438,105051,14175678
1979-10-18,1980,18,N,3,3+,14511,284505,16847528,5355,110406,14175678
1979-10-19,1980,19,N,3,3+,13929,298434,16847528,5845,116251,14175678
1979-10-20,1980,20,N,3,3+,14296,312730,16847528,7235,123486,14175678
1979-10-21,1980,21,N,3,3+,15075,327805,16847528,8771,132257,14175678
1979-10-22,1980,22,N,3,3+,14870,342675,16847528,9329,141586,14175678
1979-10-23,1980,23,N,3,3+,14418,357093,16847528,9769,151355,14175678
1979-10-24,1980,24,N,3,3+,13654,370747,16847528,5779,157134,14175678
1979-10-25,1980,25,N,3,3+,15861,386608,16847528,6820,163954,14175678
1979-10-26,1980,26,N,3,3+,16970,403578,16847528,12474,176428,14175678
1979-10-27,1980,27,N,3,3+,18900,422478,16847528,13805,190233,14175678
1979-10-28,1980,28,N,3,3+,21599,444077,16847528,15858,206091,14175678
1979-10-29,1980,29,N,3,3+,19885,463962,16847528,15404,221495,14175678
1979-10-30,1980,30,N,3,3+,17142,481104,16847528,13176,234671,14175678
1979-10-31,1980,31,N,3,3+,15985,497089,16847528,7087,241758,14175678
1979-11-01,1980,32,N,3,3+,15275,512364,16847528,6539,248297,14175678
1979-11-02,1980,33,N,3,3+,14907,527271,16847528,6151,254448,14175678
1979-11-03,1980,34,N,3,3+,15283,542554,16847528,5927,260375,14175678
1979-11-04,1980,35,N,3,3+,16079,558633,16847528,9006,269381,14175678
1979-11-05,1980,36,N,3,3+,15896,574529,16847528,8805,278186,14175678
1979-11-06,1980,37,N,3,3+,16791,591320,16847528,9673,287859,14175678
1979-11-07,1980,38,N,3,3+,17437,608757,16847528,11825,299684,14175678
1979-11-08,1980,39,N,3,3+,17654,626411,16847528,12941,312625,14175678
1979-11-09,1980,40,N,3,3+,17459,643870,16847528,10027,322652,14175678
1979-11-10,1980,41,N,3,3+,17051,660921,16847528,10942,333594,14175678
1979-11-11,1980,42,N,3,3+,16594,677515,16847528,10546,344140,14175678
1979-11-12,1980,43,N,3,3+,16169,693684,16847528,10796,354936,14175678
1979-11-13,1980,44,N,3,3+,15591,709275,16847528,9728,364664,14175678
1979-11-14,1980,45,N,3,3+,14915,724190,16847528,8314,372978,14175678
1979-11-15,1980,46,N,3,3+,14746,738936,16847528,7570,380548,14175678
1979-11-16,1980,47,N,3,3+,14730,753666,16847528,7583,388131,14175678
1979-11-17,1980,48,N,3,3+,15134,768800,16847528,10008,398139,14175678
1979-11-18,1980,49,N,3,3+,16583,785383,16847528,12057,410196,14175678
1979-11-19,1980,50,N,3,3+,21352,806735,16847528,16623,426819,14175678
1979-11-20,1980,51,N,3,3+,23375,830110,16847528,18630,445449,14175678
1979-11-21,1980,52,N,3,3+,21748,851858,16847528,16833,462282,14175678
1979-11-22,1980,53,N,3,3+,19849,871707,16847528,12478,474760,14175678
1979-11-23,1980,54,N,3,3+,18921,890628,16847528,12999,487759,14175678
1979-11-24,1980,55,N,3,3+,18536,909164,16847528,12524,500283,14175678
1979-11-25,1980,56,N,3,3+,19584,928748,16847528,13966,514249,14175678
1979-11-26,1980,57,N,3,3+,21342,950090,16847528,18171,532420,14175678
1979-11-27,1980,58,N,3,3+,23572,973662,16847528,20659,553079,14175678
1979-11-28,1980,59,N,3,3+,24295,997957,16847528,19728,572807,14175678
1979-11-29,1980,60,N,3,3+,23087,1021044,16847528,18161,590968,14175678
1979-11-30,1980,61,N,3,3+,21383,1042427,16847528,15952,606920,14175678
1979-12-01,1980,62,N,3,3+,20103,1062530,16847528,12457,619377,14175678
1979-12-02,1980,63,N,3,3+,19192,1081722,16847528,11292,630669,14175678
1979-12-03,1980,64,N,3,3+,18821,1100543,16847528,11537,642206,14175678
1979-12-04,1980,65,N,3,3+,18264,1118807,16847528,11009,653215,14175678
1979-12-05,1980,66,N,3,3+,17862,1136669,16847528,10165,663380,14175678
1979-12-06,1980,67,N,3,3+,17465,1154134,16847528,9786,673166,14175678
1979-12-07,1980,68,N,3,3+,17275,1171409,16847528,9439,682605,14175678
1979-12-08,1980,69,N,3,3+,16958,1188367,16847528,9473,692078,14175678
1979-12-09,1980,70,N,3,3+,17228,1205595,16847528,9974,702052,14175678
1979-12-10,1980,71,N,3,3+,17285,1222880,16847528,10021,712073,14175678
1979-12-11,1980,72,N,3,3+,16912,1239792,16847528,10193,722266,14175678
1979-12-12,1980,73,N,3,3+,16654,1256446,16847528,9535,731801,14175678
1979-12-13,1980,74,N,3,3+,16477,1272923,16847528,9307,741108,14175678
1979-12-14,1980,75,N,3,3+,16274,1289197,16847528,8382,749490,14175678
1979-12-15,1980,76,N,3,3+,16168,1305365,16847528,7527,757017,14175678
1979-12-16,1980,77,N,3,3+,16386,1321751,16847528,7417,764434,14175678
1979-12-17,1980,78,N,3,3+,16509,1338260,16847528,7663,772097,14175678
1979-12-18,1980,79,N,3,3+,16422,1354682,16847528,7243,779340,14175678
1979-12-19,1980,80,N,3,3+,16983,1371665,16847528,8488,787828,14175678
1979-12-20,1980,81,N,3,3+,17648,1389313,16847528,10326,798154,14175678
1979-12-21,1980,82,N,3,3+,17778,1407091,16847528,11763,809917,14175678
1979-12-22,1980,83,N,3,3+,19331,1426422,16847528,15369,825286,14175678
1979-12-23,1980,84,N,3,3+,20350,1446772,16847528,16461,841747,14175678
1979-12-24,1980,85,N,3,3+,21196,1467968,16847528,21952,863699,14175678
1979-12-25,1980,86,N,3,3+,33650,1501618,16847528,40615,904314,14175678
1979-12-26,1980,87,N,3,3+,49673,1551291,16847528,55721,960035,14175678
1979-12-27,1980,88,N,3,3+,51257,1602548,16847528,56358,1016393,14175678
1979-12-28,1980,89,N,3,3+,53420,1655968,16847528,57821,1074214,14175678
1979-12-29,1980,90,N,3,3+,51106,1707074,16847528,49026,1123240,14175678
1979-12-30,1980,91,N,3,3+,45783,1752857,16847528,38666,1161906,14175678
1979-12-31,1980,92,N,3,3+,43382,1796239,16847528,34899,1196805,14175678
1980-01-01,1980,93,N,3,3+,49065,1845304,16847528,43754,1240559,14175678
1980-01-02,1980,94,N,3,3+,51823,1897127,16847528,46492,1287051,14175678
1980-01-03,1980,95,N,3,3+,51145,1948272,16847528,46094,1333145,14175678
1980-01-04,1980,96,N,3,3+,50100,1998372,16847528,44845,1377990,14175678
1980-01-05,1980,97,N,3,3+,47068,2045440,16847528,40645,1418635,14175678
1980-01-06,1980,98,N,3,3+,43573,2089013,16847528,35508,1454143,14175678
1980-01-07,1980,99,N,3,3+,40206,2129219,16847528,32382,1486525,14175678
1980-01-08,1980,100,N,3,3+,36685,2165904,16847528,29177,1515702,14175678
1980-01-09,1980,101,N,3,3+,36402,2202306,16847528,31238,1546940,14175678
1980-01-10,1980,102,N,3,3+,39625,2241931,16847528,38318,1585258,14175678
1980-01-11,1980,103,N,3,3+,44210,2286141,16847528,49197,1634455,14175678
1980-01-12,1980,104,N,3,3+,60250,2346391,16847528,67364,1701819,14175678
1980-01-13,1980,105,N,3,3+,99393,2445784,16847528,107054,1808873,14175678
1980-01-14,1980,106,N,3,3+,194728,2640512,16847528,204266,2013139,14175678
1980-01-15,1980,107,N,3,3+,268252,2908764,16847528,276584,2289723,14175678
1980-01-16,1980,108,N,3,3+,299222,3207986,16847528,301972,2591695,14175678
1980-01-17,1980,109,N,3,3+,303753,3511739,16847528,303238,2894933,14175678
1980-01-18,1980,110,N,3,3+,298601,3810340,16847528,302653,3197586,14175678
1980-01-19,1980,111,N,3,3+,242821,4053161,16847528,242269,3439855,14175678
1980-01-20,1980,112,N,3,3+,204027,4257188,16847528,202131,3641986,14175678
1980-01-21,1980,113,N,3,3+,172349,4429537,16847528,169671,3811657,14175678
1980-01-22,1980,114,N,3,3+,150198,4579735,16847528,147012,3958669,14175678
1980-01-23,1980,115,N,3,3+,139295,4719030,16847528,132418,4091087,14175678
1980-01-24,1980,116,N,3,3+,134784,4853814,16847528,128254,4219341,14175678
1980-01-25,1980,117,N,3,3+,126354,4980168,16847528,118998,4338339,14175678
1980-01-26,1980,118,N,3,3+,115105,5095273,16847528,107845,4446184,14175678
1980-01-27,1980,119,N,3,3+,101795,5197068,16847528,93568,4539752,14175678
1980-01-28,1980,120,N,3,3+,96052,5293120,16847528,89133,4628885,14175678
1980-01-29,1980,121,N,3,3+,90885,5384005,16847528,83975,4712860,14175678
1980-01-30,1980,122,N,3,3+,84799,5468804,16847528,77661,4790521,14175678
1980-01-31,1980,123,N,3,3+,78145,5546949,16847528,71108,4861629,14175678
1980-02-01,1980,124,N,3,3+,73015,5619964,16847528,64754,4926383,14175678
1980-02-02,1980,125,N,3,3+,69168,5689132,16847528,60054,4986437,14175678
1980-02-03,1980,126,N,3,3+,65330,5754462,16847528,57262,5043699,14175678
1980-02-04,1980,127,N,3,3+,61320,5815782,16847528,53966,5097665,14175678
1980-02-05,1980,128,N,3,3+,56996,5872778,16847528,49104,5146769,14175678
1980-02-06,1980,129,N,3,3+,54027,5926805,16847528,47160,5193929,14175678
1980-02-07,1980,130,N,3,3+,50136,5976941,16847528,41776,5235705,14175678
1980-02-08,1980,131,N,3,3+,45883,6022824,16847528,37154,5272859,14175678
1980-02-09,1980,132,N,3,3+,43455,6066279,16847528,35141,5308000,14175678
1980-02-10,1980,133,N,3,3+,40899,6107178,16847528,31226,5339226,14175678
1980-02-11,1980,134,N,3,3+,39121,6146299,16847528,29372,5368598,14175678
1980-02-12,1980,135,N,3,3+,37400,6183699,16847528,29179,5397777,14175678
1980-02-13,1980,136,N,3,3+,36518,6220217,16847528,27748,5425525,14175678
1980-02-14,1980,137,N,3,3+,36049,6256266,16847528,29336,5454861,14175678
1980-02-15,1980,138,N,3,3+,37900,6294166,16847528,31550,5486411,14175678
1980-02-16,1980,139,N,3,3+,46347,6340513,16847528,45118,5531529,14175678
1980-02-17,1980,140,N,3,3+,67839,6408352,16847528,67344,5598873,14175678
1980-02-18,1980,141,N,3,3+,101619,6509971,16847528,103631,5702504,14175678
1980-02-19,1980,142,N,3,3+,152655,6662626,16847528,162316,5864820,14175678
1980-02-20,1980,143,N,3,3+,243042,6905668,16847528,252459,6117279,14175678
1980-02-21,1980,144,N,3,3+,315722,7221390,16847528,323503,6440782,14175678
1980-02-22,1980,145,N,3,3+,339008,7560398,16847528,339852,6780634,14175678
1980-02-23,1980,146,N,3,3+,325916,7886314,16847528,325730,7106364,14175678
1980-02-24,1980,147,N,3,3+,293443,8179757,16847528,289283,7395647,14175678
1980-02-25,1980,148,N,3,3+,251172,8430929,16847528,247109,7642756,14175678
1980-02-26,1980,149,N,3,3+,221544,8652473,16847528,217478,7860234,14175678
1980-02-27,1980,150,N,3,3+,195551,8848024,16847528,191342,8051576,14175678
1980-02-28,1980,151,N,3,3+,176942,9024966,16847528,172752,8224328,14175678
1980-02-29,1980,152,N,3,3+,169526,9194492,16847528,165290,8389618,14175678
1980-03-01,1980,153,N,3,3+,163784,9358276,16847528,159520,8549138,14175678
1980-03-02,1980,154,N,3,3+,159266,9517542,16847528,155323,8704461,14175678
1980-03-03,1980,155,N,3,3+,155557,9673099,16847528,152619,8857080,14175678
1980-03-04,1980,156,N,3,3+,152171,9825270,16847528,149528,9006608,14175678
1980-03-05,1980,157,N,3,3+,148902,9974172,16847528,148527,9155135,14175678
1980-03-06,1980,158,N,3,3+,154987,10129159,16847528,154910,9310045,14175678
1980-03-07,1980,159,N,3,3+,157482,10286641,16847528,157098,9467143,14175678
1980-03-08,1980,160,N,3,3+,153382,10440023,16847528,150855,9617998,14175678
1980-03-09,1980,161,N,3,3+,144238,10584261,16847528,140752,9758750,14175678
1980-03-10,1980,162,N,3,3+,136152,10720413,16847528,131011,9889761,14175678
1980-03-11,1980,163,N,3,3+,127506,10847919,16847528,119002,10008763,14175678
1980-03-12,1980,164,N,3,3+,118127,10966046,16847528,110471,10119234,14175678
1980-03-13,1980,165,N,3,3+,108965,11075011,16847528,104212,10223446,14175678
1980-03-14,1980,166,N,3,3+,103496,11178507,16847528,98669,10322115,14175678
1980-03-15,1980,167,N,3,3+,98326,11276833,16847528,94366,10416481,14175678
1980-03-16,1980,168,N,3,3+,94507,11371340,16847528,90509,10506990,14175678
1980-03-17,1980,169,N,3,3+,91739,11463079,16847528,87684,10594674,14175678
1980-03-18,1980,170,N,3,3+,89666,11552745,16847528,85588,10680262,14175678
1980-03-19,1980,171,N,3,3+,87742,11640487,16847528,83005,10763267,14175678
1980-03-20,1980,172,N,3,3+,85094,11725581,16847528,78651,10841918,14175678
1980-03-21,1980,173,N,3,3+,80691,11806272,16847528,73954,10915872,14175678
1980-03-22,1980,174,N,3,3+,75515,11881787,16847528,70270,10986142,14175678
1980-03-23,1980,175,N,3,3+,70010,11951797,16847528,63254,11049396,14175678
1980-03-24,1980,176,N,3,3+,65168,12016965,16847528,57864,11107260,14175678
1980-03-25,1980,177,N,3,3+,62576,12079541,16847528,56244,11163504,14175678
1980-03-26,1980,178,N,3,3+,60178,12139719,16847528,57579,11221083,14175678
1980-03-27,1980,179,N,3,3+,56786,12196505,16847528,55322,11276405,14175678
1980-03-28,1980,180,N,3,3+,54389,12250894,16847528,52562,11328967,14175678
1980-03-29,1980,181,N,3,3+,50227,12301121,16847528,48460,11377427,14175678
1980-03-30,1980,182,N,3,3+,48302,12349423,16847528,45469,11422896,14175678
1980-03-31,1980,183,N,3,3+,46792,12396215,16847528,40429,11463325,14175678
1980-04-01,1980,184,N,3,3+,45434,12441649,16847528,38814,11502139,14175678
1980-04-02,1980,185,N,3,3+,42861,12484510,16847528,36086,11538225,14175678
1980-04-03,1980,186,N,3,3+,40072,12524582,16847528,33443,11571668,14175678
1980-04-04,1980,187,N,3,3+,39042,12563624,16847528,32201,11603869,14175678
1980-04-05,1980,188,N,3,3+,40184,12603808,16847528,39671,11643540,14175678
1980-04-06,1980,189,N,3,3+,41705,12645513,16847528,41666,11685206,14175678
1980-04-07,1980,190,N,3,3+,40911,12686424,16847528,40930,11726136,14175678
1980-04-08,1980,191,N,3,3+,40342,12726766,16847528,40248,11766384,14175678
1980-04-09,1980,192,N,3,3+,38712,12765478,16847528,39096,11805480,14175678
1980-04-10,1980,193,N,3,3+,36997,12802475,16847528,30439,11835919,14175678
1980-04-11,1980,194,N,3,3+,35934,12838409,16847528,28918,11864837,14175678
1980-04-12,1980,195,N,3,3+,34996,12873405,16847528,27996,11892833,14175678
1980-04-13,1980,196,N,3,3+,34127,12907532,16847528,26885,11919718,14175678
1980-04-14,1980,197,N,3,3+,33833,12941365,16847528,26600,11946318,14175678
1980-04-15,1980,198,N,3,3+,33507,12974872,16847528,26210,11972528,14175678
1980-04-16,1980,199,N,3,3+,33219,13008091,16847528,25975,11998503,14175678
1980-04-17,1980,200,N,3,3+,32999,13041090,16847528,25058,12023561,14175678
1980-04-18,1980,201,N,3,3+,33394,13074484,16847528,24925,12048486,14175678
1980-04-19,1980,202,N,3,3+,32491,13106975,16847528,24210,12072696,14175678
1980-04-20,1980,203,N,3,3+,31608,13138583,16847528,22975,12095671,14175678
1980-04-21,1980,204,N,3,3+,31564,13170147,16847528,23214,12118885,14175678
1980-04-22,1980,205,N,3,3+,30996,13201143,16847528,23286,12142171,14175678
1980-04-23,1980,206,N,3,3+,30910,13232053,16847528,23970,12166141,14175678
1980-04-24,1980,207,N,3,3+,30669,13262722,16847528,23438,12189579,14175678
1980-04-25,1980,208,N,3,3+,29938,13292660,16847528,22922,12212501,14175678
1980-04-26,1980,209,N,3,3+,29247,13321907,16847528,22323,12234824,14175678
1980-04-27,1980,210,N,3,3+,28858,13350765,16847528,23197,12258021,14175678
1980-04-28,1980,211,N,3,3+,28415,13379180,16847528,21667,12279688,14175678
1980-04-29,1980,212,N,3,3+,29182,13408362,16847528,22078,12301766,14175678
1980-04-30,1980,213,N,3,3+,28026,13436388,16847528,20410,12322176,14175678
1980-05-01,1980,214,N,3,3+,27525,13463913,16847528,20057,12342233,14175678
1980-05-02,1980,215,N,3,3+,27668,13491581,16847528,21311,12363544,14175678
1980-05-03,1980,216,N,3,3+,26283,13517864,16847528,19761,12383305,14175678
1980-05-04,1980,217,N,3,3+,24894,13542758,16847528,18431,12401736,14175678
1980-05-05,1980,218,N,3,3+,24685,13567443,16847528,18364,12420100,14175678
1980-05-06,1980,219,N,3,3+,24552,13591995,16847528,18218,12438318,14175678
1980-05-07,1980,220,N,3,3+,24202,13616197,16847528,18466,12456784,14175678
1980-05-08,1980,221,N,3,3+,23978,13640175,16847528,17895,12474679,14175678
1980-05-09,1980,222,N,3,3+,25407,13665582,16847528,20355,12495034,14175678
1980-05-10,1980,223,N,3,3+,27038,13692620,16847528,22750,12517784,14175678
1980-05-11,1980,224,N,3,3+,29360,13721980,16847528,25802,12543586,14175678
1980-05-12,1980,225,N,3,3+,31418,13753398,16847528,27386,12570972,14175678
1980-05-13,1980,226,N,3,3+,31708,13785106,16847528,27719,12598691,14175678
1980-05-14,1980,227,N,3,3+,31882,13816988,16847528,27283,12625974,14175678
1980-05-15,1980,228,N,3,3+,30851,13847839,16847528,24709,12650683,14175678
1980-05-16,1980,229,N,3,3+,30653,13878492,16847528,24407,12675090,14175678
1980-05-17,1980,230,N,3,3+,30100,13908592,16847528,23819,12698909,14175678
1980-05-18,1980,231,N,3,3+,29931,13938523,16847528,23583,12722492,14175678
1980-05-19,1980,232,N,3,3+,29777,13968300,16847528,22952,12745444,14175678
1980-05-20,1980,233,N,3,3+,28697,13996997,16847528,21993,12767437,14175678
1980-05-21,1980,234,N,3,3+,28328,14025325,16847528,20920,12788357,14175678
1980-05-22,1980,235,N,3,3+,28881,14054206,16847528,21104,12809461,14175678
1980-05-23,1980,236,N,3,3+,28553,14082759,16847528,20696,12830157,14175678
1980-05-24,1980,237,N,3,3+,27848,14110607,16847528,19489,12849646,14175678
1980-05-25,1980,238,N,3,3+,27593,14138200,16847528,18520,12868166,14175678
1980-05-26,1980,239,N,3,3+,26727,14164927,16847528,17660,12885826,14175678
1980-05-27,1980,240,N,3,3+,25719,14190646,16847528,16625,12902451,14175678
1980-05-28,1980,241,N,3,3+,26685,14217331,16847528,17560,12920011,14175678
1980-05-29,1980,242,N,3,3+,25635,14242966,16847528,16393,12936404,14175678
1980-05-30,1980,243,N,3,3+,24499,14267465,16847528,15226,12951630,14175678
1980-05-31,1980,244,N,3,3+,24096,14291561,16847528,15455,12967085,14175678
1980-06-01,1980,245,N,3,3+,23530,14315091,16847528,14188,12981273,14175678
1980-06-02,1980,246,N,3,3+,23615,14338706,16847528,14445,12995718,14175678
1980-06-03,1980,247,N,3,3+,22427,14361133,16847528,14286,13010004,14175678
1980-06-04,1980,248,N,3,3+,22366,14383499,16847528,14598,13024602,14175678
1980-06-05,1980,249,N,3,3+,22024,14405523,16847528,14035,13038637,14175678
1980-06-06,1980,250,N,3,3+,22404,14427927,16847528,13665,13052302,14175678
1980-06-07,1980,251,N,3,3+,22601,14450528,16847528,13607,13065909,14175678
1980-06-08,1980,252,N,3,3+,22691,14473219,16847528,13592,13079501,14175678
1980-06-09,1980,253,N,3,3+,23174,14496393,16847528,13938,13093439,14175678
1980-06-10,1980,254,N,3,3+,22934,14519327,16847528,14851,13108290,14175678
1980-06-11,1980,255,N,3,3+,23248,14542575,16847528,16325,13124615,14175678
1980-06-12,1980,256,N,3,3+,24199,14566774,16847528,14726,13139341,14175678
1980-06-13,1980,257,N,3,3+,24571,14591345,16847528,14438,13153779,14175678
1980-06-14,1980,258,N,3,3+,25038,14616383,16847528,12249,13166028,14175678
1980-06-15,1980,259,N,3,3+,24916,14641299,16847528,12776,13178804,14175678
1980-06-16,1980,260,N,3,3+,25069,14666368,16847528,15013,13193817,14175678
1980-06-17,1980,261,N,3,3+,25420,14691788,16847528,15145,13208962,14175678
1980-06-18,1980,262,N,3,3+,25682,14717470,16847528,15516,13224478,14175678
1980-06-19,1980,263,N,3,3+,25686,14743156,16847528,15742,13240220,14175678
1980-06-20,1980,264,N,3,3+,25923,14769079,16847528,15896,13256116,14175678
1980-06-21,1980,265,N,3,3+,26392,14795471,16847528,15731,13271847,14175678
1980-06-22,1980,266,N,3,3+,26288,14821759,16847528,15588,13287435,14175678
1980-06-23,1980,267,N,3,3+,26235,14847994,16847528,15638,13303073,14175678
1980-06-24,1980,268,N,3,3+,25901,14873895,16847528,15301,13318374,14175678
1980-06-25,1980,269,N,3,3+,26494,14900389,16847528,15936,13334310,14175678
1980-06-26,1980,270,N,3,3+,26511,14926900,16847528,16262,13350572,14175678
1980-06-27,1980,271,N,3,3+,25648,14952548,16847528,15753,13366325,14175678
1980-06-28,1980,272,N,3,3+,25321,14977869,16847528,15104,13381429,14175678
1980-06-29,1980,273,N,3,3+,25416,15003285,16847528,15286,13396715,14175678
1980-06-30,1980,274,N,3,3+,25595,15028880,16847528,14079,13410794,14175678
1980-07-01,1980,275,N,3,3+,24746,15053626,16847528,11643,13422437,14175678
1980-07-02,1980,276,N,3,3+,24726,15078352,16847528,13854,13436291,14175678
1980-07-03,1980,277,N,3,3+,24547,15102899,16847528,15431,13451722,14175678
1980-07-04,1980,278,N,3,3+,23215,15126114,16847528,15512,13467234,14175678
1980-07-05,1980,279,N,3,3+,23005,15149119,16847528,14736,13481970,14175678
1980-07-06,1980,280,N,3,3+,22067,15171186,16847528,14378,13496348,14175678
1980-07-07,1980,281,N,3,3+,21836,15193022,16847528,12033,13508381,14175678
1980-07-08,1980,282,N,3,3+,21647,15214669,16847528,10156,13518537,14175678
1980-07-09,1980,283,N,3,3+,22035,15236704,16847528,10459,13528996,14175678
1980-07-10,1980,284,N,3,3+,21911,15258615,16847528,10286,13539282,14175678
1980-07-11,1980,285,N,3,3+,21667,15280282,16847528,10126,13549408,14175678
1980-07-12,1980,286,N,3,3+,21442,15301724,16847528,9888,13559296,14175678
1980-07-13,1980,287,N,3,3+,21130,15322854,16847528,8986,13568282,14175678
1980-07-14,1980,288,N,3,3+,20870,15343724,16847528,8656,13576938,14175678
1980-07-15,1980,289,N,3,3+,20432,15364156,16847528,10021,13586959,14175678
1980-07-16,1980,290,N,3,3+,20252,15384408,16847528,9835,13596794,14175678
1980-07-17,1980,291,N,3,3+,20570,15404978,16847528,10134,13606928,14175678
1980-07-18,1980,292,N,3,3+,21081,15426059,16847528,10467,13617395,14175678
1980-07-19,1980,293,N,3,3+,21908,15447967,16847528,10611,13628006,14175678
1980-07-20,1980,294,N,3,3+,22260,15470227,16847528,9612,13637618,14175678
1980-07-21,1980,295,N,3,3+,22511,15492738,16847528,10439,13648057,14175678
1980-07-22,1980,296,N,3,3+,22418,15515156,16847528,10841,13658898,14175678
1980-07-23,1980,297,N,3,3+,22086,15537242,16847528,10602,13669500,14175678
1980-07-24,1980,298,N,3,3+,21922,15559164,16847528,10635,13680135,14175678
1980-07-25,1980,299,N,3,3+,21687,15580851,16847528,10689,13690824,14175678
1980-07-26,1980,300,N,3,3+,21376,15602227,16847528,10731,13701555,14175678
1980-07-27,1980,301,N,3,3+,21370,15623597,16847528,10811,13712366,14175678
1980-07-28,1980,302,N,3,3+,21492,15645089,16847528,11007,13723373,14175678
1980-07-29,1980,303,N,3,3+,20740,15665829,16847528,10468,13733841,14175678
1980-07-30,1980,304,N,3,3+,20782,15686611,16847528,10427,13744268,14175678
1980-07-31,1980,305,N,3,3+,19674,15706285,16847528,9548,13753816,14175678
1980-08-01,1980,306,N,3,3+,18593,15724878,16847528,5248,13759064,14175678
1980-08-02,1980,307,N,3,3+,18496,15743374,16847528,5514,13764578,14175678
1980-08-03,1980,308,N,3,3+,18625,15761999,16847528,6181,13770759,14175678
1980-08-04,1980,309,N,3,3+,18909,15780908,16847528,6195,13776954,14175678
1980-08-05,1980,310,N,3,3+,18521,15799429,16847528,5271,13782225,14175678
1980-08-06,1980,311,N,3,3+,19007,15818436,16847528,6081,13788306,14175678
1980-08-07,1980,312,N,3,3+,18559,15836995,16847528,5425,13793731,14175678
1980-08-08,1980,313,N,3,3+,18124,15855119,16847528,5049,13798780,14175678
1980-08-09,1980,314,N,3,3+,17854,15872973,16847528,3817,13802597,14175678
1980-08-10,1980,315,N,3,3+,17857,15890830,16847528,4332,13806929,14175678
1980-08-11,1980,316,N,3,3+,18308,15909138,16847528,4627,13811556,14175678
1980-08-12,1980,317,N,3,3+,17548,15926686,16847528,4170,13815726,14175678
1980-08-13,1980,318,N,3,3+,16597,15943283,16847528,3099,13818825,14175678
1980-08-14,1980,319,N,3,3+,16030,15959313,16847528,2753,13821578,14175678
1980-08-15,1980,320,N,3,3+,16041,15975354,16847528,3092,13824670,14175678
1980-08-16,1980,321,N,3,3+,16239,15991593,16847528,3052,13827722,14175678
1980-08-17,1980,322,N,3,3+,16386,16007979,16847528,2634,13830356,14175678
1980-08-18,1980,323,N,3,3+,15856,16023835,16847528,1911,13832267,14175678
1980-08-19,1980,324,N,3,3+,16045,16039880,16847528,3234,13835501,14175678
1980-08-20,1980,325,N,3,3+,16811,16056691,16847528,3490,13838991,14175678
1980-08-21,1980,326,N,3,3+,17373,16074064,16847528,3068,13842059,14175678
1980-08-22,1980,327,N,3,3+,16980,16091044,16847528,3479,13845538,14175678
1980-08-23,1980,328,N,3,3+,17440,16108484,16847528,3833,13849371,14175678
1980-08-24,1980,329,N,3,3+,17384,16125868,16847528,3942,13853313,14175678
1980-08-25,1980,330,N,3,3+,16957,16142825,16847528,3474,13856787,14175678
1980-08-26,1980,331,N,3,3+,16508,16159333,16847528,3437,13860224,14175678
1980-08-27,1980,332,N,3,3+,16026,16175359,16847528,3670,13863894,14175678
1980-08-28,1980,333,N,3,3+,15017,16190376,16847528,4003,13867897,14175678
1980-08-29,1980,334,N,3,3+,15914,16206290,16847528,4273,13872170,14175678
1980-08-30,1980,335,N,3,3+,17255,16223545,16847528,4566,13876736,14175678
1980-08-31,1980,336,N,3,3+,17495,16241040,16847528,4852,13881588,14175678
1980-09-01,1980,337,N,3,3+,18425,16259465,16847528,5413,13887001,14175678
1980-09-02,1980,338,N,3,3+,18857,16278322,16847528,5402,13892403,14175678
1980-09-03,1980,339,N,3,3+,18894,16297216,16847528,7402,13899805,14175678
1980-09-04,1980,340,N,3,3+,19779,16316995,16847528,8264,13908069,14175678
1980-09-05,1980,341,N,3,3+,19832,16336827,16847528,7674,13915743,14175678
1980-09-06,1980,342,N,3,3+,19846,16356673,16847528,7190,13922933,14175678
1980-09-07,1980,343,N,3,3+,20254,16376927,16847528,7545,13930478,14175678
1980-09-08,1980,344,N,3,3+,20431,16397358,16847528,7457,13937935,14175678
1980-09-09,1980,345,N,3,3+,20188,16417546,16847528,7494,13945429,14175678
1980-09-10,1980,346,N,3,3+,20331,16437877,16847528,7635,13953064,14175678
1980-09-11,1980,347,N,3,3+,21002,16458879,16847528,10069,13963133,14175678
1980-09-12,1980,348,N,3,3+,20799,16479678,16847528,10201,13973334,14175678
1980-09-13,1980,349,N,3,3+,20595,16500273,16847528,9165,13982499,14175678
1980-09-14,1980,350,N,3,3+,21706,16521979,16847528,10115,13992614,14175678
1980-09-15,1980,351,N,3,3+,21408,16543387,16847528,9945,14002559,14175678
1980-09-16,1980,352,N,3,3+,20688,16564075,16847528,10867,14013426,14175678
1980-09-17,1980,353,N,3,3+,20924,16584999,16847528,11030,14024456,14175678
1980-09-18,1980,354,N,3,3+,21035,16606034,16847528,11549,14036005,14175678
1980-09-19,1980,355,N,3,3+,21115,16627149,16847528,11786,14047791,14175678
1980-09-20,1980,356,N,3,3+,21246,16648395,16847528,10400,14058191,14175678
1980-09-21,1980,357,N,3,3+,21335,16669730,16847528,9129,14067320,14175678
1980-09-22,1980,358,N,3,3+,20971,16690701,16847528,9952,14077272,14175678
1980-09-23,1980,359,N,3,3+,20479,16711180,16847528,10976,14088248,14175678
1980-09-24,1980,360,N,3,3+,20000,16731180,16847528,10762,14099010,14175678
1980-09-25,1980,361,N,3,3+,19285,16750465,16847528,9968,14108978,14175678
1980-09-26,1980,362,N,3,3+,18787,16769252,16847528,11053,14120031,14175678
1980-09-27,1980,363,N,3,3+,20175,16789427,16847528,16933,14136964,14175678
1980-09-28,1980,364,N,3,3+,20905,16810332,16847528,17664,14154628,14175678
1980-09-29,1980,365,N,3,3+,19466,16829798,16847528,13475,14168103,14175678
1980-09-30,1980,366,N,3,3+,17730,16847528,16847528,7575,14175678,14175678
1980-10-01,1981,1,N,4,3+,17759,17759,6889547,9640,9640,3969425
1980-10-02,1981,2,N,4,3+,17937,35696,6889547,9009,18649,3969425
1980-10-03,1981,3,N,4,3+,19037,54733,6889547,9503,28152,3969425
1980-10-04,1981,4,N,4,3+,19333,74066,6889547,8518,36670,3969425
1980-10-05,1981,5,N,4,3+,19463,93529,6889547,7350,44020,3969425
1980-10-06,1981,6,N,4,3+,19706,113235,6889547,9191,53211,3969425
1980-10-07,1981,7,N,4,3+,19628,132863,6889547,10262,63473,3969425
1980-10-08,1981,8,N,4,3+,19363,152226,6889547,10227,73700,3969425
1980-10-09,1981,9,N,4,3+,19032,171258,6889547,9955,83655,3969425
1980-10-10,1981,10,N,4,3+,19191,190449,6889547,10175,93830,3969425
1980-10-11,1981,11,N,4,3+,18311,208760,6889547,8796,102626,3969425
1980-10-12,1981,12,N,4,3+,17510,226270,6889547,7297,109923,3969425
1980-10-13,1981,13,N,4,3+,16847,243117,6889547,8012,117935,3969425
1980-10-14,1981,14,N,4,3+,16757,259874,6889547,8005,125940,3969425
1980-10-15,1981,15,N,4,3+,16455,276329,6889547,7423,133363,3969425
1980-10-16,1981,16,N,4,3+,16174,292503,6889547,7854,141217,3969425
1980-10-17,1981,17,N,4,3+,15198,307701,6889547,7442,148659,3969425
1980-10-18,1981,18,N,4,3+,14077,321778,6889547,5537,154196,3969425
1980-10-19,1981,19,N,4,3+,13288,335066,6889547,3533,157729,3969425
1980-10-20,1981,20,N,4,3+,12809,347875,6889547,3946,161675,3969425
1980-10-21,1981,21,N,4,3+,12384,360259,6889547,4967,166642,3969425
1980-10-22,1981,22,N,4,3+,13022,373281,6889547,3782,170424,3969425
1980-10-23,1981,23,N,4,3+,12895,386176,6889547,6303,176727,3969425
1980-10-24,1981,24,N,4,3+,12402,398578,6889547,7152,183879,3969425
1980-10-25,1981,25,N,4,3+,12659,411237,6889547,6604,190483,3969425
1980-10-26,1981,26,N,4,3+,13280,424517,6889547,7366,197849,3969425
1980-10-27,1981,27,N,4,3+,13549,438066,6889547,6246,204095,3969425
1980-10-28,1981,28,N,4,3+,13498,451564,6889547,6085,210180,3969425
1980-10-29,1981,29,N,4,3+,13860,465424,6889547,5644,215824,3969425
1980-10-30,1981,30,N,4,3+,13463,478887,6889547,5534,221358,3969425
1980-10-31,1981,31,N,4,3+,13399,492286,6889547,5588,226946,3969425
1980-11-01,1981,32,N,4,3+,13724,506010,6889547,4954,231900,3969425
1980-11-02,1981,33,N,4,3+,13765,519775,6889547,5439,237339,3969425
1980-11-03,1981,34,N,4,3+,14577,534352,6889547,6690,244029,3969425
1980-11-04,1981,35,N,4,3+,15111,549463,6889547,5618,249647,3969425
1980-11-05,1981,36,N,4,3+,15638,565101,6889547,6618,256265,3969425
1980-11-06,1981,37,N,4,3+,15764,580865,6889547,7201,263466,3969425
1980-11-07,1981,38,N,4,3+,14887,595752,6889547,6500,269966,3969425
1980-11-08,1981,39,N,4,3+,14946,610698,6889547,6694,276660,3969425
1980-11-09,1981,40,N,4,3+,14668,625366,6889547,6331,282991,3969425
1980-11-10,1981,41,N,4,3+,14887,640253,6889547,7406,290397,3969425
1980-11-11,1981,42,N,4,3+,14609,654862,6889547,6886,297283,3969425
1980-11-12,1981,43,N,4,3+,14638,669500,6889547,6887,304170,3969425
1980-11-13,1981,44,N,4,3+,14676,684176,6889547,7042,311212,3969425
1980-11-14,1981,45,N,4,3+,14758,698934,6889547,7052,318264,3969425
1980-11-15,1981,46,N,4,3+,14547,713481,6889547,6720,324984,3969425
1980-11-16,1981,47,N,4,3+,14642,728123,6889547,6392,331376,3969425
1980-11-17,1981,48,N,4,3+,15055,743178,6889547,7655,339031,3969425
1980-11-18,1981,49,N,4,3+,14309,757487,6889547,6159,345190,3969425
1980-11-19,1981,50,N,4,3+,13987,771474,6889547,6637,351827,3969425
1980-11-20,1981,51,N,4,3+,13640,785114,6889547,5404,357231,3969425
1980-11-21,1981,52,N,4,3+,14603,799717,6889547,6358,363589,3969425
1980-11-22,1981,53,N,4,3+,14473,814190,6889547,5804,369393,3969425
1980-11-23,1981,54,N,4,3+,14830,829020,6889547,5650,375043,3969425
1980-11-24,1981,55,N,4,3+,15129,844149,6889547,7677,382720,3969425
1980-11-25,1981,56,N,4,3+,14969,859118,6889547,7462,390182,3969425
1980-11-26,1981,57,N,4,3+,14854,873972,6889547,7541,397723,3969425
1980-11-27,1981,58,N,4,3+,14961,888933,6889547,8038,405761,3969425
1980-11-28,1981,59,N,4,3+,14957,903890,6889547,7439,413200,3969425
1980-11-29,1981,60,N,4,3+,14796,918686,6889547,6519,419719,3969425
1980-11-30,1981,61,N,4,3+,15058,933744,6889547,7081,426800,3969425
1980-12-01,1981,62,N,4,3+,15257,949001,6889547,7747,434547,3969425
1980-12-02,1981,63,N,4,3+,14886,963887,6889547,7049,441596,3969425
1980-12-03,1981,64,N,4,3+,15231,979118,6889547,7172,448768,3969425
1980-12-04,1981,65,N,4,3+,19327,998445,6889547,16373,465141,3969425
1980-12-05,1981,66,N,4,3+,31309,1029754,6889547,28498,493639,3969425
1980-12-06,1981,67,N,4,3+,33434,1063188,6889547,30213,523852,3969425
1980-12-07,1981,68,N,4,3+,29876,1093064,6889547,26448,550300,3969425
1980-12-08,1981,69,N,4,3+,26707,1119771,6889547,23967,574267,3969425
1980-12-09,1981,70,N,4,3+,24507,1144278,6889547,15723,589990,3969425
1980-12-10,1981,71,N,4,3+,22621,1166899,6889547,14266,604256,3969425
1980-12-11,1981,72,N,4,3+,21540,1188439,6889547,12967,617223,3969425
1980-12-12,1981,73,N,4,3+,20276,1208715,6889547,11716,628939,3969425
1980-12-13,1981,74,N,4,3+,19436,1228151,6889547,9851,638790,3969425
1980-12-14,1981,75,N,4,3+,18984,1247135,6889547,8703,647493,3969425
1980-12-15,1981,76,N,4,3+,18196,1265331,6889547,8704,656197,3969425
1980-12-16,1981,77,N,4,3+,17620,1282951,6889547,8985,665182,3969425
1980-12-17,1981,78,N,4,3+,17330,1300281,6889547,7916,673098,3969425
1980-12-18,1981,79,N,4,3+,17228,1317509,6889547,8169,681267,3969425
1980-12-19,1981,80,N,4,3+,17439,1334948,6889547,8436,689703,3969425
1980-12-20,1981,81,N,4,3+,17317,1352265,6889547,7824,697527,3969425
1980-12-21,1981,82,N,4,3+,17476,1369741,6889547,8071,705598,3969425
1980-12-22,1981,83,N,4,3+,18219,1387960,6889547,11498,717096,3969425
1980-12-23,1981,84,N,4,3+,17955,1405915,6889547,11621,728717,3969425
1980-12-24,1981,85,N,4,3+,18992,1424907,6889547,12420,741137,3969425
1980-12-25,1981,86,N,4,3+,19237,1444144,6889547,13545,754682,3969425
1980-12-26,1981,87,N,4,3+,18539,1462683,6889547,12744,767426,3969425
1980-12-27,1981,88,N,4,3+,17532,1480215,6889547,8648,776074,3969425
1980-12-28,1981,89,N,4,3+,17881,1498096,6889547,9060,785134,3969425
1980-12-29,1981,90,N,4,3+,18164,1516260,6889547,10176,795310,3969425
1980-12-30,1981,91,N,4,3+,17237,1533497,6889547,8694,804004,3969425
1980-12-31,1981,92,N,4,3+,17686,1551183,6889547,9887,813891,3969425
1981-01-01,1981,93,N,4,3+,17545,1568728,6889547,8943,822834,3969425
1981-01-02,1981,94,N,4,3+,16916,1585644,6889547,8358,831192,3969425
1981-01-03,1981,95,N,4,3+,16077,1601721,6889547,6631,837823,3969425
1981-01-04,1981,96,N,4,3+,16370,1618091,6889547,7947,845770,3969425
1981-01-05,1981,97,N,4,3+,16054,1634145,6889547,8445,854215,3969425
1981-01-06,1981,98,N,4,3+,15472,1649617,6889547,7178,861393,3969425
1981-01-07,1981,99,N,4,3+,15945,1665562,6889547,7836,869229,3969425
1981-01-08,1981,100,N,4,3+,16258,1681820,6889547,7512,876741,3969425
1981-01-09,1981,101,N,4,3+,16432,1698252,6889547,7505,884246,3969425
1981-01-10,1981,102,N,4,3+,16071,1714323,6889547,6612,890858,3969425
1981-01-11,1981,103,N,4,3+,15631,1729954,6889547,5220,896078,3969425
1981-01-12,1981,104,N,4,3+,14966,1744920,6889547,5638,901716,3969425
1981-01-13,1981,105,N,4,3+,14367,1759287,6889547,5332,907048,3969425
1981-01-14,1981,106,N,4,3+,14877,1774164,6889547,5580,912628,3969425
1981-01-15,1981,107,N,4,3+,14486,1788650,6889547,4353,916981,3969425
1981-01-16,1981,108,N,4,3+,14235,1802885,6889547,4057,921038,3969425
1981-01-17,1981,109,N,4,3+,14171,1817056,6889547,3840,924878,3969425
1981-01-18,1981,110,N,4,3+,13940,1830996,6889547,3116,927994,3969425
1981-01-19,1981,111,N,4,3+,13424,1844420,6889547,2814,930808,3969425
1981-01-20,1981,112,N,4,3+,13706,1858126,6889547,3125,933933,3969425
1981-01-21,1981,113,N,4,3+,14790,1872916,6889547,5247,939180,3969425
1981-01-22,1981,114,N,4,3+,15587,1888503,6889547,6389,945569,3969425
1981-01-23,1981,115,N,4,3+,18300,1906803,6889547,18972,964541,3969425
1981-01-24,1981,116,N,4,3+,26223,1933026,6889547,27040,991581,3969425
1981-01-25,1981,117,N,4,3+,37516,1970542,6889547,37909,1029490,3969425
1981-01-26,1981,118,N,4,3+,37618,2008160,6889547,38281,1067771,3969425
1981-01-27,1981,119,N,4,3+,35374,2043534,6889547,42707,1110478,3969425
1981-01-28,1981,120,N,4,3+,43826,2087360,6889547,52520,1162998,3969425
1981-01-29,1981,121,N,4,3+,59043,2146403,6889547,70251,1233249,3969425
1981-01-30,1981,122,N,4,3+,62376,2208779,6889547,73520,1306769,3969425
1981-01-31,1981,123,N,4,3+,64268,2273047,6889547,75205,1381974,3969425
1981-02-01,1981,124,N,4,3+,62924,2335971,6889547,67260,1449234,3969425
1981-02-02,1981,125,N,4,3+,54819,2390790,6889547,49840,1499074,3969425
1981-02-03,1981,126,N,4,3+,44945,2435735,6889547,36459,1535533,3969425
1981-02-04,1981,127,N,4,3+,38502,2474237,6889547,29843,1565376,3969425
1981-02-05,1981,128,N,4,3+,34402,2508639,6889547,25754,1591130,3969425
1981-02-06,1981,129,N,4,3+,30740,2539379,6889547,22030,1613160,3969425
1981-02-07,1981,130,N,4,3+,26625,2566004,6889547,17912,1631072,3969425
1981-02-08,1981,131,N,4,3+,23735,2589739,6889547,15119,1646191,3969425
1981-02-09,1981,132,N,4,3+,21824,2611563,6889547,13886,1660077,3969425
1981-02-10,1981,133,N,4,3+,20268,2631831,6889547,12494,1672571,3969425
1981-02-11,1981,134,N,4,3+,19664,2651495,6889547,12550,1685121,3969425
1981-02-12,1981,135,N,4,3+,18730,2670225,6889547,12260,1697381,3969425
1981-02-13,1981,136,N,4,3+,18116,2688341,6889547,12254,1709635,3969425
1981-02-14,1981,137,N,4,3+,18375,2706716,6889547,12918,1722553,3969425
1981-02-15,1981,138,N,4,3+,21450,2728166,6889547,14628,1737181,3969425
1981-02-16,1981,139,N,4,3+,31991,2760157,6889547,24519,1761700,3969425
1981-02-17,1981,140,N,4,3+,34783,2794940,6889547,26611,1788311,3969425
1981-02-18,1981,141,N,4,3+,30860,2825800,6889547,22798,1811109,3969425
1981-02-19,1981,142,N,4,3+,28466,2854266,6889547,20466,1831575,3969425
1981-02-20,1981,143,N,4,3+,27187,2881453,6889547,19729,1851304,3969425
1981-02-21,1981,144,N,4,3+,25231,2906684,6889547,17902,1869206,3969425
1981-02-22,1981,145,N,4,3+,24262,2930946,6889547,16130,1885336,3969425
1981-02-23,1981,146,N,4,3+,22350,2953296,6889547,14745,1900081,3969425
1981-02-24,1981,147,N,4,3+,20987,2974283,6889547,13279,1913360,3969425
1981-02-25,1981,148,N,4,3+,21164,2995447,6889547,14866,1928226,3969425
1981-02-26,1981,149,N,4,3+,20951,3016398,6889547,14791,1943017,3969425
1981-02-27,1981,150,N,4,3+,22702,3039100,6889547,16023,1959040,3969425
1981-02-28,1981,151,N,4,3+,22988,3062088,6889547,15733,1974773,3969425
1981-03-01,1981,152,N,4,3+,22043,3084131,6889547,13777,1988550,3969425
1981-03-02,1981,153,N,4,3+,20880,3105011,6889547,13552,2002102,3969425
1981-03-03,1981,154,N,4,3+,19731,3124742,6889547,13572,2015674,3969425
1981-03-04,1981,155,N,4,3+,19594,3144336,6889547,13854,2029528,3969425
1981-03-05,1981,156,N,4,3+,20949,3165285,6889547,20089,2049617,3969425
1981-03-06,1981,157,N,4,3+,24643,3189928,6889547,23706,2073323,3969425
1981-03-07,1981,158,N,4,3+,28021,3217949,6889547,26815,2100138,3969425
1981-03-08,1981,159,N,4,3+,26169,3244118,6889547,24316,2124454,3969425
1981-03-09,1981,160,N,4,3+,23376,3267494,6889547,22847,2147301,3969425
1981-03-10,1981,161,N,4,3+,21281,3288775,6889547,17227,2164528,3969425
1981-03-11,1981,162,N,4,3+,19665,3308440,6889547,14784,2179312,3969425
1981-03-12,1981,163,N,4,3+,18527,3326967,6889547,13280,2192592,3969425
1981-03-13,1981,164,N,4,3+,17918,3344885,6889547,12788,2205380,3969425
1981-03-14,1981,165,N,4,3+,17182,3362067,6889547,12307,2217687,3969425
1981-03-15,1981,166,N,4,3+,17504,3379571,6889547,11733,2229420,3969425
1981-03-16,1981,167,N,4,3+,19129,3398700,6889547,15862,2245282,3969425
1981-03-17,1981,168,N,4,3+,19516,3418216,6889547,17750,2263032,3969425
1981-03-18,1981,169,N,4,3+,21915,3440131,6889547,18817,2281849,3969425
1981-03-19,1981,170,N,4,3+,26085,3466216,6889547,28931,2310780,3969425
1981-03-20,1981,171,N,4,3+,34608,3500824,6889547,37749,2348529,3969425
1981-03-21,1981,172,N,4,3+,38205,3539029,6889547,40516,2389045,3969425
1981-03-22,1981,173,N,4,3+,37662,3576691,6889547,40538,2429583,3969425
1981-03-23,1981,174,N,4,3+,40647,3617338,6889547,43380,2472963,3969425
1981-03-24,1981,175,N,4,3+,42276,3659614,6889547,38464,2511427,3969425
1981-03-25,1981,176,N,4,3+,42437,3702051,6889547,38806,2550233,3969425
1981-03-26,1981,177,N,4,3+,48017,3750068,6889547,44982,2595215,3969425
1981-03-27,1981,178,N,4,3+,47677,3797745,6889547,45332,2640547,3969425
1981-03-28,1981,179,N,4,3+,46087,3843832,6889547,42283,2682830,3969425
1981-03-29,1981,180,N,4,3+,43752,3887584,6889547,39676,2722506,3969425
1981-03-30,1981,181,N,4,3+,41903,3929487,6889547,38311,2760817,3969425
1981-03-31,1981,182,N,4,3+,39309,3968796,6889547,34937,2795754,3969425
1981-04-01,1981,183,N,4,3+,38966,4007762,6889547,32847,2828601,3969425
1981-04-02,1981,184,N,4,3+,37562,4045324,6889547,30467,2859068,3969425
1981-04-03,1981,185,N,4,3+,35355,4080679,6889547,28002,2887070,3969425
1981-04-04,1981,186,N,4,3+,32839,4113518,6889547,26183,2913253,3969425
1981-04-05,1981,187,N,4,3+,30391,4143909,6889547,22725,2935978,3969425
1981-04-06,1981,188,N,4,3+,27249,4171158,6889547,19159,2955137,3969425
1981-04-07,1981,189,N,4,3+,24630,4195788,6889547,16065,2971202,3969425
1981-04-08,1981,190,N,4,3+,22751,4218539,6889547,12883,2984085,3969425
1981-04-09,1981,191,N,4,3+,20255,4238794,6889547,9960,2994045,3969425
1981-04-10,1981,192,N,4,3+,18599,4257393,6889547,7700,3001745,3969425
1981-04-11,1981,193,N,4,3+,18071,4275464,6889547,6797,3008542,3969425
1981-04-12,1981,194,N,4,3+,17611,4293075,6889547,6328,3014870,3969425
1981-04-13,1981,195,N,4,3+,16963,4310038,6889547,5933,3020803,3969425
1981-04-14,1981,196,N,4,3+,15821,4325859,6889547,4272,3025075,3969425
1981-04-15,1981,197,N,4,3+,14682,4340541,6889547,4394,3029469,3969425
1981-04-16,1981,198,N,4,3+,14179,4354720,6889547,3764,3033233,3969425
1981-04-17,1981,199,N,4,3+,12983,4367703,6889547,2136,3035369,3969425
1981-04-18,1981,200,N,4,3+,12587,4380290,6889547,110,3035479,3969425
1981-04-19,1981,201,N,4,3+,14444,4394734,6889547,9606,3045085,3969425
1981-04-20,1981,202,N,4,3+,17105,4411839,6889547,14284,3059369,3969425
1981-04-21,1981,203,N,4,3+,17735,4429574,6889547,17168,3076537,3969425
1981-04-22,1981,204,N,4,3+,18373,4447947,6889547,16659,3093196,3969425
1981-04-23,1981,205,N,4,3+,17894,4465841,6889547,16536,3109732,3969425
1981-04-24,1981,206,N,4,3+,17761,4483602,6889547,9638,3119370,3969425
1981-04-25,1981,207,N,4,3+,17160,4500762,6889547,7019,3126389,3969425
1981-04-26,1981,208,N,4,3+,16224,4516986,6889547,6602,3132991,3969425
1981-04-27,1981,209,N,4,3+,15963,4532949,6889547,5549,3138540,3969425
1981-04-28,1981,210,N,4,3+,15066,4548015,6889547,4273,3142813,3969425
1981-04-29,1981,211,N,4,3+,14476,4562491,6889547,1824,3144637,3969425
1981-04-30,1981,212,N,4,3+,13116,4575607,6889547,547,3145184,3969425
1981-05-01,1981,213,N,4,3+,12823,4588430,6889547,648,3145832,3969425
1981-05-02,1981,214,N,4,3+,12446,4600876,6889547,537,3146369,3969425
1981-05-03,1981,215,N,4,3+,12109,4612985,6889547,177,3146546,3969425
1981-05-04,1981,216,N,4,3+,11862,4624847,6889547,6227,3152773,3969425
1981-05-05,1981,217,N,4,3+,11491,4636338,6889547,5194,3157967,3969425
1981-05-06,1981,218,N,4,3+,13258,4649596,6889547,7259,3165226,3969425
1981-05-07,1981,219,N,4,3+,14333,4663929,6889547,8831,3174057,3969425
1981-05-08,1981,220,N,4,3+,14926,4678855,6889547,9299,3183356,3969425
1981-05-09,1981,221,N,4,3+,15796,4694651,6889547,10114,3193470,3969425
1981-05-10,1981,222,N,4,3+,16026,4710677,6889547,10361,3203831,3969425
1981-05-11,1981,223,N,4,3+,16487,4727164,6889547,10350,3214181,3969425
1981-05-12,1981,224,N,4,3+,16255,4743419,6889547,10083,3224264,3969425
1981-05-13,1981,225,N,4,3+,16051,4759470,6889547,9842,3234106,3969425
1981-05-14,1981,226,N,4,3+,16036,4775506,6889547,10028,3244134,3969425
1981-05-15,1981,227,N,4,3+,15926,4791432,6889547,10150,3254284,3969425
1981-05-16,1981,228,N,4,3+,16713,4808145,6889547,10506,3264790,3969425
1981-05-17,1981,229,N,4,3+,16799,4824944,6889547,9239,3274029,3969425
1981-05-18,1981,230,N,4,3+,17460,4842404,6889547,9434,3283463,3969425
1981-05-19,1981,231,N,4,3+,18749,4861153,6889547,10353,3293816,3969425
1981-05-20,1981,232,N,4,3+,19217,4880370,6889547,11778,3305594,3969425
1981-05-21,1981,233,N,4,3+,20308,4900678,6889547,14787,3320381,3969425
1981-05-22,1981,234,N,4,3+,19579,4920257,6889547,13672,3334053,3969425
1981-05-23,1981,235,N,4,3+,18597,4938854,6889547,12619,3346672,3969425
1981-05-24,1981,236,N,4,3+,17923,4956777,6889547,11462,3358134,3969425
1981-05-25,1981,237,N,4,3+,17758,4974535,6889547,11651,3369785,3969425
1981-05-26,1981,238,N,4,3+,17191,4991726,6889547,11382,3381167,3969425
1981-05-27,1981,239,N,4,3+,16582,5008308,6889547,10661,3391828,3969425
1981-05-28,1981,240,N,4,3+,16776,5025084,6889547,9946,3401774,3969425
1981-05-29,1981,241,N,4,3+,16705,5041789,6889547,9970,3411744,3969425
1981-05-30,1981,242,N,4,3+,16329,5058118,6889547,9197,3420941,3969425
1981-05-31,1981,243,N,4,3+,14892,5073010,6889547,7662,3428603,3969425
1981-06-01,1981,244,N,4,3+,13427,5086437,6889547,6892,3435495,3969425
1981-06-02,1981,245,N,4,3+,12659,5099096,6889547,5969,3441464,3969425
1981-06-03,1981,246,N,4,3+,12224,5111320,6889547,5393,3446857,3969425
1981-06-04,1981,247,N,4,3+,11629,5122949,6889547,4398,3451255,3969425
1981-06-05,1981,248,N,4,3+,11033,5133982,6889547,4385,3455640,3969425
1981-06-06,1981,249,N,4,3+,10784,5144766,6889547,3394,3459034,3969425
1981-06-07,1981,250,N,4,3+,11089,5155855,6889547,4356,3463390,3969425
1981-06-08,1981,251,N,4,3+,12719,5168574,6889547,9297,3472687,3969425
1981-06-09,1981,252,N,4,3+,14040,5182614,6889547,6834,3479521,3969425
1981-06-10,1981,253,N,4,3+,13757,5196371,6889547,6442,3485963,3969425
1981-06-11,1981,254,N,4,3+,12391,5208762,6889547,4854,3490817,3969425
1981-06-12,1981,255,N,4,3+,12402,5221164,6889547,5105,3495922,3969425
1981-06-13,1981,256,N,4,3+,12353,5233517,6889547,4765,3500687,3969425
1981-06-14,1981,257,N,4,3+,12329,5245846,6889547,4827,3505514,3969425
1981-06-15,1981,258,N,4,3+,12274,5258120,6889547,4748,3510262,3969425
1981-06-16,1981,259,N,4,3+,11458,5269578,6889547,3856,3514118,3969425
1981-06-17,1981,260,N,4,3+,11374,5280952,6889547,3237,3517355,3969425
1981-06-18,1981,261,N,4,3+,10813,5291765,6889547,2315,3519670,3969425
1981-06-19,1981,262,N,4,3+,10404,5302169,6889547,1789,3521459,3969425
1981-06-20,1981,263,N,4,3+,10502,5312671,6889547,2185,3523644,3969425
1981-06-21,1981,264,N,4,3+,11093,5323764,6889547,2726,3526370,3969425
1981-06-22,1981,265,N,4,3+,11873,5335637,6889547,3482,3529852,3969425
1981-06-23,1981,266,N,4,3+,13016,5348653,6889547,4573,3534425,3969425
1981-06-24,1981,267,N,4,3+,13311,5361964,6889547,4508,3538933,3969425
1981-06-25,1981,268,N,4,3+,13448,5375412,6889547,3979,3542912,3969425
1981-06-26,1981,269,N,4,3+,13684,5389096,6889547,4322,3547234,3969425
1981-06-27,1981,270,N,4,3+,13521,5402617,6889547,4125,3551359,3969425
1981-06-28,1981,271,N,4,3+,13437,5416054,6889547,4478,3555837,3969425
1981-06-29,1981,272,N,4,3+,14198,5430252,6889547,5361,3561198,3969425
1981-06-30,1981,273,N,4,3+,14001,5444253,6889547,5279,3566477,3969425
1981-07-01,1981,274,N,4,3+,14643,5458896,6889547,5467,3571944,3969425
1981-07-02,1981,275,N,4,3+,15246,5474142,6889547,5551,3577495,3969425
1981-07-03,1981,276,N,4,3+,15637,5489779,6889547,5908,3583403,3969425
1981-07-04,1981,277,N,4,3+,15219,5504998,6889547,5483,3588886,3969425
1981-07-05,1981,278,N,4,3+,15797,5520795,6889547,6049,3594935,3969425
1981-07-06,1981,279,N,4,3+,15562,5536357,6889547,5331,3600266,3969425
1981-07-07,1981,280,N,4,3+,15713,5552070,6889547,5230,3605496,3969425
1981-07-08,1981,281,N,4,3+,14745,5566815,6889547,4966,3610462,3969425
1981-07-09,1981,282,N,4,3+,14169,5580984,6889547,4454,3614916,3969425
1981-07-10,1981,283,N,4,3+,13916,5594900,6889547,4224,3619140,3969425
1981-07-11,1981,284,N,4,3+,13511,5608411,6889547,3954,3623094,3969425
1981-07-12,1981,285,N,4,3+,13828,5622239,6889547,4084,3627178,3969425
1981-07-13,1981,286,N,4,3+,14317,5636556,6889547,4354,3631532,3969425
1981-07-14,1981,287,N,4,3+,14435,5650991,6889547,3947,3635479,3969425
1981-07-15,1981,288,N,4,3+,15209,5666200,6889547,4657,3640136,3969425
1981-07-16,1981,289,N,4,3+,16358,5682558,6889547,5799,3645935,3969425
1981-07-17,1981,290,N,4,3+,17916,5700474,6889547,5954,3651889,3969425
1981-07-18,1981,291,N,4,3+,19278,5719752,6889547,6097,3657986,3969425
1981-07-19,1981,292,N,4,3+,19456,5739208,6889547,5294,3663280,3969425
1981-07-20,1981,293,N,4,3+,19675,5758883,6889547,5409,3668689,3969425
1981-07-21,1981,294,N,4,3+,19306,5778189,6889547,5373,3674062,3969425
1981-07-22,1981,295,N,4,3+,18888,5797077,6889547,4943,3679005,3969425
1981-07-23,1981,296,N,4,3+,18895,5815972,6889547,5356,3684361,3969425
1981-07-24,1981,297,N,4,3+,18783,5834755,6889547,5356,3689717,3969425
1981-07-25,1981,298,N,4,3+,18949,5853704,6889547,5798,3695515,3969425
1981-07-26,1981,299,N,4,3+,18583,5872287,6889547,5295,3700810,3969425
1981-07-27,1981,300,N,4,3+,18496,5890783,6889547,5785,3706595,3969425
1981-07-28,1981,301,N,4,3+,18121,5908904,6889547,6305,3712900,3969425
1981-07-29,1981,302,N,4,3+,17764,5926668,6889547,5934,3718834,3969425
1981-07-30,1981,303,N,4,3+,17690,5944358,6889547,6031,3724865,3969425
1981-07-31,1981,304,N,4,3+,17747,5962105,6889547,6090,3730955,3969425
1981-08-01,1981,305,N,4,3+,17914,5980019,6889547,5289,3736244,3969425
1981-08-02,1981,306,N,4,3+,18214,5998233,6889547,4936,3741180,3969425
1981-08-03,1981,307,N,4,3+,18621,6016854,6889547,4716,3745896,3969425
1981-08-04,1981,308,N,4,3+,18451,6035305,6889547,4660,3750556,3969425
1981-08-05,1981,309,N,4,3+,18123,6053428,6889547,3984,3754540,3969425
1981-08-06,1981,310,N,4,3+,17366,6070794,6889547,3516,3758056,3969425
1981-08-07,1981,311,N,4,3+,16737,6087531,6889547,3770,3761826,3969425
1981-08-08,1981,312,N,4,3+,16883,6104414,6889547,4074,3765900,3969425
1981-08-09,1981,313,N,4,3+,16843,6121257,6889547,4173,3770073,3969425
1981-08-10,1981,314,N,4,3+,16812,6138069,6889547,3900,3773973,3969425
1981-08-11,1981,315,N,4,3+,16740,6154809,6889547,4086,3778059,3969425
1981-08-12,1981,316,N,4,3+,16167,6170976,6889547,3377,3781436,3969425
1981-08-13,1981,317,N,4,3+,15638,6186614,6889547,2999,3784435,3969425
1981-08-14,1981,318,N,4,3+,15621,6202235,6889547,2574,3787009,3969425
1981-08-15,1981,319,N,4,3+,15501,6217736,6889547,2094,3789103,3969425
1981-08-16,1981,320,N,4,3+,15273,6233009,6889547,2240,3791343,3969425
1981-08-17,1981,321,N,4,3+,15422,6248431,6889547,2112,3793455,3969425
1981-08-18,1981,322,N,4,3+,14867,6263298,6889547,997,3794452,3969425
1981-08-19,1981,323,N,4,3+,15454,6278752,6889547,1751,3796203,3969425
1981-08-20,1981,324,N,4,3+,15450,6294202,6889547,2352,3798555,3969425
1981-08-21,1981,325,N,4,3+,15672,6309874,6889547,2965,3801520,3969425
1981-08-22,1981,326,N,4,3+,15516,6325390,6889547,2344,3803864,3969425
1981-08-23,1981,327,N,4,3+,15158,6340548,6889547,1628,3805492,3969425
1981-08-24,1981,328,N,4,3+,16232,6356780,6889547,2797,3808289,3969425
1981-08-25,1981,329,N,4,3+,16231,6373011,6889547,3076,3811365,3969425
1981-08-26,1981,330,N,4,3+,16432,6389443,6889547,3563,3814928,3969425
1981-08-27,1981,331,N,4,3+,15794,6405237,6889547,2553,3817481,3969425
1981-08-28,1981,332,N,4,3+,15349,6420586,6889547,2025,3819506,3969425
1981-08-29,1981,333,N,4,3+,15479,6436065,6889547,2710,3822216,3969425
1981-08-30,1981,334,N,4,3+,15159,6451224,6889547,3511,3825727,3969425
1981-08-31,1981,335,N,4,3+,14579,6465803,6889547,2822,3828549,3969425
1981-09-01,1981,336,N,4,3+,14277,6480080,6889547,3992,3832541,3969425
1981-09-02,1981,337,N,4,3+,14276,6494356,6889547,4405,3836946,3969425
1981-09-03,1981,338,N,4,3+,14441,6508797,6889547,5410,3842356,3969425
1981-09-04,1981,339,N,4,3+,14568,6523365,6889547,4653,3847009,3969425
1981-09-05,1981,340,N,4,3+,14867,6538232,6889547,4816,3851825,3969425
1981-09-06,1981,341,N,4,3+,14593,6552825,6889547,4520,3856345,3969425
1981-09-07,1981,342,N,4,3+,15538,6568363,6889547,5919,3862264,3969425
1981-09-08,1981,343,N,4,3+,15217,6583580,6889547,6052,3868316,3969425
1981-09-09,1981,344,N,4,3+,14950,6598530,6889547,5972,3874288,3969425
1981-09-10,1981,345,N,4,3+,15300,6613830,6889547,5776,3880064,3969425
1981-09-11,1981,346,N,4,3+,15231,6629061,6889547,4929,3884993,3969425
1981-09-12,1981,347,N,4,3+,15136,6644197,6889547,4744,3889737,3969425
1981-09-13,1981,348,N,4,3+,15170,6659367,6889547,5065,3894802,3969425
1981-09-14,1981,349,N,4,3+,15012,6674379,6889547,4592,3899394,3969425
1981-09-15,1981,350,N,4,3+,14537,6688916,6889547,3833,3903227,3969425
1981-09-16,1981,351,N,4,3+,14458,6703374,6889547,5195,3908422,3969425
1981-09-17,1981,352,N,4,3+,14497,6717871,6889547,5761,3914183,3969425
1981-09-18,1981,353,N,4,3+,13725,6731596,6889547,5147,3919330,3969425
1981-09-19,1981,354,N,4,3+,13828,6745424,6889547,5026,3924356,3969425
1981-09-20,1981,355,N,4,3+,13619,6759043,6889547,3889,3928245,3969425
1981-09-21,1981,356,N,4,3+,13709,6772752,6889547,4525,3932770,3969425
1981-09-22,1981,357,N,4,3+,13181,6785933,6889547,4260,3937030,3969425
1981-09-23,1981,358,N,4,3+,12524,6798457,6889547,3863,3940893,3969425
1981-09-24,1981,359,N,4,3+,12276,6810733,6889547,3773,3944666,3969425
1981-09-25,1981,360,N,4,3+,12528,6823261,6889547,4278,3948944,3969425
1981-09-26,1981,361,N,4,3+,12910,6836171,6889547,4359,3953303,3969425
1981-09-27,1981,362,N,4,3+,13532,6849703,6889547,3523,3956826,3969425
1981-09-28,1981,363,N,4,3+,13688,6863391,6889547,3791,3960617,3969425
1981-09-29,1981,364,N,4,3+,13322,6876713,6889547,5165,3965782,3969425
1981-09-30,1981,365,N,4,3+,12834,6889547,6889547,3643,3969425,3969425
1981-10-01,1982,1,W,1,1,12550,12550,23021741,2815,2815,20625044
1981-10-02,1982,2,W,1,1,11750,24300,23021741,2726,5541,20625044
1981-10-03,1982,3,W,1,1,11591,35891,23021741,5196,10737,20625044
1981-10-04,1982,4,W,1,1,11706,47597,23021741,5204,15941,20625044
1981-10-05,1982,5,W,1,1,12034,59631,23021741,5470,21411,20625044
1981-10-06,1982,6,W,1,1,11551,71182,23021741,5198,26609,20625044
1981-10-07,1982,7,W,1,1,12194,83376,23021741,6629,33238,20625044
1981-10-08,1982,8,W,1,1,12616,95992,23021741,4749,37987,20625044
1981-10-09,1982,9,W,1,1,13032,109024,23021741,5059,43046,20625044
1981-10-10,1982,10,W,1,1,12563,121587,23021741,5336,48382,20625044
1981-10-11,1982,11,W,1,1,12461,134048,23021741,5191,53573,20625044
1981-10-12,1982,12,W,1,1,12536,146584,23021741,4814,58387,20625044
1981-10-13,1982,13,W,1,1,12347,158931,23021741,5377,63764,20625044
1981-10-14,1982,14,W,1,1,12393,171324,23021741,6272,70036,20625044
1981-10-15,1982,15,W,1,1,11434,182758,23021741,4016,74052,20625044
1981-10-16,1982,16,W,1,1,11158,193916,23021741,3634,77686,20625044
1981-10-17,1982,17,W,1,1,10921,204837,23021741,4171,81857,20625044
1981-10-18,1982,18,W,1,1,10442,215279,23021741,2409,84266,20625044
1981-10-19,1982,19,W,1,1,10431,225710,23021741,2536,86802,20625044
1981-10-20,1982,20,W,1,1,10371,236081,23021741,2769,89571,20625044
1981-10-21,1982,21,W,1,1,10292,246373,23021741,3084,92655,20625044
1981-10-22,1982,22,W,1,1,9950,256323,23021741,2711,95366,20625044
1981-10-23,1982,23,W,1,1,9577,265900,23021741,2596,97962,20625044
1981-10-24,1982,24,W,1,1,9260,275160,23021741,2071,100033,20625044
1981-10-25,1982,25,W,1,1,9431,284591,23021741,2209,102242,20625044
1981-10-26,1982,26,W,1,1,9609,294200,23021741,3231,105473,20625044
1981-10-27,1982,27,W,1,1,9790,303990,23021741,3442,108915,20625044
1981-10-28,1982,28,W,1,1,11095,315085,23021741,10627,119542,20625044
1981-10-29,1982,29,W,1,1,11743,326828,23021741,11972,131514,20625044
1981-10-30,1982,30,W,1,1,13584,340412,23021741,14754,146268,20625044
1981-10-31,1982,31,W,1,1,14262,354674,23021741,15359,161627,20625044
1981-11-01,1982,32,W,1,1,12828,367502,23021741,13156,174783,20625044
1981-11-02,1982,33,W,1,1,11776,379278,23021741,5933,180716,20625044
1981-11-03,1982,34,W,1,1,10990,390268,23021741,4751,185467,20625044
1981-11-04,1982,35,W,1,1,10870,401138,23021741,3509,188976,20625044
1981-11-05,1982,36,W,1,1,11221,412359,23021741,4080,193056,20625044
1981-11-06,1982,37,W,1,1,11177,423536,23021741,6252,199308,20625044
1981-11-07,1982,38,W,1,1,11090,434626,23021741,6127,205435,20625044
1981-11-08,1982,39,W,1,1,10749,445375,23021741,5198,210633,20625044
1981-11-09,1982,40,W,1,1,10344,455719,23021741,4643,215276,20625044
1981-11-10,1982,41,W,1,1,10105,465824,23021741,4929,220205,20625044
1981-11-11,1982,42,W,1,1,10242,476066,23021741,4511,224716,20625044
1981-11-12,1982,43,W,1,1,11372,487438,23021741,8508,233224,20625044
1981-11-13,1982,44,W,1,1,14302,501740,23021741,13352,246576,20625044
1981-11-14,1982,45,W,1,1,23093,524833,23021741,23659,270235,20625044
1981-11-15,1982,46,W,1,1,28221,553054,23021741,28391,298626,20625044
1981-11-16,1982,47,W,1,1,30410,583464,23021741,34012,332638,20625044
1981-11-17,1982,48,W,1,1,34821,618285,23021741,34566,367204,20625044
1981-11-18,1982,49,W,1,1,45449,663734,23021741,43011,410215,20625044
1981-11-19,1982,50,W,1,1,47449,711183,23021741,44048,454263,20625044
1981-11-20,1982,51,W,1,1,47865,759048,23021741,43697,497960,20625044
1981-11-21,1982,52,W,1,1,45294,804342,23021741,36751,534711,20625044
1981-11-22,1982,53,W,1,1,49644,853986,23021741,40310,575021,20625044
1981-11-23,1982,54,W,1,1,57766,911752,23021741,52214,627235,20625044
1981-11-24,1982,55,W,1,1,62230,973982,23021741,59569,686804,20625044
1981-11-25,1982,56,W,1,1,76432,1050414,23021741,74509,761313,20625044
1981-11-26,1982,57,W,1,1,91429,1141843,23021741,90432,851745,20625044
1981-11-27,1982,58,W,1,1,108966,1250809,23021741,109046,960791,20625044
1981-11-28,1982,59,W,1,1,103461,1354270,23021741,101292,1062083,20625044
1981-11-29,1982,60,W,1,1,95902,1450172,23021741,94606,1156689,20625044
1981-11-30,1982,61,W,1,1,85474,1535646,23021741,84956,1241645,20625044
1981-12-01,1982,62,W,1,1,74420,1610066,23021741,71192,1312837,20625044
1981-12-02,1982,63,W,1,1,67540,1677606,23021741,62742,1375579,20625044
1981-12-03,1982,64,W,1,1,62864,1740470,23021741,57521,1433100,20625044
1981-12-04,1982,65,W,1,1,59152,1799622,23021741,54817,1487917,20625044
1981-12-05,1982,66,W,1,1,54945,1854567,23021741,49557,1537474,20625044
1981-12-06,1982,67,W,1,1,52784,1907351,23021741,47218,1584692,20625044
1981-12-07,1982,68,W,1,1,51524,1958875,23021741,46280,1630972,20625044
1981-12-08,1982,69,W,1,1,48833,2007708,23021741,44754,1675726,20625044
1981-12-09,1982,70,W,1,1,45886,2053594,23021741,40578,1716304,20625044
1981-12-10,1982,71,W,1,1,45279,2098873,23021741,37465,1753769,20625044
1981-12-11,1982,72,W,1,1,45200,2144073,23021741,37307,1791076,20625044
1981-12-12,1982,73,W,1,1,45138,2189211,23021741,36997,1828073,20625044
1981-12-13,1982,74,W,1,1,43185,2232396,23021741,35525,1863598,20625044
1981-12-14,1982,75,W,1,1,41589,2273985,23021741,34570,1898168,20625044
1981-12-15,1982,76,W,1,1,42332,2316317,23021741,34745,1932913,20625044
1981-12-16,1982,77,W,1,1,45496,2361813,23021741,38303,1971216,20625044
1981-12-17,1982,78,W,1,1,47820,2409633,23021741,40673,2011889,20625044
1981-12-18,1982,79,W,1,1,48357,2457990,23021741,40650,2052539,20625044
1981-12-19,1982,80,W,1,1,52738,2510728,23021741,48539,2101078,20625044
1981-12-20,1982,81,W,1,1,91674,2602402,23021741,89931,2191009,20625044
1981-12-21,1982,82,W,1,1,208170,2810572,23021741,206590,2397599,20625044
1981-12-22,1982,83,W,1,1,217650,3028222,23021741,217288,2614887,20625044
1981-12-23,1982,84,W,1,1,205605,3233827,23021741,205021,2819908,20625044
1981-12-24,1982,85,W,1,1,191965,3425792,23021741,187864,3007772,20625044
1981-12-25,1982,86,W,1,1,168678,3594470,23021741,161142,3168914,20625044
1981-12-26,1982,87,W,1,1,143455,3737925,23021741,134201,3303115,20625044
1981-12-27,1982,88,W,1,1,127264,3865189,23021741,119067,3422182,20625044
1981-12-28,1982,89,W,1,1,120486,3985675,23021741,113097,3535279,20625044
1981-12-29,1982,90,W,1,1,114497,4100172,23021741,108126,3643405,20625044
1981-12-30,1982,91,W,1,1,133620,4233792,23021741,132961,3776366,20625044
1981-12-31,1982,92,W,1,1,140270,4374062,23021741,140188,3916554,20625044
1982-01-01,1982,93,W,1,1,149137,4523199,23021741,150205,4066759,20625044
1982-01-02,1982,94,W,1,1,159887,4683086,23021741,163113,4229872,20625044
1982-01-03,1982,95,W,1,1,153691,4836777,23021741,157563,4387435,20625044
1982-01-04,1982,96,W,1,1,150767,4987544,23021741,157807,4545242,20625044
1982-01-05,1982,97,W,1,1,205409,5192953,23021741,222673,4767915,20625044
1982-01-06,1982,98,W,1,1,195764,5388717,23021741,214279,4982194,20625044
1982-01-07,1982,99,W,1,1,168106,5556823,23021741,184693,5166887,20625044
1982-01-08,1982,100,W,1,1,148357,5705180,23021741,164528,5331415,20625044
1982-01-09,1982,101,W,1,1,126943,5832123,23021741,136134,5467549,20625044
1982-01-10,1982,102,W,1,1,114186,5946309,23021741,107469,5575018,20625044
1982-01-11,1982,103,W,1,1,103649,6049958,23021741,98031,5673049,20625044
1982-01-12,1982,104,W,1,1,94570,6144528,23021741,88983,5762032,20625044
1982-01-13,1982,105,W,1,1,86543,6231071,23021741,81406,5843438,20625044
1982-01-14,1982,106,W,1,1,81690,6312761,23021741,75403,5918841,20625044
1982-01-15,1982,107,W,1,1,78313,6391074,23021741,72635,5991476,20625044
1982-01-16,1982,108,W,1,1,72016,6463090,23021741,65956,6057432,20625044
1982-01-17,1982,109,W,1,1,65264,6528354,23021741,59408,6116840,20625044
1982-01-18,1982,110,W,1,1,60069,6588423,23021741,54299,6171139,20625044
1982-01-19,1982,111,W,1,1,56141,6644564,23021741,50924,6222063,20625044
1982-01-20,1982,112,W,1,1,55714,6700278,23021741,49913,6271976,20625044
1982-01-21,1982,113,W,1,1,65227,6765505,23021741,62587,6334563,20625044
1982-01-22,1982,114,W,1,1,63117,6828622,23021741,61629,6396192,20625044
1982-01-23,1982,115,W,1,1,65372,6893994,23021741,61970,6458162,20625044
1982-01-24,1982,116,W,1,1,64775,6958769,23021741,61049,6519211,20625044
1982-01-25,1982,117,W,1,1,62884,7021653,23021741,60186,6579397,20625044
1982-01-26,1982,118,W,1,1,60144,7081797,23021741,54165,6633562,20625044
1982-01-27,1982,119,W,1,1,62325,7144122,23021741,57646,6691208,20625044
1982-01-28,1982,120,W,1,1,66506,7210628,23021741,62652,6753860,20625044
1982-01-29,1982,121,W,1,1,68119,7278747,23021741,63947,6817807,20625044
1982-01-30,1982,122,W,1,1,69178,7347925,23021741,65679,6883486,20625044
1982-01-31,1982,123,W,1,1,67598,7415523,23021741,60963,6944449,20625044
1982-02-01,1982,124,W,1,1,65534,7481057,23021741,60466,7004915,20625044
1982-02-02,1982,125,W,1,1,61847,7542904,23021741,55178,7060093,20625044
1982-02-03,1982,126,W,1,1,58517,7601421,23021741,49653,7109746,20625044
1982-02-04,1982,127,W,1,1,55924,7657345,23021741,46673,7156419,20625044
1982-02-05,1982,128,W,1,1,52596,7709941,23021741,43108,7199527,20625044
1982-02-06,1982,129,W,1,1,50038,7759979,23021741,40276,7239803,20625044
1982-02-07,1982,130,W,1,1,46607,7806586,23021741,35344,7275147,20625044
1982-02-08,1982,131,W,1,1,44588,7851174,23021741,33512,7308659,20625044
1982-02-09,1982,132,W,1,1,42234,7893408,23021741,31516,7340175,20625044
1982-02-10,1982,133,W,1,1,41182,7934590,23021741,30330,7370505,20625044
1982-02-11,1982,134,W,1,1,40119,7974709,23021741,29457,7399962,20625044
1982-02-12,1982,135,W,1,1,38942,8013651,23021741,28652,7428614,20625044
1982-02-13,1982,136,W,1,1,37432,8051083,23021741,26733,7455347,20625044
1982-02-14,1982,137,W,1,1,37808,8088891,23021741,28461,7483808,20625044
1982-02-15,1982,138,W,1,1,58470,8147361,23021741,55998,7539806,20625044
1982-02-16,1982,139,W,1,1,152934,8300295,23021741,158280,7698086,20625044
1982-02-17,1982,140,W,1,1,238395,8538690,23021741,242388,7940474,20625044
1982-02-18,1982,141,W,1,1,226572,8765262,23021741,229554,8170028,20625044
1982-02-19,1982,142,W,1,1,199834,8965096,23021741,201308,8371336,20625044
1982-02-20,1982,143,W,1,1,173527,9138623,23021741,169082,8540418,20625044
1982-02-21,1982,144,W,1,1,158411,9297034,23021741,146948,8687366,20625044
1982-02-22,1982,145,W,1,1,149865,9446899,23021741,138429,8825795,20625044
1982-02-23,1982,146,W,1,1,145956,9592855,23021741,134587,8960382,20625044
1982-02-24,1982,147,W,1,1,142672,9735527,23021741,131126,9091508,20625044
1982-02-25,1982,148,W,1,1,138712,9874239,23021741,127470,9218978,20625044
1982-02-26,1982,149,W,1,1,128556,10002795,23021741,117257,9336235,20625044
1982-02-27,1982,150,W,1,1,115842,10118637,23021741,104684,9440919,20625044
1982-02-28,1982,151,W,1,1,106263,10224900,23021741,95075,9535994,20625044
1982-03-01,1982,152,W,1,1,97315,10322215,23021741,88300,9624294,20625044
1982-03-02,1982,153,W,1,1,103118,10425333,23021741,96181,9720475,20625044
1982-03-03,1982,154,W,1,1,108191,10533524,23021741,102840,9823315,20625044
1982-03-04,1982,155,W,1,1,105417,10638941,23021741,99703,9923018,20625044
1982-03-05,1982,156,W,1,1,86663,10725604,23021741,80758,10003776,20625044
1982-03-06,1982,157,W,1,1,92447,10818051,23021741,84559,10088335,20625044
1982-03-07,1982,158,W,1,1,89051,10907102,23021741,77924,10166259,20625044
1982-03-08,1982,159,W,1,1,86900,10994002,23021741,75448,10241707,20625044
1982-03-09,1982,160,W,1,1,84781,11078783,23021741,73437,10315144,20625044
1982-03-10,1982,161,W,1,1,82488,11161271,23021741,71825,10386969,20625044
1982-03-11,1982,162,W,1,1,84379,11245650,23021741,76703,10463672,20625044
1982-03-12,1982,163,W,1,1,87064,11332714,23021741,80963,10544635,20625044
1982-03-13,1982,164,W,1,1,86659,11419373,23021741,80309,10624944,20625044
1982-03-14,1982,165,W,1,1,86271,11505644,23021741,80629,10705573,20625044
1982-03-15,1982,166,W,1,1,87345,11592989,23021741,83125,10788698,20625044
1982-03-16,1982,167,W,1,1,86321,11679310,23021741,80792,10869490,20625044
1982-03-17,1982,168,W,1,1,93625,11772935,23021741,88442,10957932,20625044
1982-03-18,1982,169,W,1,1,101500,11874435,23021741,97650,11055582,20625044
1982-03-19,1982,170,W,1,1,100912,11975347,23021741,99082,11154664,20625044
1982-03-20,1982,171,W,1,1,96192,12071539,23021741,92354,11247018,20625044
1982-03-21,1982,172,W,1,1,92758,12164297,23021741,87528,11334546,20625044
1982-03-22,1982,173,W,1,1,90334,12254631,23021741,82984,11417530,20625044
1982-03-23,1982,174,W,1,1,84741,12339372,23021741,75338,11492868,20625044
1982-03-24,1982,175,W,1,1,79626,12418998,23021741,67595,11560463,20625044
1982-03-25,1982,176,W,1,1,74624,12493622,23021741,62616,11623079,20625044
1982-03-26,1982,177,W,1,1,70173,12563795,23021741,60602,11683681,20625044
1982-03-27,1982,178,W,1,1,64264,12628059,23021741,59338,11743019,20625044
1982-03-28,1982,179,W,1,1,60851,12688910,23021741,57114,11800133,20625044
1982-03-29,1982,180,W,1,1,60620,12749530,23021741,60593,11860726,20625044
1982-03-30,1982,181,W,1,1,63694,12813224,23021741,66673,11927399,20625044
1982-03-31,1982,182,W,1,1,88513,12901737,23021741,91335,12018734,20625044
1982-04-01,1982,183,W,1,1,140987,13042724,23021741,148184,12166918,20625044
1982-04-02,1982,184,W,1,1,146306,13189030,23021741,152162,12319080,20625044
1982-04-03,1982,185,W,1,1,163742,13352772,23021741,167690,12486770,20625044
1982-04-04,1982,186,W,1,1,179884,13532656,23021741,181682,12668452,20625044
1982-04-05,1982,187,W,1,1,170432,13703088,23021741,168531,12836983,20625044
1982-04-06,1982,188,W,1,1,156767,13859855,23021741,147106,12984089,20625044
1982-04-07,1982,189,W,1,1,140398,14000253,23021741,130829,13114918,20625044
1982-04-08,1982,190,W,1,1,128961,14129214,23021741,118633,13233551,20625044
1982-04-09,1982,191,W,1,1,119241,14248455,23021741,107684,13341235,20625044
1982-04-10,1982,192,W,1,1,112609,14361064,23021741,103304,13444539,20625044
1982-04-11,1982,193,W,1,1,137291,14498355,23021741,132594,13577133,20625044
1982-04-12,1982,194,W,1,1,213142,14711497,23021741,211645,13788778,20625044
1982-04-13,1982,195,W,1,1,232661,14944158,23021741,230827,14019605,20625044
1982-04-14,1982,196,W,1,1,226680,15170838,23021741,225734,14245339,20625044
1982-04-15,1982,197,W,1,1,204000,15374838,23021741,200754,14446093,20625044
1982-04-16,1982,198,W,1,1,197768,15572606,23021741,188966,14635059,20625044
1982-04-17,1982,199,W,1,1,188913,15761519,23021741,178020,14813079,20625044
1982-04-18,1982,200,W,1,1,185492,15947011,23021741,174638,14987717,20625044
1982-04-19,1982,201,W,1,1,174383,16121394,23021741,162516,15150233,20625044
1982-04-20,1982,202,W,1,1,160099,16281493,23021741,148305,15298538,20625044
1982-04-21,1982,203,W,1,1,146364,16427857,23021741,134767,15433305,20625044
1982-04-22,1982,204,W,1,1,133921,16561778,23021741,124790,15558095,20625044
1982-04-23,1982,205,W,1,1,118852,16680630,23021741,109753,15667848,20625044
1982-04-24,1982,206,W,1,1,108539,16789169,23021741,96519,15764367,20625044
1982-04-25,1982,207,W,1,1,104157,16893326,23021741,91910,15856277,20625044
1982-04-26,1982,208,W,1,1,101693,16995019,23021741,89384,15945661,20625044
1982-04-27,1982,209,W,1,1,98889,17093908,23021741,86847,16032508,20625044
1982-04-28,1982,210,W,1,1,96515,17190423,23021741,84216,16116724,20625044
1982-04-29,1982,211,W,1,1,96172,17286595,23021741,84099,16200823,20625044
1982-04-30,1982,212,W,1,1,95820,17382415,23021741,83682,16284505,20625044
1982-05-01,1982,213,W,1,1,93434,17475849,23021741,83170,16367675,20625044
1982-05-02,1982,214,W,1,1,90138,17565987,23021741,82879,16450554,20625044
1982-05-03,1982,215,W,1,1,89169,17655156,23021741,81300,16531854,20625044
1982-05-04,1982,216,W,1,1,88222,17743378,23021741,79871,16611725,20625044
1982-05-05,1982,217,W,1,1,85631,17829009,23021741,78105,16689830,20625044
1982-05-06,1982,218,W,1,1,82277,17911286,23021741,74837,16764667,20625044
1982-05-07,1982,219,W,1,1,81779,17993065,23021741,73947,16838614,20625044
1982-05-08,1982,220,W,1,1,79942,18073007,23021741,71963,16910577,20625044
1982-05-09,1982,221,W,1,1,77409,18150416,23021741,68500,16979077,20625044
1982-05-10,1982,222,W,1,1,75315,18225731,23021741,67654,17046731,20625044
1982-05-11,1982,223,W,1,1,72903,18298634,23021741,64740,17111471,20625044
1982-05-12,1982,224,W,1,1,71097,18369731,23021741,62379,17173850,20625044
1982-05-13,1982,225,W,1,1,68746,18438477,23021741,60536,17234386,20625044
1982-05-14,1982,226,W,1,1,65023,18503500,23021741,56483,17290869,20625044
1982-05-15,1982,227,W,1,1,62165,18565665,23021741,54493,17345362,20625044
1982-05-16,1982,228,W,1,1,59341,18625006,23021741,52492,17397854,20625044
1982-05-17,1982,229,W,1,1,57387,18682393,23021741,50442,17448296,20625044
1982-05-18,1982,230,W,1,1,56573,18738966,23021741,48878,17497174,20625044
1982-05-19,1982,231,W,1,1,56391,18795357,23021741,48482,17545656,20625044
1982-05-20,1982,232,W,1,1,56901,18852258,23021741,48982,17594638,20625044
1982-05-21,1982,233,W,1,1,55311,18907569,23021741,47177,17641815,20625044
1982-05-22,1982,234,W,1,1,53328,18960897,23021741,45033,17686848,20625044
1982-05-23,1982,235,W,1,1,51551,19012448,23021741,41427,17728275,20625044
1982-05-24,1982,236,W,1,1,51400,19063848,23021741,42166,17770441,20625044
1982-05-25,1982,237,W,1,1,50852,19114700,23021741,41446,17811887,20625044
1982-05-26,1982,238,W,1,1,52318,19167018,23021741,42427,17854314,20625044
1982-05-27,1982,239,W,1,1,55287,19222305,23021741,45598,17899912,20625044
1982-05-28,1982,240,W,1,1,56372,19278677,23021741,47478,17947390,20625044
1982-05-29,1982,241,W,1,1,55424,19334101,23021741,45530,17992920,20625044
1982-05-30,1982,242,W,1,1,52946,19387047,23021741,42510,18035430,20625044
1982-05-31,1982,243,W,1,1,50784,19437831,23021741,40316,18075746,20625044
1982-06-01,1982,244,W,1,1,49909,19487740,23021741,40828,18116574,20625044
1982-06-02,1982,245,W,1,1,49215,19536955,23021741,41108,18157682,20625044
1982-06-03,1982,246,W,1,1,47887,19584842,23021741,39316,18196998,20625044
1982-06-04,1982,247,W,1,1,45258,19630100,23021741,35098,18232096,20625044
1982-06-05,1982,248,W,1,1,43627,19673727,23021741,33337,18265433,20625044
1982-06-06,1982,249,W,1,1,41019,19714746,23021741,30834,18296267,20625044
1982-06-07,1982,250,W,1,1,39664,19754410,23021741,31004,18327271,20625044
1982-06-08,1982,251,W,1,1,40065,19794475,23021741,32797,18360068,20625044
1982-06-09,1982,252,W,1,1,39817,19834292,23021741,33044,18393112,20625044
1982-06-10,1982,253,W,1,1,37057,19871349,23021741,30218,18423330,20625044
1982-06-11,1982,254,W,1,1,36770,19908119,23021741,29895,18453225,20625044
1982-06-12,1982,255,W,1,1,36019,19944138,23021741,29101,18482326,20625044
1982-06-13,1982,256,W,1,1,35807,19979945,23021741,28374,18510700,20625044
1982-06-14,1982,257,W,1,1,35039,20014984,23021741,28018,18538718,20625044
1982-06-15,1982,258,W,1,1,34376,20049360,23021741,27304,18566022,20625044
1982-06-16,1982,259,W,1,1,33919,20083279,23021741,26783,18592805,20625044
1982-06-17,1982,260,W,1,1,32942,20116221,23021741,25748,18618553,20625044
1982-06-18,1982,261,W,1,1,32679,20148900,23021741,25395,18643948,20625044
1982-06-19,1982,262,W,1,1,32252,20181152,23021741,25033,18668981,20625044
1982-06-20,1982,263,W,1,1,31638,20212790,23021741,24318,18693299,20625044
1982-06-21,1982,264,W,1,1,31602,20244392,23021741,24697,18717996,20625044
1982-06-22,1982,265,W,1,1,30672,20275064,23021741,23884,18741880,20625044
1982-06-23,1982,266,W,1,1,30868,20305932,23021741,23200,18765080,20625044
1982-06-24,1982,267,W,1,1,30676,20336608,23021741,23985,18789065,20625044
1982-06-25,1982,268,W,1,1,29817,20366425,23021741,21109,18810174,20625044
1982-06-26,1982,269,W,1,1,28322,20394747,23021741,19590,18829764,20625044
1982-06-27,1982,270,W,1,1,28356,20423103,23021741,20308,18850072,20625044
1982-06-28,1982,271,W,1,1,28829,20451932,23021741,20684,18870756,20625044
1982-06-29,1982,272,W,1,1,29426,20481358,23021741,24087,18894843,20625044
1982-06-30,1982,273,W,1,1,29797,20511155,23021741,24593,18919436,20625044
1982-07-01,1982,274,W,1,1,31886,20543041,23021741,28904,18948340,20625044
1982-07-02,1982,275,W,1,1,32693,20575734,23021741,28982,18977322,20625044
1982-07-03,1982,276,W,1,1,32801,20608535,23021741,29776,19007098,20625044
1982-07-04,1982,277,W,1,1,33206,20641741,23021741,26748,19033846,20625044
1982-07-05,1982,278,W,1,1,33443,20675184,23021741,28073,19061919,20625044
1982-07-06,1982,279,W,1,1,31716,20706900,23021741,25408,19087327,20625044
1982-07-07,1982,280,W,1,1,29140,20736040,23021741,23781,19111108,20625044
1982-07-08,1982,281,W,1,1,27295,20763335,23021741,21249,19132357,20625044
1982-07-09,1982,282,W,1,1,25381,20788716,23021741,20028,19152385,20625044
1982-07-10,1982,283,W,1,1,24153,20812869,23021741,18400,19170785,20625044
1982-07-11,1982,284,W,1,1,23105,20835974,23021741,16996,19187781,20625044
1982-07-12,1982,285,W,1,1,22554,20858528,23021741,16461,19204242,20625044
1982-07-13,1982,286,W,1,1,21916,20880444,23021741,14662,19218904,20625044
1982-07-14,1982,287,W,1,1,21668,20902112,23021741,12809,19231713,20625044
1982-07-15,1982,288,W,1,1,21465,20923577,23021741,11369,19243082,20625044
1982-07-16,1982,289,W,1,1,21218,20944795,23021741,11136,19254218,20625044
1982-07-17,1982,290,W,1,1,21033,20965828,23021741,10561,19264779,20625044
1982-07-18,1982,291,W,1,1,20545,20986373,23021741,11233,19276012,20625044
1982-07-19,1982,292,W,1,1,21363,21007736,23021741,10983,19286995,20625044
1982-07-20,1982,293,W,1,1,22110,21029846,23021741,12898,19299893,20625044
1982-07-21,1982,294,W,1,1,22626,21052472,23021741,12242,19312135,20625044
1982-07-22,1982,295,W,1,1,22649,21075121,23021741,14113,19326248,20625044
1982-07-23,1982,296,W,1,1,22505,21097626,23021741,12165,19338413,20625044
1982-07-24,1982,297,W,1,1,22576,21120202,23021741,11400,19349813,20625044
1982-07-25,1982,298,W,1,1,22982,21143184,23021741,11741,19361554,20625044
1982-07-26,1982,299,W,1,1,23987,21167171,23021741,13581,19375135,20625044
1982-07-27,1982,300,W,1,1,23943,21191114,23021741,11907,19387042,20625044
1982-07-28,1982,301,W,1,1,23872,21214986,23021741,12758,19399800,20625044
1982-07-29,1982,302,W,1,1,23956,21238942,23021741,13285,19413085,20625044
1982-07-30,1982,303,W,1,1,24015,21262957,23021741,13631,19426716,20625044
1982-07-31,1982,304,W,1,1,23532,21286489,23021741,11686,19438402,20625044
1982-08-01,1982,305,W,1,1,24041,21310530,23021741,12739,19451141,20625044
1982-08-02,1982,306,W,1,1,24665,21335195,23021741,13982,19465123,20625044
1982-08-03,1982,307,W,1,1,22704,21357899,23021741,9855,19474978,20625044
1982-08-04,1982,308,W,1,1,21650,21379549,23021741,9150,19484128,20625044
1982-08-05,1982,309,W,1,1,21223,21400772,23021741,9836,19493964,20625044
1982-08-06,1982,310,W,1,1,22453,21423225,23021741,11173,19505137,20625044
1982-08-07,1982,311,W,1,1,24261,21447486,23021741,13041,19518178,20625044
1982-08-08,1982,312,W,1,1,24218,21471704,23021741,12392,19530570,20625044
1982-08-09,1982,313,W,1,1,24381,21496085,23021741,12330,19542900,20625044
1982-08-10,1982,314,W,1,1,24143,21520228,23021741,11931,19554831,20625044
1982-08-11,1982,315,W,1,1,24482,21544710,23021741,11927,19566758,20625044
1982-08-12,1982,316,W,1,1,24250,21568960,23021741,11938,19578696,20625044
1982-08-13,1982,317,W,1,1,23901,21592861,23021741,11643,19590339,20625044
1982-08-14,1982,318,W,1,1,24511,21617372,23021741,11825,19602164,20625044
1982-08-15,1982,319,W,1,1,25071,21642443,23021741,12046,19614210,20625044
1982-08-16,1982,320,W,1,1,25655,21668098,23021741,12792,19627002,20625044
1982-08-17,1982,321,W,1,1,25471,21693569,23021741,12218,19639220,20625044
1982-08-18,1982,322,W,1,1,25432,21719001,23021741,12503,19651723,20625044
1982-08-19,1982,323,W,1,1,25494,21744495,23021741,12395,19664118,20625044
1982-08-20,1982,324,W,1,1,25641,21770136,23021741,13285,19677403,20625044
1982-08-21,1982,325,W,1,1,25874,21796010,23021741,12863,19690266,20625044
1982-08-22,1982,326,W,1,1,26131,21822141,23021741,13962,19704228,20625044
1982-08-23,1982,327,W,1,1,26820,21848961,23021741,14677,19718905,20625044
1982-08-24,1982,328,W,1,1,26171,21875132,23021741,12208,19731113,20625044
1982-08-25,1982,329,W,1,1,26219,21901351,23021741,12824,19743937,20625044
1982-08-26,1982,330,W,1,1,27109,21928460,23021741,15215,19759152,20625044
1982-08-27,1982,331,W,1,1,27811,21956271,23021741,15795,19774947,20625044
1982-08-28,1982,332,W,1,1,28109,21984380,23021741,17402,19792349,20625044
1982-08-29,1982,333,W,1,1,28339,22012719,23021741,17777,19810126,20625044
1982-08-30,1982,334,W,1,1,29073,22041792,23021741,19636,19829762,20625044
1982-08-31,1982,335,W,1,1,28982,22070774,23021741,21227,19850989,20625044
1982-09-01,1982,336,W,1,1,29313,22100087,23021741,20875,19871864,20625044
1982-09-02,1982,337,W,1,1,29868,22129955,23021741,20999,19892863,20625044
1982-09-03,1982,338,W,1,1,29839,22159794,23021741,20705,19913568,20625044
1982-09-04,1982,339,W,1,1,29915,22189709,23021741,21179,19934747,20625044
1982-09-05,1982,340,W,1,1,31290,22220999,23021741,22605,19957352,20625044
1982-09-06,1982,341,W,1,1,31954,22252953,23021741,24677,19982029,20625044
1982-09-07,1982,342,W,1,1,31296,22284249,23021741,24091,20006120,20625044
1982-09-08,1982,343,W,1,1,31217,22315466,23021741,23473,20029593,20625044
1982-09-09,1982,344,W,1,1,31299,22346765,23021741,23704,20053297,20625044
1982-09-10,1982,345,W,1,1,31562,22378327,23021741,24142,20077439,20625044
1982-09-11,1982,346,W,1,1,31542,22409869,23021741,23222,20100661,20625044
1982-09-12,1982,347,W,1,1,31884,22441753,23021741,22659,20123320,20625044
1982-09-13,1982,348,W,1,1,30684,22472437,23021741,22842,20146162,20625044
1982-09-14,1982,349,W,1,1,28947,22501384,23021741,21363,20167525,20625044
1982-09-15,1982,350,W,1,1,29915,22531299,23021741,22649,20190174,20625044
1982-09-16,1982,351,W,1,1,30332,22561631,23021741,27751,20217925,20625044
1982-09-17,1982,352,W,1,1,30616,22592247,23021741,29085,20247010,20625044
1982-09-18,1982,353,W,1,1,31489,22623736,23021741,28778,20275788,20625044
1982-09-19,1982,354,W,1,1,32539,22656275,23021741,29237,20305025,20625044
1982-09-20,1982,355,W,1,1,33839,22690114,23021741,31397,20336422,20625044
1982-09-21,1982,356,W,1,1,33740,22723854,23021741,27503,20363925,20625044
1982-09-22,1982,357,W,1,1,32941,22756795,23021741,24744,20388669,20625044
1982-09-23,1982,358,W,1,1,32829,22789624,23021741,24574,20413243,20625044
1982-09-24,1982,359,W,1,1,32771,22822395,23021741,24208,20437451,20625044
1982-09-25,1982,360,W,1,1,32955,22855350,23021741,25476,20462927,20625044
1982-09-26,1982,361,W,1,1,33988,22889338,23021741,32111,20495038,20625044
1982-09-27,1982,362,W,1,1,33948,22923286,23021741,32921,20527959,20625044
1982-09-28,1982,363,W,1,1,33099,22956385,23021741,33452,20561411,20625044
1982-09-29,1982,364,W,1,1,33003,22989388,23021741,32653,20594064,20625044
1982-09-30,1982,365,W,1,1,32353,23021741,23021741,30980,20625044,20625044
1982-10-01,1983,1,W,2,2,32644,32644,34656486,26630,26630,32400143
1982-10-02,1983,2,W,2,2,32067,64711,34656486,25614,52244,32400143
1982-10-03,1983,3,W,2,2,31178,95889,34656486,24100,76344,32400143
1982-10-04,1983,4,W,2,2,31137,127026,34656486,24884,101228,32400143
1982-10-05,1983,5,W,2,2,30216,157242,34656486,23755,124983,32400143
1982-10-06,1983,6,W,2,2,29364,186606,34656486,22385,147368,32400143
1982-10-07,1983,7,W,2,2,29385,215991,34656486,23047,170415,32400143
1982-10-08,1983,8,W,2,2,29224,245215,34656486,22608,193023,32400143
1982-10-09,1983,9,W,2,2,29209,274424,34656486,24816,217839,32400143
1982-10-10,1983,10,W,2,2,29810,304234,34656486,25087,242926,32400143
1982-10-11,1983,11,W,2,2,30046,334280,34656486,25590,268516,32400143
1982-10-12,1983,12,W,2,2,29439,363719,34656486,23239,291755,32400143
1982-10-13,1983,13,W,2,2,27996,391715,34656486,21756,313511,32400143
1982-10-14,1983,14,W,2,2,26753,418468,34656486,19870,333381,32400143
1982-10-15,1983,15,W,2,2,25566,444034,34656486,18230,351611,32400143
1982-10-16,1983,16,W,2,2,24273,468307,34656486,16600,368211,32400143
1982-10-17,1983,17,W,2,2,23758,492065,34656486,15902,384113,32400143
1982-10-18,1983,18,W,2,2,23297,515362,34656486,16239,400352,32400143
1982-10-19,1983,19,W,2,2,23297,538659,34656486,15594,415946,32400143
1982-10-20,1983,20,W,2,2,24132,562791,34656486,16526,432472,32400143
1982-10-21,1983,21,W,2,2,24511,587302,34656486,16519,448991,32400143
1982-10-22,1983,22,W,2,2,24764,612066,34656486,17117,466108,32400143
1982-10-23,1983,23,W,2,2,25789,637855,34656486,18746,484854,32400143
1982-10-24,1983,24,W,2,2,26424,664279,34656486,18055,502909,32400143
1982-10-25,1983,25,W,2,2,27368,691647,34656486,20444,523353,32400143
1982-10-26,1983,26,W,2,2,31338,722985,34656486,32670,556023,32400143
1982-10-27,1983,27,W,2,2,32259,755244,34656486,32413,588436,32400143
1982-10-28,1983,28,W,2,2,34501,789745,34656486,33769,622205,32400143
1982-10-29,1983,29,W,2,2,33861,823606,34656486,31985,654190,32400143
1982-10-30,1983,30,W,2,2,34489,858095,34656486,30681,684871,32400143
1982-10-31,1983,31,W,2,2,35237,893332,34656486,27366,712237,32400143
1982-11-01,1983,32,W,2,2,36556,929888,34656486,29430,741667,32400143
1982-11-02,1983,33,W,2,2,36778,966666,34656486,30893,772560,32400143
1982-11-03,1983,34,W,2,2,35548,1002214,34656486,29802,802362,32400143
1982-11-04,1983,35,W,2,2,34273,1036487,34656486,27247,829609,32400143
1982-11-05,1983,36,W,2,2,33728,1070215,34656486,25926,855535,32400143
1982-11-06,1983,37,W,2,2,34240,1104455,34656486,25418,880953,32400143
1982-11-07,1983,38,W,2,2,33596,1138051,34656486,23959,904912,32400143
1982-11-08,1983,39,W,2,2,33959,1172010,34656486,26020,930932,32400143
1982-11-09,1983,40,W,2,2,32146,1204156,34656486,24779,955711,32400143
1982-11-10,1983,41,W,2,2,31674,1235830,34656486,29776,985487,32400143
1982-11-11,1983,42,W,2,2,30946,1266776,34656486,29447,1014934,32400143
1982-11-12,1983,43,W,2,2,29923,1296699,34656486,28794,1043728,32400143
1982-11-13,1983,44,W,2,2,31176,1327875,34656486,27894,1071622,32400143
1982-11-14,1983,45,W,2,2,31827,1359702,34656486,28042,1099664,32400143
1982-11-15,1983,46,W,2,2,30420,1390122,34656486,21505,1121169,32400143
1982-11-16,1983,47,W,2,2,27784,1417906,34656486,19409,1140578,32400143
1982-11-17,1983,48,W,2,2,27474,1445380,34656486,20764,1161342,32400143
1982-11-18,1983,49,W,2,2,33933,1479313,34656486,31115,1192457,32400143
1982-11-19,1983,50,W,2,2,46983,1526296,34656486,54636,1247093,32400143
1982-11-20,1983,51,W,2,2,55141,1581437,34656486,61597,1308690,32400143
1982-11-21,1983,52,W,2,2,56757,1638194,34656486,62854,1371544,32400143
1982-11-22,1983,53,W,2,2,54878,1693072,34656486,61505,1433049,32400143
1982-11-23,1983,54,W,2,2,53771,1746843,34656486,58234,1491283,32400143
1982-11-24,1983,55,W,2,2,55771,1802614,34656486,51460,1542743,32400143
1982-11-25,1983,56,W,2,2,58353,1860967,34656486,53541,1596284,32400143
1982-11-26,1983,57,W,2,2,57332,1918299,34656486,52189,1648473,32400143
1982-11-27,1983,58,W,2,2,55700,1973999,34656486,49415,1697888,32400143
1982-11-28,1983,59,W,2,2,54788,2028787,34656486,45936,1743824,32400143
1982-11-29,1983,60,W,2,2,58303,2087090,34656486,50603,1794427,32400143
1982-11-30,1983,61,W,2,2,89298,2176388,34656486,92380,1886807,32400143
1982-12-01,1983,62,W,2,2,99055,2275443,34656486,96726,1983533,32400143
1982-12-02,1983,63,W,2,2,101807,2377250,34656486,99152,2082685,32400143
1982-12-03,1983,64,W,2,2,100484,2477734,34656486,97493,2180178,32400143
1982-12-04,1983,65,W,2,2,93988,2571722,34656486,90028,2270206,32400143
1982-12-05,1983,66,W,2,2,87198,2658920,34656486,75704,2345910,32400143
1982-12-06,1983,67,W,2,2,82040,2740960,34656486,70931,2416841,32400143
1982-12-07,1983,68,W,2,2,75409,2816369,34656486,63762,2480603,32400143
1982-12-08,1983,69,W,2,2,70631,2887000,34656486,59601,2540204,32400143
1982-12-09,1983,70,W,2,2,67849,2954849,34656486,56486,2596690,32400143
1982-12-10,1983,71,W,2,2,64110,3018959,34656486,52074,2648764,32400143
1982-12-11,1983,72,W,2,2,59992,3078951,34656486,48044,2696808,32400143
1982-12-12,1983,73,W,2,2,55405,3134356,34656486,44760,2741568,32400143
1982-12-13,1983,74,W,2,2,53078,3187434,34656486,49258,2790826,32400143
1982-12-14,1983,75,W,2,2,51481,3238915,34656486,45630,2836456,32400143
1982-12-15,1983,76,W,2,2,50243,3289158,34656486,39386,2875842,32400143
1982-12-16,1983,77,W,2,2,49235,3338393,34656486,37483,2913325,32400143
1982-12-17,1983,78,W,2,2,52402,3390795,34656486,41039,2954364,32400143
1982-12-18,1983,79,W,2,2,58554,3449349,34656486,47695,3002059,32400143
1982-12-19,1983,80,W,2,2,62960,3512309,34656486,52731,3054790,32400143
1982-12-20,1983,81,W,2,2,65184,3577493,34656486,54451,3109241,32400143
1982-12-21,1983,82,W,2,2,89652,3667145,34656486,82125,3191366,32400143
1982-12-22,1983,83,W,2,2,136804,3803949,34656486,138359,3329725,32400143
1982-12-23,1983,84,W,2,2,186287,3990236,34656486,195630,3525355,32400143
1982-12-24,1983,85,W,2,2,195774,4186010,34656486,200389,3725744,32400143
1982-12-25,1983,86,W,2,2,177744,4363754,34656486,181797,3907541,32400143
1982-12-26,1983,87,W,2,2,163716,4527470,34656486,163662,4071203,32400143
1982-12-27,1983,88,W,2,2,147708,4675178,34656486,141687,4212890,32400143
1982-12-28,1983,89,W,2,2,134703,4809881,34656486,128934,4341824,32400143
1982-12-29,1983,90,W,2,2,121568,4931449,34656486,116308,4458132,32400143
1982-12-30,1983,91,W,2,2,108836,5040285,34656486,98985,4557117,32400143
1982-12-31,1983,92,W,2,2,97307,5137592,34656486,85838,4642955,32400143
1983-01-01,1983,93,W,2,2,89021,5226613,34656486,77406,4720361,32400143
1983-01-02,1983,94,W,2,2,81416,5308029,34656486,69968,4790329,32400143
1983-01-03,1983,95,W,2,2,75251,5383280,34656486,63764,4854093,32400143
1983-01-04,1983,96,W,2,2,70508,5453788,34656486,58917,4913010,32400143
1983-01-05,1983,97,W,2,2,65357,5519145,34656486,54668,4967678,32400143
1983-01-06,1983,98,W,2,2,61655,5580800,34656486,50366,5018044,32400143
1983-01-07,1983,99,W,2,2,59186,5639986,34656486,47844,5065888,32400143
1983-01-08,1983,100,W,2,2,56484,5696470,34656486,44879,5110767,32400143
1983-01-09,1983,101,W,2,2,53476,5749946,34656486,41885,5152652,32400143
1983-01-10,1983,102,W,2,2,51097,5801043,34656486,39452,5192104,32400143
1983-01-11,1983,103,W,2,2,48818,5849861,34656486,37042,5229146,32400143
1983-01-12,1983,104,W,2,2,47178,5897039,34656486,35687,5264833,32400143
1983-01-13,1983,105,W,2,2,44937,5941976,34656486,33362,5298195,32400143
1983-01-14,1983,106,W,2,2,43844,5985820,34656486,32659,5330854,32400143
1983-01-15,1983,107,W,2,2,42846,6028666,34656486,31096,5361950,32400143
1983-01-16,1983,108,W,2,2,41704,6070370,34656486,31967,5393917,32400143
1983-01-17,1983,109,W,2,2,41266,6111636,34656486,31569,5425486,32400143
1983-01-18,1983,110,W,2,2,41249,6152885,34656486,31404,5456890,32400143
1983-01-19,1983,111,W,2,2,47578,6200463,34656486,42935,5499825,32400143
1983-01-20,1983,112,W,2,2,52184,6252647,34656486,48259,5548084,32400143
1983-01-21,1983,113,W,2,2,57065,6309712,34656486,50750,5598834,32400143
1983-01-22,1983,114,W,2,2,64845,6374557,34656486,62005,5660839,32400143
1983-01-23,1983,115,W,2,2,82644,6457201,34656486,88966,5749805,32400143
1983-01-24,1983,116,W,2,2,116478,6573679,34656486,123269,5873074,32400143
1983-01-25,1983,117,W,2,2,130048,6703727,34656486,138658,6011732,32400143
1983-01-26,1983,118,W,2,2,145819,6849546,34656486,154907,6166639,32400143
1983-01-27,1983,119,W,2,2,211922,7061468,34656486,216764,6383403,32400143
1983-01-28,1983,120,W,2,2,232934,7294402,34656486,228540,6611943,32400143
1983-01-29,1983,121,W,2,2,287144,7581546,34656486,277076,6889019,32400143
1983-01-30,1983,122,W,2,2,297111,7878657,34656486,285664,7174683,32400143
1983-01-31,1983,123,W,2,2,261614,8140271,34656486,250880,7425563,32400143
1983-02-01,1983,124,W,2,2,224210,8364481,34656486,214199,7639762,32400143
1983-02-02,1983,125,W,2,2,199510,8563991,34656486,188436,7828198,32400143
1983-02-03,1983,126,W,2,2,181469,8745460,34656486,170911,7999109,32400143
1983-02-04,1983,127,W,2,2,167512,8912972,34656486,156618,8155727,32400143
1983-02-05,1983,128,W,2,2,155415,9068387,34656486,144779,8300506,32400143
1983-02-06,1983,129,W,2,2,144923,9213310,34656486,137347,8437853,32400143
1983-02-07,1983,130,W,2,2,155693,9369003,34656486,154545,8592398,32400143
1983-02-08,1983,131,W,2,2,196433,9565436,34656486,198335,8790733,32400143
1983-02-09,1983,132,W,2,2,218093,9783529,34656486,221043,9011776,32400143
1983-02-10,1983,133,W,2,2,217590,10001119,34656486,220039,9231815,32400143
1983-02-11,1983,134,W,2,2,205156,10206275,34656486,204373,9436188,32400143
1983-02-12,1983,135,W,2,2,198152,10404427,34656486,190023,9626211,32400143
1983-02-13,1983,136,W,2,2,217580,10622007,34656486,209261,9835472,32400143
1983-02-14,1983,137,W,2,2,223715,10845722,34656486,216217,10051689,32400143
1983-02-15,1983,138,W,2,2,216134,11061856,34656486,207583,10259272,32400143
1983-02-16,1983,139,W,2,2,209333,11271189,34656486,201081,10460353,32400143
1983-02-17,1983,140,W,2,2,192183,11463372,34656486,184144,10644497,32400143
1983-02-18,1983,141,W,2,2,181597,11644969,34656486,171572,10816069,32400143
1983-02-19,1983,142,W,2,2,175638,11820607,34656486,166108,10982177,32400143
1983-02-20,1983,143,W,2,2,168221,11988828,34656486,158278,11140455,32400143
1983-02-21,1983,144,W,2,2,162824,12151652,34656486,152547,11293002,32400143
1983-02-22,1983,145,W,2,2,158936,12310588,34656486,148672,11441674,32400143
1983-02-23,1983,146,W,2,2,155286,12465874,34656486,143518,11585192,32400143
1983-02-24,1983,147,W,2,2,150292,12616166,34656486,138523,11723715,32400143
1983-02-25,1983,148,W,2,2,144600,12760766,34656486,134075,11857790,32400143
1983-02-26,1983,149,W,2,2,152891,12913657,34656486,145726,12003516,32400143
1983-02-27,1983,150,W,2,2,164917,13078574,34656486,159797,12163313,32400143
1983-02-28,1983,151,W,2,2,186986,13265560,34656486,183425,12346738,32400143
1983-03-01,1983,152,W,2,2,252314,13517874,34656486,253914,12600652,32400143
1983-03-02,1983,153,W,2,2,327739,13845613,34656486,331766,12932418,32400143
1983-03-03,1983,154,W,2,2,387704,14233317,34656486,389928,13322346,32400143
1983-03-04,1983,155,W,2,2,422213,14655530,34656486,419680,13742026,32400143
1983-03-05,1983,156,W,2,2,401166,15056696,34656486,394093,14136119,32400143
1983-03-06,1983,157,W,2,2,367015,15423711,34656486,359755,14495874,32400143
1983-03-07,1983,158,W,2,2,336389,15760100,34656486,330841,14826715,32400143
1983-03-08,1983,159,W,2,2,309387,16069487,34656486,305044,15131759,32400143
1983-03-09,1983,160,W,2,2,278744,16348231,34656486,274706,15406465,32400143
1983-03-10,1983,161,W,2,2,250884,16599115,34656486,246991,15653456,32400143
1983-03-11,1983,162,W,2,2,236971,16836086,34656486,238219,15891675,32400143
1983-03-12,1983,163,W,2,2,223893,17059979,34656486,221892,16113567,32400143
1983-03-13,1983,164,W,2,2,275352,17335331,34656486,280801,16394368,32400143
1983-03-14,1983,165,W,2,2,333058,17668389,34656486,338706,16733074,32400143
1983-03-15,1983,166,W,2,2,339875,18008264,34656486,345574,17078648,32400143
1983-03-16,1983,167,W,2,2,323083,18331347,34656486,325897,17404545,32400143
1983-03-17,1983,168,W,2,2,303771,18635118,34656486,308330,17712875,32400143
1983-03-18,1983,169,W,2,2,283412,18918530,34656486,282554,17995429,32400143
1983-03-19,1983,170,W,2,2,243040,19161570,34656486,241921,18237350,32400143
1983-03-20,1983,171,W,2,2,212334,19373904,34656486,214157,18451507,32400143
1983-03-21,1983,172,W,2,2,204326,19578230,34656486,206107,18657614,32400143
1983-03-22,1983,173,W,2,2,193825,19772055,34656486,196853,18854467,32400143
1983-03-23,1983,174,W,2,2,194943,19966998,34656486,196885,19051352,32400143
1983-03-24,1983,175,W,2,2,205035,20172033,34656486,208910,19260262,32400143
1983-03-25,1983,176,W,2,2,212116,20384149,34656486,213076,19473338,32400143
1983-03-26,1983,177,W,2,2,207758,20591907,34656486,208676,19682014,32400143
1983-03-27,1983,178,W,2,2,200859,20792766,34656486,201621,19883635,32400143
1983-03-28,1983,179,W,2,2,196173,20988939,34656486,196129,20079764,32400143
1983-03-29,1983,180,W,2,2,186616,21175555,34656486,184591,20264355,32400143
1983-03-30,1983,181,W,2,2,179863,21355418,34656486,176055,20440410,32400143
1983-03-31,1983,182,W,2,2,175403,21530821,34656486,171646,20612056,32400143
1983-04-01,1983,183,W,2,2,174329,21705150,34656486,169040,20781096,32400143
1983-04-02,1983,184,W,2,2,174118,21879268,34656486,168334,20949430,32400143
1983-04-03,1983,185,W,2,2,173178,22052446,34656486,167453,21116883,32400143
1983-04-04,1983,186,W,2,2,167726,22220172,34656486,161919,21278802,32400143
1983-04-05,1983,187,W,2,2,164216,22384388,34656486,158411,21437213,32400143
1983-04-06,1983,188,W,2,2,161391,22545779,34656486,155610,21592823,32400143
1983-04-07,1983,189,W,2,2,153208,22698987,34656486,147404,21740227,32400143
1983-04-08,1983,190,W,2,2,144397,22843384,34656486,138506,21878733,32400143
1983-04-09,1983,191,W,2,2,135124,22978508,34656486,129293,22008026,32400143
1983-04-10,1983,192,W,2,2,127462,23105970,34656486,121824,22129850,32400143
1983-04-11,1983,193,W,2,2,120631,23226601,34656486,115458,22245308,32400143
1983-04-12,1983,194,W,2,2,116479,23343080,34656486,111983,22357291,32400143
1983-04-13,1983,195,W,2,2,112835,23455915,34656486,108288,22465579,32400143
1983-04-14,1983,196,W,2,2,109222,23565137,34656486,104688,22570267,32400143
1983-04-15,1983,197,W,2,2,105072,23670209,34656486,100258,22670525,32400143
1983-04-16,1983,198,W,2,2,100651,23770860,34656486,96118,22766643,32400143
1983-04-17,1983,199,W,2,2,97131,23867991,34656486,91680,22858323,32400143
1983-04-18,1983,200,W,2,2,95422,23963413,34656486,89994,22948317,32400143
1983-04-19,1983,201,W,2,2,94734,24058147,34656486,88229,23036546,32400143
1983-04-20,1983,202,W,2,2,94672,24152819,34656486,89269,23125815,32400143
1983-04-21,1983,203,W,2,2,94047,24246866,34656486,90575,23216390,32400143
1983-04-22,1983,204,W,2,2,94344,24341210,34656486,91724,23308114,32400143
1983-04-23,1983,205,W,2,2,94864,24436074,34656486,92133,23400247,32400143
1983-04-24,1983,206,W,2,2,97297,24533371,34656486,96279,23496526,32400143
1983-04-25,1983,207,W,2,2,99617,24632988,34656486,98193,23594719,32400143
1983-04-26,1983,208,W,2,2,102041,24735029,34656486,98966,23693685,32400143
1983-04-27,1983,209,W,2,2,103670,24838699,34656486,100609,23794294,32400143
1983-04-28,1983,210,W,2,2,108251,24946950,34656486,111993,23906287,32400143
1983-04-29,1983,211,W,2,2,114747,25061697,34656486,117882,24024169,32400143
1983-04-30,1983,212,W,2,2,123201,25184898,34656486,130879,24155048,32400143
1983-05-01,1983,213,W,2,2,127334,25312232,34656486,134653,24289701,32400143
1983-05-02,1983,214,W,2,2,124837,25437069,34656486,132234,24421935,32400143
1983-05-03,1983,215,W,2,2,124359,25561428,34656486,124867,24546802,32400143
1983-05-04,1983,216,W,2,2,122468,25683896,34656486,121867,24668669,32400143
1983-05-05,1983,217,W,2,2,122013,25805909,34656486,118893,24787562,32400143
1983-05-06,1983,218,W,2,2,123183,25929092,34656486,118507,24906069,32400143
1983-05-07,1983,219,W,2,2,122621,26051713,34656486,117885,25023954,32400143
1983-05-08,1983,220,W,2,2,121018,26172731,34656486,118053,25142007,32400143
1983-05-09,1983,221,W,2,2,118675,26291406,34656486,116370,25258377,32400143
1983-05-10,1983,222,W,2,2,117224,26408630,34656486,113341,25371718,32400143
1983-05-11,1983,223,W,2,2,114872,26523502,34656486,110842,25482560,32400143
1983-05-12,1983,224,W,2,2,112457,26635959,34656486,107269,25589829,32400143
1983-05-13,1983,225,W,2,2,110667,26746626,34656486,106520,25696349,32400143
1983-05-14,1983,226,W,2,2,109460,26856086,34656486,104376,25800725,32400143
1983-05-15,1983,227,W,2,2,108137,26964223,34656486,103085,25903810,32400143
1983-05-16,1983,228,W,2,2,106205,27070428,34656486,101103,26004913,32400143
1983-05-17,1983,229,W,2,2,102191,27172619,34656486,97023,26101936,32400143
1983-05-18,1983,230,W,2,2,96986,27269605,34656486,91840,26193776,32400143
1983-05-19,1983,231,W,2,2,89987,27359592,34656486,84754,26278530,32400143
1983-05-20,1983,232,W,2,2,85808,27445400,34656486,80509,26359039,32400143
1983-05-21,1983,233,W,2,2,84579,27529979,34656486,78881,26437920,32400143
1983-05-22,1983,234,W,2,2,83808,27613787,34656486,77826,26515746,32400143
1983-05-23,1983,235,W,2,2,83417,27697204,34656486,75844,26591590,32400143
1983-05-24,1983,236,W,2,2,83396,27780600,34656486,75561,26667151,32400143
1983-05-25,1983,237,W,2,2,82909,27863509,34656486,74871,26742022,32400143
1983-05-26,1983,238,W,2,2,82673,27946182,34656486,75099,26817121,32400143
1983-05-27,1983,239,W,2,2,83487,28029669,34656486,76280,26893401,32400143
1983-05-28,1983,240,W,2,2,84975,28114644,34656486,77505,26970906,32400143
1983-05-29,1983,241,W,2,2,86263,28200907,34656486,78789,27049695,32400143
1983-05-30,1983,242,W,2,2,88259,28289166,34656486,80693,27130388,32400143
1983-05-31,1983,243,W,2,2,89092,28378258,34656486,83084,27213472,32400143
1983-06-01,1983,244,W,2,2,90039,28468297,34656486,82930,27296402,32400143
1983-06-02,1983,245,W,2,2,91242,28559539,34656486,83651,27380053,32400143
1983-06-03,1983,246,W,2,2,91272,28650811,34656486,84643,27464696,32400143
1983-06-04,1983,247,W,2,2,90393,28741204,34656486,83738,27548434,32400143
1983-06-05,1983,248,W,2,2,90218,28831422,34656486,83509,27631943,32400143
1983-06-06,1983,249,W,2,2,90353,28921775,34656486,83589,27715532,32400143
1983-06-07,1983,250,W,2,2,90062,29011837,34656486,81431,27796963,32400143
1983-06-08,1983,251,W,2,2,89324,29101161,34656486,79910,27876873,32400143
1983-06-09,1983,252,W,2,2,88610,29189771,34656486,80278,27957151,32400143
1983-06-10,1983,253,W,2,2,86871,29276642,34656486,78690,28035841,32400143
1983-06-11,1983,254,W,2,2,85980,29362622,34656486,77810,28113651,32400143
1983-06-12,1983,255,W,2,2,85440,29448062,34656486,76961,28190612,32400143
1983-06-13,1983,256,W,2,2,86124,29534186,34656486,77799,28268411,32400143
1983-06-14,1983,257,W,2,2,84843,29619029,34656486,76080,28344491,32400143
1983-06-15,1983,258,W,2,2,82746,29701775,34656486,73501,28417992,32400143
1983-06-16,1983,259,W,2,2,81483,29783258,34656486,72573,28490565,32400143
1983-06-17,1983,260,W,2,2,78548,29861806,34656486,70896,28561461,32400143
1983-06-18,1983,261,W,2,2,76703,29938509,34656486,67366,28628827,32400143
1983-06-19,1983,262,W,2,2,74696,30013205,34656486,65523,28694350,32400143
1983-06-20,1983,263,W,2,2,73826,30087031,34656486,64301,28758651,32400143
1983-06-21,1983,264,W,2,2,71867,30158898,34656486,62551,28821202,32400143
1983-06-22,1983,265,W,2,2,68813,30227711,34656486,59113,28880315,32400143
1983-06-23,1983,266,W,2,2,66398,30294109,34656486,56474,28936789,32400143
1983-06-24,1983,267,W,2,2,66163,30360272,34656486,56553,28993342,32400143
1983-06-25,1983,268,W,2,2,67630,30427902,34656486,57444,29050786,32400143
1983-06-26,1983,269,W,2,2,68109,30496011,34656486,56028,29106814,32400143
1983-06-27,1983,270,W,2,2,68933,30564944,34656486,57725,29164539,32400143
1983-06-28,1983,271,W,2,2,69320,30634264,34656486,59375,29223914,32400143
1983-06-29,1983,272,W,2,2,69323,30703587,34656486,59042,29282956,32400143
1983-06-30,1983,273,W,2,2,68529,30772116,34656486,58398,29341354,32400143
1983-07-01,1983,274,W,2,2,67631,30839747,34656486,59504,29400858,32400143
1983-07-02,1983,275,W,2,2,66751,30906498,34656486,58434,29459292,32400143
1983-07-03,1983,276,W,2,2,66708,30973206,34656486,57943,29517235,32400143
1983-07-04,1983,277,W,2,2,66938,31040144,34656486,58040,29575275,32400143
1983-07-05,1983,278,W,2,2,65785,31105929,34656486,56739,29632014,32400143
1983-07-06,1983,279,W,2,2,65282,31171211,34656486,57137,29689151,32400143
1983-07-07,1983,280,W,2,2,65417,31236628,34656486,58400,29747551,32400143
1983-07-08,1983,281,W,2,2,66061,31302689,34656486,56505,29804056,32400143
1983-07-09,1983,282,W,2,2,65209,31367898,34656486,56985,29861041,32400143
1983-07-10,1983,283,W,2,2,63868,31431766,34656486,54414,29915455,32400143
1983-07-11,1983,284,W,2,2,63070,31494836,34656486,53987,29969442,32400143
1983-07-12,1983,285,W,2,2,62582,31557418,34656486,54380,30023822,32400143
1983-07-13,1983,286,W,2,2,61514,31618932,34656486,53372,30077194,32400143
1983-07-14,1983,287,W,2,2,60733,31679665,34656486,52590,30129784,32400143
1983-07-15,1983,288,W,2,2,58963,31738628,34656486,50278,30180062,32400143
1983-07-16,1983,289,W,2,2,55449,31794077,34656486,44478,30224540,32400143
1983-07-17,1983,290,W,2,2,53285,31847362,34656486,40897,30265437,32400143
1983-07-18,1983,291,W,2,2,51366,31898728,34656486,40008,30305445,32400143
1983-07-19,1983,292,W,2,2,49472,31948200,34656486,39889,30345334,32400143
1983-07-20,1983,293,W,2,2,47582,31995782,34656486,38259,30383593,32400143
1983-07-21,1983,294,W,2,2,45553,32041335,34656486,35615,30419208,32400143
1983-07-22,1983,295,W,2,2,43805,32085140,34656486,33162,30452370,32400143
1983-07-23,1983,296,W,2,2,42055,32127195,34656486,31224,30483594,32400143
1983-07-24,1983,297,W,2,2,40538,32167733,34656486,28632,30512226,32400143
1983-07-25,1983,298,W,2,2,39880,32207613,34656486,28655,30540881,32400143
1983-07-26,1983,299,W,2,2,38749,32246362,34656486,28089,30568970,32400143
1983-07-27,1983,300,W,2,2,37612,32283974,34656486,27326,30596296,32400143
1983-07-28,1983,301,W,2,2,36973,32320947,34656486,27332,30623628,32400143
1983-07-29,1983,302,W,2,2,36218,32357165,34656486,25911,30649539,32400143
1983-07-30,1983,303,W,2,2,35666,32392831,34656486,24853,30674392,32400143
1983-07-31,1983,304,W,2,2,35542,32428373,34656486,23497,30697889,32400143
1983-08-01,1983,305,W,2,2,35375,32463748,34656486,23881,30721770,32400143
1983-08-02,1983,306,W,2,2,35197,32498945,34656486,21529,30743299,32400143
1983-08-03,1983,307,W,2,2,34896,32533841,34656486,22253,30765552,32400143
1983-08-04,1983,308,W,2,2,34683,32568524,34656486,23144,30788696,32400143
1983-08-05,1983,309,W,2,2,34764,32603288,34656486,23707,30812403,32400143
1983-08-06,1983,310,W,2,2,34611,32637899,34656486,22361,30834764,32400143
1983-08-07,1983,311,W,2,2,34676,32672575,34656486,21713,30856477,32400143
1983-08-08,1983,312,W,2,2,34591,32707166,34656486,21739,30878216,32400143
1983-08-09,1983,313,W,2,2,33823,32740989,34656486,21913,30900129,32400143
1983-08-10,1983,314,W,2,2,32489,32773478,34656486,21685,30921814,32400143
1983-08-11,1983,315,W,2,2,32858,32806336,34656486,21166,30942980,32400143
1983-08-12,1983,316,W,2,2,34219,32840555,34656486,21667,30964647,32400143
1983-08-13,1983,317,W,2,2,34482,32875037,34656486,22167,30986814,32400143
1983-08-14,1983,318,W,2,2,34560,32909597,34656486,23697,31010511,32400143
1983-08-15,1983,319,W,2,2,34947,32944544,34656486,24078,31034589,32400143
1983-08-16,1983,320,W,2,2,34818,32979362,34656486,23775,31058364,32400143
1983-08-17,1983,321,W,2,2,34730,33014092,34656486,24710,31083074,32400143
1983-08-18,1983,322,W,2,2,34279,33048371,34656486,23548,31106622,32400143
1983-08-19,1983,323,W,2,2,34853,33083224,34656486,24491,31131113,32400143
1983-08-20,1983,324,W,2,2,35413,33118637,34656486,23967,31155080,32400143
1983-08-21,1983,325,W,2,2,35410,33154047,34656486,22655,31177735,32400143
1983-08-22,1983,326,W,2,2,35628,33189675,34656486,25052,31202787,32400143
1983-08-23,1983,327,W,2,2,35778,33225453,34656486,26182,31228969,32400143
1983-08-24,1983,328,W,2,2,35405,33260858,34656486,25690,31254659,32400143
1983-08-25,1983,329,W,2,2,35671,33296529,34656486,26153,31280812,32400143
1983-08-26,1983,330,W,2,2,37282,33333811,34656486,27611,31308423,32400143
1983-08-27,1983,331,W,2,2,38455,33372266,34656486,28535,31336958,32400143
1983-08-28,1983,332,W,2,2,38875,33411141,34656486,28503,31365461,32400143
1983-08-29,1983,333,W,2,2,39526,33450667,34656486,29872,31395333,32400143
1983-08-30,1983,334,W,2,2,39710,33490377,34656486,30520,31425853,32400143
1983-08-31,1983,335,W,2,2,39811,33530188,34656486,31043,31456896,32400143
1983-09-01,1983,336,W,2,2,39665,33569853,34656486,31561,31488457,32400143
1983-09-02,1983,337,W,2,2,39059,33608912,34656486,31257,31519714,32400143
1983-09-03,1983,338,W,2,2,39258,33648170,34656486,31368,31551082,32400143
1983-09-04,1983,339,W,2,2,39655,33687825,34656486,31823,31582905,32400143
1983-09-05,1983,340,W,2,2,40237,33728062,34656486,32087,31614992,32400143
1983-09-06,1983,341,W,2,2,40101,33768163,34656486,32328,31647320,32400143
1983-09-07,1983,342,W,2,2,40426,33808589,34656486,31252,31678572,32400143
1983-09-08,1983,343,W,2,2,40733,33849322,34656486,34005,31712577,32400143
1983-09-09,1983,344,W,2,2,40153,33889475,34656486,32941,31745518,32400143
1983-09-10,1983,345,W,2,2,38869,33928344,34656486,30814,31776332,32400143
1983-09-11,1983,346,W,2,2,37771,33966115,34656486,29231,31805563,32400143
1983-09-12,1983,347,W,2,2,36401,34002516,34656486,28399,31833962,32400143
1983-09-13,1983,348,W,2,2,36083,34038599,34656486,29807,31863769,32400143
1983-09-14,1983,349,W,2,2,35743,34074342,34656486,29684,31893453,32400143
1983-09-15,1983,350,W,2,2,35678,34110020,34656486,29633,31923086,32400143
1983-09-16,1983,351,W,2,2,35819,34145839,34656486,28922,31952008,32400143
1983-09-17,1983,352,W,2,2,35946,34181785,34656486,29916,31981924,32400143
1983-09-18,1983,353,W,2,2,35819,34217604,34656486,29116,32011040,32400143
1983-09-19,1983,354,W,2,2,36612,34254216,34656486,29591,32040631,32400143
1983-09-20,1983,355,W,2,2,36105,34290321,34656486,29145,32069776,32400143
1983-09-21,1983,356,W,2,2,35216,34325537,34656486,27457,32097233,32400143
1983-09-22,1983,357,W,2,2,35251,34360788,34656486,32753,32129986,32400143
1983-09-23,1983,358,W,2,2,36090,34396878,34656486,34228,32164214,32400143
1983-09-24,1983,359,W,2,2,35299,34432177,34656486,33544,32197758,32400143
1983-09-25,1983,360,W,2,2,35971,34468148,34656486,34220,32231978,32400143
1983-09-26,1983,361,W,2,2,37500,34505648,34656486,36281,32268259,32400143
1983-09-27,1983,362,W,2,2,38349,34543997,34656486,33715,32301974,32400143
1983-09-28,1983,363,W,2,2,36916,34580913,34656486,31428,32333402,32400143
1983-09-29,1983,364,W,2,2,36803,34617716,34656486,31370,32364772,32400143
1983-09-30,1983,365,W,2,2,38770,34656486,34656486,35371,32400143,32400143
1983-10-01,1984,1,W,3,3+,39363,39363,17851417,35754,35754,15427292
1983-10-02,1984,2,W,3,3+,39337,78700,17851417,36895,72649,15427292
1983-10-03,1984,3,W,3,3+,39066,117766,17851417,36697,109346,15427292
1983-10-04,1984,4,W,3,3+,37744,155510,17851417,34514,143860,15427292
1983-10-05,1984,5,W,3,3+,38017,193527,17851417,33681,177541,15427292
1983-10-06,1984,6,W,3,3+,40123,233650,17851417,35263,212804,15427292
1983-10-07,1984,7,W,3,3+,39306,272956,17851417,34429,247233,15427292
1983-10-08,1984,8,W,3,3+,40206,313162,17851417,34559,281792,15427292
1983-10-09,1984,9,W,3,3+,41922,355084,17851417,37147,318939,15427292
1983-10-10,1984,10,W,3,3+,42243,397327,17851417,37579,356518,15427292
1983-10-11,1984,11,W,3,3+,42261,439588,17851417,37830,394348,15427292
1983-10-12,1984,12,W,3,3+,42129,481717,17851417,37708,432056,15427292
1983-10-13,1984,13,W,3,3+,41535,523252,17851417,37664,469720,15427292
1983-10-14,1984,14,W,3,3+,40449,563701,17851417,36758,506478,15427292
1983-10-15,1984,15,W,3,3+,38716,602417,17851417,34310,540788,15427292
1983-10-16,1984,16,W,3,3+,37088,639505,17851417,32723,573511,15427292
1983-10-17,1984,17,W,3,3+,35252,674757,17851417,31619,605130,15427292
1983-10-18,1984,18,W,3,3+,33449,708206,17851417,28881,634011,15427292
1983-10-19,1984,19,W,3,3+,32240,740446,17851417,28681,662692,15427292
1983-10-20,1984,20,W,3,3+,31626,772072,17851417,27077,689769,15427292
1983-10-21,1984,21,W,3,3+,31376,803448,17851417,27429,717198,15427292
1983-10-22,1984,22,W,3,3+,31521,834969,17851417,27155,744353,15427292
1983-10-23,1984,23,W,3,3+,31679,866648,17851417,27328,771681,15427292
1983-10-24,1984,24,W,3,3+,31566,898214,17851417,27395,799076,15427292
1983-10-25,1984,25,W,3,3+,31292,929506,17851417,27779,826855,15427292
1983-10-26,1984,26,W,3,3+,31202,960708,17851417,26872,853727,15427292
1983-10-27,1984,27,W,3,3+,31853,992561,17851417,27976,881703,15427292
1983-10-28,1984,28,W,3,3+,31681,1024242,17851417,28121,909824,15427292
1983-10-29,1984,29,W,3,3+,31818,1056060,17851417,29233,939057,15427292
1983-10-30,1984,30,W,3,3+,32269,1088329,17851417,30793,969850,15427292
1983-10-31,1984,31,W,3,3+,32335,1120664,17851417,30912,1000762,15427292
1983-11-01,1984,32,W,3,3+,32497,1153161,17851417,30396,1031158,15427292
1983-11-02,1984,33,W,3,3+,32309,1185470,17851417,30907,1062065,15427292
1983-11-03,1984,34,W,3,3+,31058,1216528,17851417,29083,1091148,15427292
1983-11-04,1984,35,W,3,3+,30202,1246730,17851417,27266,1118414,15427292
1983-11-05,1984,36,W,3,3+,29832,1276562,17851417,27645,1146059,15427292
1983-11-06,1984,37,W,3,3+,29106,1305668,17851417,26509,1172568,15427292
1983-11-07,1984,38,W,3,3+,29710,1335378,17851417,27303,1199871,15427292
1983-11-08,1984,39,W,3,3+,29690,1365068,17851417,27152,1227023,15427292
1983-11-09,1984,40,W,3,3+,29596,1394664,17851417,26405,1253428,15427292
1983-11-10,1984,41,W,3,3+,29509,1424173,17851417,26951,1280379,15427292
1983-11-11,1984,42,W,3,3+,40234,1464407,17851417,52371,1332750,15427292
1983-11-12,1984,43,W,3,3+,51211,1515618,17851417,63352,1396102,15427292
1983-11-13,1984,44,W,3,3+,57146,1572764,17851417,70146,1466248,15427292
1983-11-14,1984,45,W,3,3+,59020,1631784,17851417,75170,1541418,15427292
1983-11-15,1984,46,W,3,3+,63076,1694860,17851417,76819,1618237,15427292
1983-11-16,1984,47,W,3,3+,67386,1762246,17851417,69412,1687649,15427292
1983-11-17,1984,48,W,3,3+,81521,1843767,17851417,87214,1774863,15427292
1983-11-18,1984,49,W,3,3+,87391,1931158,17851417,96104,1870967,15427292
1983-11-19,1984,50,W,3,3+,99121,2030279,17851417,105189,1976156,15427292
1983-11-20,1984,51,W,3,3+,112002,2142281,17851417,119509,2095665,15427292
1983-11-21,1984,52,W,3,3+,115012,2257293,17851417,123167,2218832,15427292
1983-11-22,1984,53,W,3,3+,114748,2372041,17851417,117822,2336654,15427292
1983-11-23,1984,54,W,3,3+,95254,2467295,17851417,93446,2430100,15427292
1983-11-24,1984,55,W,3,3+,95521,2562816,17851417,93182,2523282,15427292
1983-11-25,1984,56,W,3,3+,104598,2667414,17851417,104981,2628263,15427292
1983-11-26,1984,57,W,3,3+,115718,2783132,17851417,114594,2742857,15427292
1983-11-27,1984,58,W,3,3+,127334,2910466,17851417,127484,2870341,15427292
1983-11-28,1984,59,W,3,3+,128636,3039102,17851417,128166,2998507,15427292
1983-11-29,1984,60,W,3,3+,120772,3159874,17851417,119027,3117534,15427292
1983-11-30,1984,61,W,3,3+,111026,3270900,17851417,107342,3224876,15427292
1983-12-01,1984,62,W,3,3+,96555,3367455,17851417,90613,3315489,15427292
1983-12-02,1984,63,W,3,3+,90230,3457685,17851417,87182,3402671,15427292
1983-12-03,1984,64,W,3,3+,89059,3546744,17851417,86413,3489084,15427292
1983-12-04,1984,65,W,3,3+,92163,3638907,17851417,91415,3580499,15427292
1983-12-05,1984,66,W,3,3+,92918,3731825,17851417,92052,3672551,15427292
1983-12-06,1984,67,W,3,3+,95005,3826830,17851417,94180,3766731,15427292
1983-12-07,1984,68,W,3,3+,97505,3924335,17851417,95967,3862698,15427292
1983-12-08,1984,69,W,3,3+,99801,4024136,17851417,97014,3959712,15427292
1983-12-09,1984,70,W,3,3+,102319,4126455,17851417,100508,4060220,15427292
1983-12-10,1984,71,W,3,3+,111818,4238273,17851417,111067,4171287,15427292
1983-12-11,1984,72,W,3,3+,125282,4363555,17851417,125209,4296496,15427292
1983-12-12,1984,73,W,3,3+,152998,4516553,17851417,154792,4451288,15427292
1983-12-13,1984,74,W,3,3+,164852,4681405,17851417,165646,4616934,15427292
1983-12-14,1984,75,W,3,3+,169189,4850594,17851417,168095,4785029,15427292
1983-12-15,1984,76,W,3,3+,159389,5009983,17851417,157253,4942282,15427292
1983-12-16,1984,77,W,3,3+,149123,5159106,17851417,144209,5086491,15427292
1983-12-17,1984,78,W,3,3+,139866,5298972,17851417,135135,5221626,15427292
1983-12-18,1984,79,W,3,3+,130979,5429951,17851417,125934,5347560,15427292
1983-12-19,1984,80,W,3,3+,122965,5552916,17851417,118877,5466437,15427292
1983-12-20,1984,81,W,3,3+,116975,5669891,17851417,111468,5577905,15427292
1983-12-21,1984,82,W,3,3+,111110,5781001,17851417,107648,5685553,15427292
1983-12-22,1984,83,W,3,3+,106016,5887017,17851417,106569,5792122,15427292
1983-12-23,1984,84,W,3,3+,103701,5990718,17851417,107101,5899223,15427292
1983-12-24,1984,85,W,3,3+,116571,6107289,17851417,123889,6023112,15427292
1983-12-25,1984,86,W,3,3+,170895,6278184,17851417,182625,6205737,15427292
1983-12-26,1984,87,W,3,3+,229182,6507366,17851417,240821,6446558,15427292
1983-12-27,1984,88,W,3,3+,314344,6821710,17851417,322793,6769351,15427292
1983-12-28,1984,89,W,3,3+,351622,7173332,17851417,356087,7125438,15427292
1983-12-29,1984,90,W,3,3+,337157,7510489,17851417,337653,7463091,15427292
1983-12-30,1984,91,W,3,3+,297625,7808114,17851417,296585,7759676,15427292
1983-12-31,1984,92,W,3,3+,258377,8066491,17851417,257393,8017069,15427292
1984-01-01,1984,93,W,3,3+,230732,8297223,17851417,228366,8245435,15427292
1984-01-02,1984,94,W,3,3+,203327,8500550,17851417,201010,8446445,15427292
1984-01-03,1984,95,W,3,3+,181861,8682411,17851417,179590,8626035,15427292
1984-01-04,1984,96,W,3,3+,159800,8842211,17851417,156570,8782605,15427292
1984-01-05,1984,97,W,3,3+,145865,8988076,17851417,143271,8925876,15427292
1984-01-06,1984,98,W,3,3+,138498,9126574,17851417,135713,9061589,15427292
1984-01-07,1984,99,W,3,3+,136435,9263009,17851417,132394,9193983,15427292
1984-01-08,1984,100,W,3,3+,127423,9390432,17851417,124709,9318692,15427292
1984-01-09,1984,101,W,3,3+,120871,9511303,17851417,118234,9436926,15427292
1984-01-10,1984,102,W,3,3+,114570,9625873,17851417,111094,9548020,15427292
1984-01-11,1984,103,W,3,3+,110194,9736067,17851417,106654,9654674,15427292
1984-01-12,1984,104,W,3,3+,106203,9842270,17851417,102946,9757620,15427292
1984-01-13,1984,105,W,3,3+,101814,9944084,17851417,98697,9856317,15427292
1984-01-14,1984,106,W,3,3+,96218,10040302,17851417,93128,9949445,15427292
1984-01-15,1984,107,W,3,3+,92181,10132483,17851417,89710,10039155,15427292
1984-01-16,1984,108,W,3,3+,90265,10222748,17851417,89706,10128861,15427292
1984-01-17,1984,109,W,3,3+,88355,10311103,17851417,86278,10215139,15427292
1984-01-18,1984,110,W,3,3+,86597,10397700,17851417,86037,10301176,15427292
1984-01-19,1984,111,W,3,3+,85036,10482736,17851417,84548,10385724,15427292
1984-01-20,1984,112,W,3,3+,82393,10565129,17851417,81241,10466965,15427292
1984-01-21,1984,113,W,3,3+,78266,10643395,17851417,75991,10542956,15427292
1984-01-22,1984,114,W,3,3+,75101,10718496,17851417,71829,10614785,15427292
1984-01-23,1984,115,W,3,3+,72489,10790985,17851417,70241,10685026,15427292
1984-01-24,1984,116,W,3,3+,69991,10860976,17851417,67735,10752761,15427292
1984-01-25,1984,117,W,3,3+,67581,10928557,17851417,65407,10818168,15427292
1984-01-26,1984,118,W,3,3+,64591,10993148,17851417,61971,10880139,15427292
1984-01-27,1984,119,W,3,3+,60896,11054044,17851417,58231,10938370,15427292
1984-01-28,1984,120,W,3,3+,57671,11111715,17851417,55075,10993445,15427292
1984-01-29,1984,121,W,3,3+,55246,11166961,17851417,52655,11046100,15427292
1984-01-30,1984,122,W,3,3+,53833,11220794,17851417,51229,11097329,15427292
1984-01-31,1984,123,W,3,3+,52047,11272841,17851417,47820,11145149,15427292
1984-02-01,1984,124,W,3,3+,49598,11322439,17851417,44986,11190135,15427292
1984-02-02,1984,125,W,3,3+,47404,11369843,17851417,41526,11231661,15427292
1984-02-03,1984,126,W,3,3+,45965,11415808,17851417,41437,11273098,15427292
1984-02-04,1984,127,W,3,3+,43939,11459747,17851417,39278,11312376,15427292
1984-02-05,1984,128,W,3,3+,40887,11500634,17851417,35599,11347975,15427292
1984-02-06,1984,129,W,3,3+,38593,11539227,17851417,32956,11380931,15427292
1984-02-07,1984,130,W,3,3+,37092,11576319,17851417,31718,11412649,15427292
1984-02-08,1984,131,W,3,3+,35868,11612187,17851417,32095,11444744,15427292
1984-02-09,1984,132,W,3,3+,34868,11647055,17851417,28771,11473515,15427292
1984-02-10,1984,133,W,3,3+,35003,11682058,17851417,29295,11502810,15427292
1984-02-11,1984,134,W,3,3+,34583,11716641,17851417,29112,11531922,15427292
1984-02-12,1984,135,W,3,3+,34897,11751538,17851417,29266,11561188,15427292
1984-02-13,1984,136,W,3,3+,35163,11786701,17851417,28450,11589638,15427292
1984-02-14,1984,137,W,3,3+,39994,11826695,17851417,36117,11625755,15427292
1984-02-15,1984,138,W,3,3+,48903,11875598,17851417,43489,11669244,15427292
1984-02-16,1984,139,W,3,3+,56728,11932326,17851417,54961,11724205,15427292
1984-02-17,1984,140,W,3,3+,59332,11991658,17851417,56220,11780425,15427292
1984-02-18,1984,141,W,3,3+,60370,12052028,17851417,57058,11837483,15427292
1984-02-19,1984,142,W,3,3+,57821,12109849,17851417,51305,11888788,15427292
1984-02-20,1984,143,W,3,3+,54187,12164036,17851417,49320,11938108,15427292
1984-02-21,1984,144,W,3,3+,55441,12219477,17851417,51031,11989139,15427292
1984-02-22,1984,145,W,3,3+,56565,12276042,17851417,52138,12041277,15427292
1984-02-23,1984,146,W,3,3+,56516,12332558,17851417,52830,12094107,15427292
1984-02-24,1984,147,W,3,3+,54612,12387170,17851417,48850,12142957,15427292
1984-02-25,1984,148,W,3,3+,51731,12438901,17851417,45647,12188604,15427292
1984-02-26,1984,149,W,3,3+,49575,12488476,17851417,41625,12230229,15427292
1984-02-27,1984,150,W,3,3+,48711,12537187,17851417,40756,12270985,15427292
1984-02-28,1984,151,W,3,3+,47824,12585011,17851417,40233,12311218,15427292
1984-02-29,1984,152,W,3,3+,45937,12630948,17851417,37879,12349097,15427292
1984-03-01,1984,153,W,3,3+,44524,12675472,17851417,38047,12387144,15427292
1984-03-02,1984,154,W,3,3+,43410,12718882,17851417,34599,12421743,15427292
1984-03-03,1984,155,W,3,3+,42361,12761243,17851417,34734,12456477,15427292
1984-03-04,1984,156,W,3,3+,42251,12803494,17851417,32665,12489142,15427292
1984-03-05,1984,157,W,3,3+,40913,12844407,17851417,31111,12520253,15427292
1984-03-06,1984,158,W,3,3+,38384,12882791,17851417,30180,12550433,15427292
1984-03-07,1984,159,W,3,3+,36862,12919653,17851417,29066,12579499,15427292
1984-03-08,1984,160,W,3,3+,36109,12955762,17851417,28318,12607817,15427292
1984-03-09,1984,161,W,3,3+,35326,12991088,17851417,27508,12635325,15427292
1984-03-10,1984,162,W,3,3+,34676,13025764,17851417,26858,12662183,15427292
1984-03-11,1984,163,W,3,3+,34079,13059843,17851417,26192,12688375,15427292
1984-03-12,1984,164,W,3,3+,33702,13093545,17851417,26401,12714776,15427292
1984-03-13,1984,165,W,3,3+,33131,13126676,17851417,23026,12737802,15427292
1984-03-14,1984,166,W,3,3+,34976,13161652,17851417,30251,12768053,15427292
1984-03-15,1984,167,W,3,3+,37569,13199221,17851417,34593,12802646,15427292
1984-03-16,1984,168,W,3,3+,42985,13242206,17851417,39646,12842292,15427292
1984-03-17,1984,169,W,3,3+,48226,13290432,17851417,46235,12888527,15427292
1984-03-18,1984,170,W,3,3+,51521,13341953,17851417,49633,12938160,15427292
1984-03-19,1984,171,W,3,3+,53129,13395082,17851417,48000,12986160,15427292
1984-03-20,1984,172,W,3,3+,50660,13445742,17851417,44586,13030746,15427292
1984-03-21,1984,173,W,3,3+,49405,13495147,17851417,44033,13074779,15427292
1984-03-22,1984,174,W,3,3+,48336,13543483,17851417,40956,13115735,15427292
1984-03-23,1984,175,W,3,3+,47514,13590997,17851417,39477,13155212,15427292
1984-03-24,1984,176,W,3,3+,46312,13637309,17851417,37806,13193018,15427292
1984-03-25,1984,177,W,3,3+,45411,13682720,17851417,37383,13230401,15427292
1984-03-26,1984,178,W,3,3+,44660,13727380,17851417,35985,13266386,15427292
1984-03-27,1984,179,W,3,3+,44525,13771905,17851417,36003,13302389,15427292
1984-03-28,1984,180,W,3,3+,43382,13815287,17851417,34462,13336851,15427292
1984-03-29,1984,181,W,3,3+,41890,13857177,17851417,33259,13370110,15427292
1984-03-30,1984,182,W,3,3+,40146,13897323,17851417,31174,13401284,15427292
1984-03-31,1984,183,W,3,3+,40197,13937520,17851417,30194,13431478,15427292
1984-04-01,1984,184,W,3,3+,37929,13975449,17851417,29295,13460773,15427292
1984-04-02,1984,185,W,3,3+,36335,14011784,17851417,27006,13487779,15427292
1984-04-03,1984,186,W,3,3+,34408,14046192,17851417,26572,13514351,15427292
1984-04-04,1984,187,W,3,3+,31596,14077788,17851417,23754,13538105,15427292
1984-04-05,1984,188,W,3,3+,28907,14106695,17851417,20001,13558106,15427292
1984-04-06,1984,189,W,3,3+,27657,14134352,17851417,18970,13577076,15427292
1984-04-07,1984,190,W,3,3+,26135,14160487,17851417,17698,13594774,15427292
1984-04-08,1984,191,W,3,3+,25040,14185527,17851417,13681,13608455,15427292
1984-04-09,1984,192,W,3,3+,25830,14211357,17851417,15242,13623697,15427292
1984-04-10,1984,193,W,3,3+,26373,14237730,17851417,17857,13641554,15427292
1984-04-11,1984,194,W,3,3+,26825,14264555,17851417,20053,13661607,15427292
1984-04-12,1984,195,W,3,3+,26622,14291177,17851417,20088,13681695,15427292
1984-04-13,1984,196,W,3,3+,26226,14317403,17851417,17868,13699563,15427292
1984-04-14,1984,197,W,3,3+,25086,14342489,17851417,15964,13715527,15427292
1984-04-15,1984,198,W,3,3+,23710,14366199,17851417,13509,13729036,15427292
1984-04-16,1984,199,W,3,3+,23114,14389313,17851417,13290,13742326,15427292
1984-04-17,1984,200,W,3,3+,21856,14411169,17851417,11755,13754081,15427292
1984-04-18,1984,201,W,3,3+,20743,14431912,17851417,11011,13765092,15427292
1984-04-19,1984,202,W,3,3+,20194,14452106,17851417,12907,13777999,15427292
1984-04-20,1984,203,W,3,3+,21005,14473111,17851417,14757,13792756,15427292
1984-04-21,1984,204,W,3,3+,21706,14494817,17851417,14810,13807566,15427292
1984-04-22,1984,205,W,3,3+,21418,14516235,17851417,13303,13820869,15427292
1984-04-23,1984,206,W,3,3+,20331,14536566,17851417,11127,13831996,15427292
1984-04-24,1984,207,W,3,3+,19091,14555657,17851417,9223,13841219,15427292
1984-04-25,1984,208,W,3,3+,17300,14572957,17851417,6891,13848110,15427292
1984-04-26,1984,209,W,3,3+,15979,14588936,17851417,6096,13854206,15427292
1984-04-27,1984,210,W,3,3+,15208,14604144,17851417,4936,13859142,15427292
1984-04-28,1984,211,W,3,3+,15288,14619432,17851417,5034,13864176,15427292
1984-04-29,1984,212,W,3,3+,15527,14634959,17851417,2945,13867121,15427292
1984-04-30,1984,213,W,3,3+,15974,14650933,17851417,3471,13870592,15427292
1984-05-01,1984,214,W,3,3+,16073,14667006,17851417,4824,13875416,15427292
1984-05-02,1984,215,W,3,3+,16044,14683050,17851417,5259,13880675,15427292
1984-05-03,1984,216,W,3,3+,16634,14699684,17851417,6439,13887114,15427292
1984-05-04,1984,217,W,3,3+,18408,14718092,17851417,8875,13895989,15427292
1984-05-05,1984,218,W,3,3+,20356,14738448,17851417,10759,13906748,15427292
1984-05-06,1984,219,W,3,3+,21131,14759579,17851417,12620,13919368,15427292
1984-05-07,1984,220,W,3,3+,21369,14780948,17851417,13360,13932728,15427292
1984-05-08,1984,221,W,3,3+,20725,14801673,17851417,12468,13945196,15427292
1984-05-09,1984,222,W,3,3+,20162,14821835,17851417,12273,13957469,15427292
1984-05-10,1984,223,W,3,3+,19557,14841392,17851417,11737,13969206,15427292
1984-05-11,1984,224,W,3,3+,19519,14860911,17851417,11568,13980774,15427292
1984-05-12,1984,225,W,3,3+,19538,14880449,17851417,11826,13992600,15427292
1984-05-13,1984,226,W,3,3+,20004,14900453,17851417,11628,14004228,15427292
1984-05-14,1984,227,W,3,3+,20833,14921286,17851417,12494,14016722,15427292
1984-05-15,1984,228,W,3,3+,21667,14942953,17851417,13727,14030449,15427292
1984-05-16,1984,229,W,3,3+,21676,14964629,17851417,13373,14043822,15427292
1984-05-17,1984,230,W,3,3+,22446,14987075,17851417,14025,14057847,15427292
1984-05-18,1984,231,W,3,3+,21745,15008820,17851417,14050,14071897,15427292
1984-05-19,1984,232,W,3,3+,21277,15030097,17851417,13298,14085195,15427292
1984-05-20,1984,233,W,3,3+,21175,15051272,17851417,15865,14101060,15427292
1984-05-21,1984,234,W,3,3+,20933,15072205,17851417,15622,14116682,15427292
1984-05-22,1984,235,W,3,3+,20190,15092395,17851417,14836,14131518,15427292
1984-05-23,1984,236,W,3,3+,19145,15111540,17851417,10594,14142112,15427292
1984-05-24,1984,237,W,3,3+,18898,15130438,17851417,9953,14152065,15427292
1984-05-25,1984,238,W,3,3+,18413,15148851,17851417,9856,14161921,15427292
1984-05-26,1984,239,W,3,3+,18436,15167287,17851417,10343,14172264,15427292
1984-05-27,1984,240,W,3,3+,18588,15185875,17851417,7423,14179687,15427292
1984-05-28,1984,241,W,3,3+,18307,15204182,17851417,8203,14187890,15427292
1984-05-29,1984,242,W,3,3+,18188,15222370,17851417,8117,14196007,15427292
1984-05-30,1984,243,W,3,3+,17627,15239997,17851417,9298,14205305,15427292
1984-05-31,1984,244,W,3,3+,17486,15257483,17851417,9163,14214468,15427292
1984-06-01,1984,245,W,3,3+,17414,15274897,17851417,9775,14224243,15427292
1984-06-02,1984,246,W,3,3+,17061,15291958,17851417,7769,14232012,15427292
1984-06-03,1984,247,W,3,3+,17002,15308960,17851417,5899,14237911,15427292
1984-06-04,1984,248,W,3,3+,17350,15326310,17851417,6775,14244686,15427292
1984-06-05,1984,249,W,3,3+,16950,15343260,17851417,8697,14253383,15427292
1984-06-06,1984,250,W,3,3+,17149,15360409,17851417,7865,14261248,15427292
1984-06-07,1984,251,W,3,3+,18248,15378657,17851417,9076,14270324,15427292
1984-06-08,1984,252,W,3,3+,18863,15397520,17851417,9337,14279661,15427292
1984-06-09,1984,253,W,3,3+,19605,15417125,17851417,10038,14289699,15427292
1984-06-10,1984,254,W,3,3+,20391,15437516,17851417,7868,14297567,15427292
1984-06-11,1984,255,W,3,3+,19685,15457201,17851417,9570,14307137,15427292
1984-06-12,1984,256,W,3,3+,18372,15475573,17851417,8431,14315568,15427292
1984-06-13,1984,257,W,3,3+,16960,15492533,17851417,7535,14323103,15427292
1984-06-14,1984,258,W,3,3+,15904,15508437,17851417,6368,14329471,15427292
1984-06-15,1984,259,W,3,3+,16262,15524699,17851417,6858,14336329,15427292
1984-06-16,1984,260,W,3,3+,17320,15542019,17851417,8058,14344387,15427292
1984-06-17,1984,261,W,3,3+,17887,15559906,17851417,8205,14352592,15427292
1984-06-18,1984,262,W,3,3+,18459,15578365,17851417,8221,14360813,15427292
1984-06-19,1984,263,W,3,3+,17724,15596089,17851417,7362,14368175,15427292
1984-06-20,1984,264,W,3,3+,17330,15613419,17851417,7996,14376171,15427292
1984-06-21,1984,265,W,3,3+,17480,15630899,17851417,7767,14383938,15427292
1984-06-22,1984,266,W,3,3+,16933,15647832,17851417,6995,14390933,15427292
1984-06-23,1984,267,W,3,3+,17565,15665397,17851417,7639,14398572,15427292
1984-06-24,1984,268,W,3,3+,18166,15683563,17851417,6204,14404776,15427292
1984-06-25,1984,269,W,3,3+,18424,15701987,17851417,7388,14412164,15427292
1984-06-26,1984,270,W,3,3+,17877,15719864,17851417,7143,14419307,15427292
1984-06-27,1984,271,W,3,3+,17885,15737749,17851417,7100,14426407,15427292
1984-06-28,1984,272,W,3,3+,18102,15755851,17851417,7296,14433703,15427292
1984-06-29,1984,273,W,3,3+,19459,15775310,17851417,8751,14442454,15427292
1984-06-30,1984,274,W,3,3+,20672,15795982,17851417,9764,14452218,15427292
1984-07-01,1984,275,W,3,3+,21846,15817828,17851417,7532,14459750,15427292
1984-07-02,1984,276,W,3,3+,22161,15839989,17851417,7872,14467622,15427292
1984-07-03,1984,277,W,3,3+,22959,15862948,17851417,9067,14476689,15427292
1984-07-04,1984,278,W,3,3+,23506,15886454,17851417,9903,14486592,15427292
1984-07-05,1984,279,W,3,3+,23290,15909744,17851417,10244,14496836,15427292
1984-07-06,1984,280,W,3,3+,23165,15932909,17851417,10811,14507647,15427292
1984-07-07,1984,281,W,3,3+,23365,15956274,17851417,10396,14518043,15427292
1984-07-08,1984,282,W,3,3+,23610,15979884,17851417,8615,14526658,15427292
1984-07-09,1984,283,W,3,3+,23670,16003554,17851417,9835,14536493,15427292
1984-07-10,1984,284,W,3,3+,23622,16027176,17851417,10075,14546568,15427292
1984-07-11,1984,285,W,3,3+,23653,16050829,17851417,9818,14556386,15427292
1984-07-12,1984,286,W,3,3+,23500,16074329,17851417,9831,14566217,15427292
1984-07-13,1984,287,W,3,3+,23484,16097813,17851417,9813,14576030,15427292
1984-07-14,1984,288,W,3,3+,23833,16121646,17851417,10182,14586212,15427292
1984-07-15,1984,289,W,3,3+,24064,16145710,17851417,9877,14596089,15427292
1984-07-16,1984,290,W,3,3+,24417,16170127,17851417,10046,14606135,15427292
1984-07-17,1984,291,W,3,3+,24304,16194431,17851417,9967,14616102,15427292
1984-07-18,1984,292,W,3,3+,24460,16218891,17851417,10394,14626496,15427292
1984-07-19,1984,293,W,3,3+,24888,16243779,17851417,10511,14637007,15427292
1984-07-20,1984,294,W,3,3+,24749,16268528,17851417,10614,14647621,15427292
1984-07-21,1984,295,W,3,3+,24479,16293007,17851417,10526,14658147,15427292
1984-07-22,1984,296,W,3,3+,25291,16318298,17851417,10927,14669074,15427292
1984-07-23,1984,297,W,3,3+,25583,16343881,17851417,11212,14680286,15427292
1984-07-24,1984,298,W,3,3+,25094,16368975,17851417,10792,14691078,15427292
1984-07-25,1984,299,W,3,3+,25170,16394145,17851417,11171,14702249,15427292
1984-07-26,1984,300,W,3,3+,23893,16418038,17851417,10108,14712357,15427292
1984-07-27,1984,301,W,3,3+,25062,16443100,17851417,11270,14723627,15427292
1984-07-28,1984,302,W,3,3+,24595,16467695,17851417,10754,14734381,15427292
1984-07-29,1984,303,W,3,3+,24869,16492564,17851417,10709,14745090,15427292
1984-07-30,1984,304,W,3,3+,24722,16517286,17851417,10537,14755627,15427292
1984-07-31,1984,305,W,3,3+,24584,16541870,17851417,10541,14766168,15427292
1984-08-01,1984,306,W,3,3+,24397,16566267,17851417,10022,14776190,15427292
1984-08-02,1984,307,W,3,3+,23667,16589934,17851417,9569,14785759,15427292
1984-08-03,1984,308,W,3,3+,23399,16613333,17851417,9379,14795138,15427292
1984-08-04,1984,309,W,3,3+,23134,16636467,17851417,8777,14803915,15427292
1984-08-05,1984,310,W,3,3+,22768,16659235,17851417,8458,14812373,15427292
1984-08-06,1984,311,W,3,3+,23001,16682236,17851417,8451,14820824,15427292
1984-08-07,1984,312,W,3,3+,22972,16705208,17851417,8535,14829359,15427292
1984-08-08,1984,313,W,3,3+,22412,16727620,17851417,7958,14837317,15427292
1984-08-09,1984,314,W,3,3+,22086,16749706,17851417,7473,14844790,15427292
1984-08-10,1984,315,W,3,3+,21620,16771326,17851417,7611,14852401,15427292
1984-08-11,1984,316,W,3,3+,21289,16792615,17851417,6917,14859318,15427292
1984-08-12,1984,317,W,3,3+,20607,16813222,17851417,6285,14865603,15427292
1984-08-13,1984,318,W,3,3+,19879,16833101,17851417,5580,14871183,15427292
1984-08-14,1984,319,W,3,3+,19353,16852454,17851417,5077,14876260,15427292
1984-08-15,1984,320,W,3,3+,19148,16871602,17851417,4874,14881134,15427292
1984-08-16,1984,321,W,3,3+,19391,16890993,17851417,5413,14886547,15427292
1984-08-17,1984,322,W,3,3+,19443,16910436,17851417,6047,14892594,15427292
1984-08-18,1984,323,W,3,3+,19695,16930131,17851417,6026,14898620,15427292
1984-08-19,1984,324,W,3,3+,19996,16950127,17851417,6553,14905173,15427292
1984-08-20,1984,325,W,3,3+,20538,16970665,17851417,6940,14912113,15427292
1984-08-21,1984,326,W,3,3+,20679,16991344,17851417,7194,14919307,15427292
1984-08-22,1984,327,W,3,3+,21203,17012547,17851417,8408,14927715,15427292
1984-08-23,1984,328,W,3,3+,21478,17034025,17851417,8566,14936281,15427292
1984-08-24,1984,329,W,3,3+,21565,17055590,17851417,8606,14944887,15427292
1984-08-25,1984,330,W,3,3+,21847,17077437,17851417,8693,14953580,15427292
1984-08-26,1984,331,W,3,3+,22018,17099455,17851417,9647,14963227,15427292
1984-08-27,1984,332,W,3,3+,22911,17122366,17851417,9936,14973163,15427292
1984-08-28,1984,333,W,3,3+,22847,17145213,17851417,10785,14983948,15427292
1984-08-29,1984,334,W,3,3+,22179,17167392,17851417,11731,14995679,15427292
1984-08-30,1984,335,W,3,3+,21596,17188988,17851417,11829,15007508,15427292
1984-08-31,1984,336,W,3,3+,21411,17210399,17851417,12197,15019705,15427292
1984-09-01,1984,337,W,3,3+,21301,17231700,17851417,13834,15033539,15427292
1984-09-02,1984,338,W,3,3+,21716,17253416,17851417,13085,15046624,15427292
1984-09-03,1984,339,W,3,3+,22149,17275565,17851417,14929,15061553,15427292
1984-09-04,1984,340,W,3,3+,21991,17297556,17851417,14735,15076288,15427292
1984-09-05,1984,341,W,3,3+,21543,17319099,17851417,14639,15090927,15427292
1984-09-06,1984,342,W,3,3+,20891,17339990,17851417,11542,15102469,15427292
1984-09-07,1984,343,W,3,3+,21080,17361070,17851417,11812,15114281,15427292
1984-09-08,1984,344,W,3,3+,21941,17383011,17851417,12950,15127231,15427292
1984-09-09,1984,345,W,3,3+,22133,17405144,17851417,15255,15142486,15427292
1984-09-10,1984,346,W,3,3+,21153,17426297,17851417,12612,15155098,15427292
1984-09-11,1984,347,W,3,3+,21366,17447663,17851417,13349,15168447,15427292
1984-09-12,1984,348,W,3,3+,21836,17469499,17851417,13446,15181893,15427292
1984-09-13,1984,349,W,3,3+,22399,17491898,17851417,14908,15196801,15427292
1984-09-14,1984,350,W,3,3+,22403,17514301,17851417,13330,15210131,15427292
1984-09-15,1984,351,W,3,3+,22347,17536648,17851417,13918,15224049,15427292
1984-09-16,1984,352,W,3,3+,22430,17559078,17851417,13220,15237269,15427292
1984-09-17,1984,353,W,3,3+,21879,17580957,17851417,14547,15251816,15427292
1984-09-18,1984,354,W,3,3+,22446,17603403,17851417,14620,15266436,15427292
1984-09-19,1984,355,W,3,3+,23096,17626499,17851417,15918,15282354,15427292
1984-09-20,1984,356,W,3,3+,23551,17650050,17851417,16178,15298532,15427292
1984-09-21,1984,357,W,3,3+,23643,17673693,17851417,17171,15315703,15427292
1984-09-22,1984,358,W,3,3+,22688,17696381,17851417,15589,15331292,15427292
1984-09-23,1984,359,W,3,3+,22061,17718442,17851417,15025,15346317,15427292
1984-09-24,1984,360,W,3,3+,21352,17739794,17851417,14637,15360954,15427292
1984-09-25,1984,361,W,3,3+,19720,17759514,17851417,12519,15373473,15427292
1984-09-26,1984,362,W,3,3+,18724,17778238,17851417,11387,15384860,15427292
1984-09-27,1984,363,W,3,3+,18556,17796794,17851417,11324,15396184,15427292
1984-09-28,1984,364,W,3,3+,18231,17815025,17851417,10756,15406940,15427292
1984-09-29,1984,365,W,3,3+,17899,17832924,17851417,10581,15417521,15427292
1984-09-30,1984,366,W,3,3+,18493,17851417,17851417,9771,15427292,15427292
1984-10-01,1985,1,N,1,1,20497,20497,7547457,12963,12963,4238098
1984-10-02,1985,2,N,1,1,20226,40723,7547457,13064,26027,4238098
1984-10-03,1985,3,N,1,1,19583,60306,7547457,12816,38843,4238098
1984-10-04,1985,4,N,1,1,18973,79279,7547457,12057,50900,4238098
1984-10-05,1985,5,N,1,1,18563,97842,7547457,11846,62746,4238098
1984-10-06,1985,6,N,1,1,18499,116341,7547457,11884,74630,4238098
1984-10-07,1985,7,N,1,1,19120,135461,7547457,12293,86923,4238098
1984-10-08,1985,8,N,1,1,18918,154379,7547457,11730,98653,4238098
1984-10-09,1985,9,N,1,1,19067,173446,7547457,12196,110849,4238098
1984-10-10,1985,10,N,1,1,18526,191972,7547457,12225,123074,4238098
1984-10-11,1985,11,N,1,1,18753,210725,7547457,12449,135523,4238098
1984-10-12,1985,12,N,1,1,17918,228643,7547457,9809,145332,4238098
1984-10-13,1985,13,N,1,1,18163,246806,7547457,9989,155321,4238098
1984-10-14,1985,14,N,1,1,18881,265687,7547457,8126,163447,4238098
1984-10-15,1985,15,N,1,1,18649,284336,7547457,10716,174163,4238098
1984-10-16,1985,16,N,1,1,17576,301912,7547457,11648,185811,4238098
1984-10-17,1985,17,N,1,1,19251,321163,7547457,20091,205902,4238098
1984-10-18,1985,18,N,1,1,19090,340253,7547457,20128,226030,4238098
1984-10-19,1985,19,N,1,1,18906,359159,7547457,18071,244101,4238098
1984-10-20,1985,20,N,1,1,18803,377962,7547457,17741,261842,4238098
1984-10-21,1985,21,N,1,1,17918,395880,7547457,16814,278656,4238098
1984-10-22,1985,22,N,1,1,17321,413201,7547457,10518,289174,4238098
1984-10-23,1985,23,N,1,1,17051,430252,7547457,11202,300376,4238098
1984-10-24,1985,24,N,1,1,16449,446701,7547457,10601,310977,4238098
1984-10-25,1985,25,N,1,1,15779,462480,7547457,9948,320925,4238098
1984-10-26,1985,26,N,1,1,15230,477710,7547457,8440,329365,4238098
1984-10-27,1985,27,N,1,1,15864,493574,7547457,6828,336193,4238098
1984-10-28,1985,28,N,1,1,16017,509591,7547457,4826,341019,4238098
1984-10-29,1985,29,N,1,1,16614,526205,7547457,7916,348935,4238098
1984-10-30,1985,30,N,1,1,16690,542895,7547457,9232,358167,4238098
1984-10-31,1985,31,N,1,1,16861,559756,7547457,10712,368879,4238098
1984-11-01,1985,32,N,1,1,17071,576827,7547457,10533,379412,4238098
1984-11-02,1985,33,N,1,1,16558,593385,7547457,7713,387125,4238098
1984-11-03,1985,34,N,1,1,17596,610981,7547457,9682,396807,4238098
1984-11-04,1985,35,N,1,1,17448,628429,7547457,7188,403995,4238098
1984-11-05,1985,36,N,1,1,17736,646165,7547457,7789,411784,4238098
1984-11-06,1985,37,N,1,1,18076,664241,7547457,8105,419889,4238098
1984-11-07,1985,38,N,1,1,17972,682213,7547457,8507,428396,4238098
1984-11-08,1985,39,N,1,1,18432,700645,7547457,14477,442873,4238098
1984-11-09,1985,40,N,1,1,19681,720326,7547457,16562,459435,4238098
1984-11-10,1985,41,N,1,1,19666,739992,7547457,16733,476168,4238098
1984-11-11,1985,42,N,1,1,20528,760520,7547457,18463,494631,4238098
1984-11-12,1985,43,N,1,1,21109,781629,7547457,19372,514003,4238098
1984-11-13,1985,44,N,1,1,26843,808472,7547457,23170,537173,4238098
1984-11-14,1985,45,N,1,1,33972,842444,7547457,30578,567751,4238098
1984-11-15,1985,46,N,1,1,39646,882090,7547457,34432,602183,4238098
1984-11-16,1985,47,N,1,1,40762,922852,7547457,38472,640655,4238098
1984-11-17,1985,48,N,1,1,40010,962862,7547457,37998,678653,4238098
1984-11-18,1985,49,N,1,1,40585,1003447,7547457,32794,711447,4238098
1984-11-19,1985,50,N,1,1,41338,1044785,7547457,33508,744955,4238098
1984-11-20,1985,51,N,1,1,40534,1085319,7547457,32840,777795,4238098
1984-11-21,1985,52,N,1,1,39269,1124588,7547457,31486,809281,4238098
1984-11-22,1985,53,N,1,1,38773,1163361,7547457,30287,839568,4238098
1984-11-23,1985,54,N,1,1,38935,1202296,7547457,30290,869858,4238098
1984-11-24,1985,55,N,1,1,38326,1240622,7547457,32538,902396,4238098
1984-11-25,1985,56,N,1,1,41010,1281632,7547457,35471,937867,4238098
1984-11-26,1985,57,N,1,1,44674,1326306,7547457,39130,976997,4238098
1984-11-27,1985,58,N,1,1,44211,1370517,7547457,37690,1014687,4238098
1984-11-28,1985,59,N,1,1,46235,1416752,7547457,44643,1059330,4238098
1984-11-29,1985,60,N,1,1,47741,1464493,7547457,42898,1102228,4238098
1984-11-30,1985,61,N,1,1,49820,1514313,7547457,45233,1147461,4238098
1984-12-01,1985,62,N,1,1,48346,1562659,7547457,42164,1189625,4238098
1984-12-02,1985,63,N,1,1,45206,1607865,7547457,37491,1227116,4238098
1984-12-03,1985,64,N,1,1,44295,1652160,7547457,35747,1262863,4238098
1984-12-04,1985,65,N,1,1,43949,1696109,7547457,36721,1299584,4238098
1984-12-05,1985,66,N,1,1,46817,1742926,7547457,39899,1339483,4238098
1984-12-06,1985,67,N,1,1,47911,1790837,7547457,41140,1380623,4238098
1984-12-07,1985,68,N,1,1,47402,1838239,7547457,40125,1420748,4238098
1984-12-08,1985,69,N,1,1,45927,1884166,7547457,37841,1458589,4238098
1984-12-09,1985,70,N,1,1,43678,1927844,7547457,34819,1493408,4238098
1984-12-10,1985,71,N,1,1,42165,1970009,7547457,33605,1527013,4238098
1984-12-11,1985,72,N,1,1,42005,2012014,7547457,35354,1562367,4238098
1984-12-12,1985,73,N,1,1,44560,2056574,7547457,36183,1598550,4238098
1984-12-13,1985,74,N,1,1,46849,2103423,7547457,37047,1635597,4238098
1984-12-14,1985,75,N,1,1,46430,2149853,7547457,35781,1671378,4238098
1984-12-15,1985,76,N,1,1,44783,2194636,7547457,33752,1705130,4238098
1984-12-16,1985,77,N,1,1,44937,2239573,7547457,37244,1742374,4238098
1984-12-17,1985,78,N,1,1,43124,2282697,7547457,35317,1777691,4238098
1984-12-18,1985,79,N,1,1,40970,2323667,7547457,32721,1810412,4238098
1984-12-19,1985,80,N,1,1,40107,2363774,7547457,31865,1842277,4238098
1984-12-20,1985,81,N,1,1,39074,2402848,7547457,29618,1871895,4238098
1984-12-21,1985,82,N,1,1,37965,2440813,7547457,25147,1897042,4238098
1984-12-22,1985,83,N,1,1,36187,2477000,7547457,24133,1921175,4238098
1984-12-23,1985,84,N,1,1,34320,2511320,7547457,21705,1942880,4238098
1984-12-24,1985,85,N,1,1,32732,2544052,7547457,20256,1963136,4238098
1984-12-25,1985,86,N,1,1,30581,2574633,7547457,17968,1981104,4238098
1984-12-26,1985,87,N,1,1,29961,2604594,7547457,21019,2002123,4238098
1984-12-27,1985,88,N,1,1,28935,2633529,7547457,23109,2025232,4238098
1984-12-28,1985,89,N,1,1,29278,2662807,7547457,22671,2047903,4238098
1984-12-29,1985,90,N,1,1,28671,2691478,7547457,22963,2070866,4238098
1984-12-30,1985,91,N,1,1,27774,2719252,7547457,20328,2091194,4238098
1984-12-31,1985,92,N,1,1,26796,2746048,7547457,19323,2110517,4238098
1985-01-01,1985,93,N,1,1,26119,2772167,7547457,19402,2129919,4238098
1985-01-02,1985,94,N,1,1,26098,2798265,7547457,19747,2149666,4238098
1985-01-03,1985,95,N,1,1,25324,2823589,7547457,17928,2167594,4238098
1985-01-04,1985,96,N,1,1,25185,2848774,7547457,16888,2184482,4238098
1985-01-05,1985,97,N,1,1,24078,2872852,7547457,15884,2200366,4238098
1985-01-06,1985,98,N,1,1,22544,2895396,7547457,14963,2215329,4238098
1985-01-07,1985,99,N,1,1,21659,2917055,7547457,14422,2229751,4238098
1985-01-08,1985,100,N,1,1,22165,2939220,7547457,17886,2247637,4238098
1985-01-09,1985,101,N,1,1,22728,2961948,7547457,18171,2265808,4238098
1985-01-10,1985,102,N,1,1,22987,2984935,7547457,20647,2286455,4238098
1985-01-11,1985,103,N,1,1,22833,3007768,7547457,19889,2306344,4238098
1985-01-12,1985,104,N,1,1,22583,3030351,7547457,19383,2325727,4238098
1985-01-13,1985,105,N,1,1,22040,3052391,7547457,16480,2342207,4238098
1985-01-14,1985,106,N,1,1,21630,3074021,7547457,16245,2358452,4238098
1985-01-15,1985,107,N,1,1,21183,3095204,7547457,14478,2372930,4238098
1985-01-16,1985,108,N,1,1,21747,3116951,7547457,14979,2387909,4238098
1985-01-17,1985,109,N,1,1,21298,3138249,7547457,15091,2403000,4238098
1985-01-18,1985,110,N,1,1,20772,3159021,7547457,14091,2417091,4238098
1985-01-19,1985,111,N,1,1,20866,3179887,7547457,13696,2430787,4238098
1985-01-20,1985,112,N,1,1,20377,3200264,7547457,12827,2443614,4238098
1985-01-21,1985,113,N,1,1,19754,3220018,7547457,13730,2457344,4238098
1985-01-22,1985,114,N,1,1,19321,3239339,7547457,13457,2470801,4238098
1985-01-23,1985,115,N,1,1,19502,3258841,7547457,14309,2485110,4238098
1985-01-24,1985,116,N,1,1,19380,3278221,7547457,13459,2498569,4238098
1985-01-25,1985,117,N,1,1,19303,3297524,7547457,12664,2511233,4238098
1985-01-26,1985,118,N,1,1,18961,3316485,7547457,11873,2523106,4238098
1985-01-27,1985,119,N,1,1,18854,3335339,7547457,10967,2534073,4238098
1985-01-28,1985,120,N,1,1,18385,3353724,7547457,10991,2545064,4238098
1985-01-29,1985,121,N,1,1,18125,3371849,7547457,11336,2556400,4238098
1985-01-30,1985,122,N,1,1,18563,3390412,7547457,11364,2567764,4238098
1985-01-31,1985,123,N,1,1,18451,3408863,7547457,11480,2579244,4238098
1985-02-01,1985,124,N,1,1,18707,3427570,7547457,11643,2590887,4238098
1985-02-02,1985,125,N,1,1,18684,3446254,7547457,11745,2602632,4238098
1985-02-03,1985,126,N,1,1,18709,3464963,7547457,11726,2614358,4238098
1985-02-04,1985,127,N,1,1,18277,3483240,7547457,11493,2625851,4238098
1985-02-05,1985,128,N,1,1,17674,3500914,7547457,11260,2637111,4238098
1985-02-06,1985,129,N,1,1,18528,3519442,7547457,10972,2648083,4238098
1985-02-07,1985,130,N,1,1,18207,3537649,7547457,10068,2658151,4238098
1985-02-08,1985,131,N,1,1,25829,3563478,7547457,23577,2681728,4238098
1985-02-09,1985,132,N,1,1,39706,3603184,7547457,39516,2721244,4238098
1985-02-10,1985,133,N,1,1,41714,3644898,7547457,39434,2760678,4238098
1985-02-11,1985,134,N,1,1,35687,3680585,7547457,35048,2795726,4238098
1985-02-12,1985,135,N,1,1,30236,3710821,7547457,29727,2825453,4238098
1985-02-13,1985,136,N,1,1,27216,3738037,7547457,20584,2846037,4238098
1985-02-14,1985,137,N,1,1,24273,3762310,7547457,15626,2861663,4238098
1985-02-15,1985,138,N,1,1,21885,3784195,7547457,12173,2873836,4238098
1985-02-16,1985,139,N,1,1,19791,3803986,7547457,9542,2883378,4238098
1985-02-17,1985,140,N,1,1,19346,3823332,7547457,10632,2894010,4238098
1985-02-18,1985,141,N,1,1,19125,3842457,7547457,10948,2904958,4238098
1985-02-19,1985,142,N,1,1,18641,3861098,7547457,10656,2915614,4238098
1985-02-20,1985,143,N,1,1,19005,3880103,7547457,11338,2926952,4238098
1985-02-21,1985,144,N,1,1,19910,3900013,7547457,11347,2938299,4238098
1985-02-22,1985,145,N,1,1,20969,3920982,7547457,11849,2950148,4238098
1985-02-23,1985,146,N,1,1,21246,3942228,7547457,11604,2961752,4238098
1985-02-24,1985,147,N,1,1,21009,3963237,7547457,11322,2973074,4238098
1985-02-25,1985,148,N,1,1,20411,3983648,7547457,10428,2983502,4238098
1985-02-26,1985,149,N,1,1,20197,4003845,7547457,10939,2994441,4238098
1985-02-27,1985,150,N,1,1,20286,4024131,7547457,10839,3005280,4238098
1985-02-28,1985,151,N,1,1,19850,4043981,7547457,10482,3015762,4238098
1985-03-01,1985,152,N,1,1,18190,4062171,7547457,9551,3025313,4238098
1985-03-02,1985,153,N,1,1,17858,4080029,7547457,5227,3030540,4238098
1985-03-03,1985,154,N,1,1,16685,4096714,7547457,5375,3035915,4238098
1985-03-04,1985,155,N,1,1,16019,4112733,7547457,5633,3041548,4238098
1985-03-05,1985,156,N,1,1,16272,4129005,7547457,4859,3046407,4238098
1985-03-06,1985,157,N,1,1,16218,4145223,7547457,7387,3053794,4238098
1985-03-07,1985,158,N,1,1,18310,4163533,7547457,9998,3063792,4238098
1985-03-08,1985,159,N,1,1,20288,4183821,7547457,12015,3075807,4238098
1985-03-09,1985,160,N,1,1,20436,4204257,7547457,11833,3087640,4238098
1985-03-10,1985,161,N,1,1,21028,4225285,7547457,13063,3100703,4238098
1985-03-11,1985,162,N,1,1,22836,4248121,7547457,12895,3113598,4238098
1985-03-12,1985,163,N,1,1,23463,4271584,7547457,12962,3126560,4238098
1985-03-13,1985,164,N,1,1,22160,4293744,7547457,13403,3139963,4238098
1985-03-14,1985,165,N,1,1,20515,4314259,7547457,12038,3152001,4238098
1985-03-15,1985,166,N,1,1,18856,4333115,7547457,11415,3163416,4238098
1985-03-16,1985,167,N,1,1,17422,4350537,7547457,9937,3173353,4238098
1985-03-17,1985,168,N,1,1,16434,4366971,7547457,9238,3182591,4238098
1985-03-18,1985,169,N,1,1,15954,4382925,7547457,8873,3191464,4238098
1985-03-19,1985,170,N,1,1,16099,4399024,7547457,9960,3201424,4238098
1985-03-20,1985,171,N,1,1,15897,4414921,7547457,9255,3210679,4238098
1985-03-21,1985,172,N,1,1,15413,4430334,7547457,8543,3219222,4238098
1985-03-22,1985,173,N,1,1,14672,4445006,7547457,7722,3226944,4238098
1985-03-23,1985,174,N,1,1,14257,4459263,7547457,3047,3229991,4238098
1985-03-24,1985,175,N,1,1,14271,4473534,7547457,3739,3233730,4238098
1985-03-25,1985,176,N,1,1,14590,4488124,7547457,6313,3240043,4238098
1985-03-26,1985,177,N,1,1,13701,4501825,7547457,5640,3245683,4238098
1985-03-27,1985,178,N,1,1,16823,4518648,7547457,14365,3260048,4238098
1985-03-28,1985,179,N,1,1,20376,4539024,7547457,18866,3278914,4238098
1985-03-29,1985,180,N,1,1,21255,4560279,7547457,19895,3298809,4238098
1985-03-30,1985,181,N,1,1,21266,4581545,7547457,20127,3318936,4238098
1985-03-31,1985,182,N,1,1,20696,4602241,7547457,19530,3338466,4238098
1985-04-01,1985,183,N,1,1,19918,4622159,7547457,12708,3351174,4238098
1985-04-02,1985,184,N,1,1,18623,4640782,7547457,9742,3360916,4238098
1985-04-03,1985,185,N,1,1,17684,4658466,7547457,9677,3370593,4238098
1985-04-04,1985,186,N,1,1,17473,4675939,7547457,9120,3379713,4238098
1985-04-05,1985,187,N,1,1,17001,4692940,7547457,8423,3388136,4238098
1985-04-06,1985,188,N,1,1,16335,4709275,7547457,7974,3396110,4238098
1985-04-07,1985,189,N,1,1,16623,4725898,7547457,8270,3404380,4238098
1985-04-08,1985,190,N,1,1,16381,4742279,7547457,8010,3412390,4238098
1985-04-09,1985,191,N,1,1,16012,4758291,7547457,7129,3419519,4238098
1985-04-10,1985,192,N,1,1,15964,4774255,7547457,7505,3427024,4238098
1985-04-11,1985,193,N,1,1,15515,4789770,7547457,5957,3432981,4238098
1985-04-12,1985,194,N,1,1,14818,4804588,7547457,5282,3438263,4238098
1985-04-13,1985,195,N,1,1,14811,4819399,7547457,5389,3443652,4238098
1985-04-14,1985,196,N,1,1,14552,4833951,7547457,4273,3447925,4238098
1985-04-15,1985,197,N,1,1,14415,4848366,7547457,4269,3452194,4238098
1985-04-16,1985,198,N,1,1,15926,4864292,7547457,8092,3460286,4238098
1985-04-17,1985,199,N,1,1,17150,4881442,7547457,8657,3468943,4238098
1985-04-18,1985,200,N,1,1,16784,4898226,7547457,6876,3475819,4238098
1985-04-19,1985,201,N,1,1,17389,4915615,7547457,7721,3483540,4238098
1985-04-20,1985,202,N,1,1,17157,4932772,7547457,7542,3491082,4238098
1985-04-21,1985,203,N,1,1,16674,4949446,7547457,5599,3496681,4238098
1985-04-22,1985,204,N,1,1,16974,4966420,7547457,6488,3503169,4238098
1985-04-23,1985,205,N,1,1,16615,4983035,7547457,6046,3509215,4238098
1985-04-24,1985,206,N,1,1,15231,4998266,7547457,4920,3514135,4238098
1985-04-25,1985,207,N,1,1,14178,5012444,7547457,6043,3520178,4238098
1985-04-26,1985,208,N,1,1,13766,5026210,7547457,4252,3524430,4238098
1985-04-27,1985,209,N,1,1,13108,5039318,7547457,4515,3528945,4238098
1985-04-28,1985,210,N,1,1,12205,5051523,7547457,4118,3533063,4238098
1985-04-29,1985,211,N,1,1,12733,5064256,7547457,4974,3538037,4238098
1985-04-30,1985,212,N,1,1,12911,5077167,7547457,5812,3543849,4238098
1985-05-01,1985,213,N,1,1,13125,5090292,7547457,5148,3548997,4238098
1985-05-02,1985,214,N,1,1,13648,5103940,7547457,5871,3554868,4238098
1985-05-03,1985,215,N,1,1,14544,5118484,7547457,6664,3561532,4238098
1985-05-04,1985,216,N,1,1,15098,5133582,7547457,6998,3568530,4238098
1985-05-05,1985,217,N,1,1,15000,5148582,7547457,6116,3574646,4238098
1985-05-06,1985,218,N,1,1,15127,5163709,7547457,6459,3581105,4238098
1985-05-07,1985,219,N,1,1,15201,5178910,7547457,7037,3588142,4238098
1985-05-08,1985,220,N,1,1,15402,5194312,7547457,7551,3595693,4238098
1985-05-09,1985,221,N,1,1,15874,5210186,7547457,7954,3603647,4238098
1985-05-10,1985,222,N,1,1,16297,5226483,7547457,8412,3612059,4238098
1985-05-11,1985,223,N,1,1,16838,5243321,7547457,8724,3620783,4238098
1985-05-12,1985,224,N,1,1,17093,5260414,7547457,8936,3629719,4238098
1985-05-13,1985,225,N,1,1,17229,5277643,7547457,8542,3638261,4238098
1985-05-14,1985,226,N,1,1,16637,5294280,7547457,6438,3644699,4238098
1985-05-15,1985,227,N,1,1,16004,5310284,7547457,6688,3651387,4238098
1985-05-16,1985,228,N,1,1,15487,5325771,7547457,5878,3657265,4238098
1985-05-17,1985,229,N,1,1,17591,5343362,7547457,8040,3665305,4238098
1985-05-18,1985,230,N,1,1,17461,5360823,7547457,7142,3672447,4238098
1985-05-19,1985,231,N,1,1,17050,5377873,7547457,6701,3679148,4238098
1985-05-20,1985,232,N,1,1,15768,5393641,7547457,5379,3684527,4238098
1985-05-21,1985,233,N,1,1,15661,5409302,7547457,6772,3691299,4238098
1985-05-22,1985,234,N,1,1,15231,5424533,7547457,6777,3698076,4238098
1985-05-23,1985,235,N,1,1,15006,5439539,7547457,7031,3705107,4238098
1985-05-24,1985,236,N,1,1,15037,5454576,7547457,6953,3712060,4238098
1985-05-25,1985,237,N,1,1,15911,5470487,7547457,7522,3719582,4238098
1985-05-26,1985,238,N,1,1,16733,5487220,7547457,8097,3727679,4238098
1985-05-27,1985,239,N,1,1,16931,5504151,7547457,8232,3735911,4238098
1985-05-28,1985,240,N,1,1,17160,5521311,7547457,8143,3744054,4238098
1985-05-29,1985,241,N,1,1,17427,5538738,7547457,8657,3752711,4238098
1985-05-30,1985,242,N,1,1,17537,5556275,7547457,8731,3761442,4238098
1985-05-31,1985,243,N,1,1,17750,5574025,7547457,8418,3769860,4238098
1985-06-01,1985,244,N,1,1,18499,5592524,7547457,9542,3779402,4238098
1985-06-02,1985,245,N,1,1,18736,5611260,7547457,10982,3790384,4238098
1985-06-03,1985,246,N,1,1,18458,5629718,7547457,10661,3801045,4238098
1985-06-04,1985,247,N,1,1,18435,5648153,7547457,10562,3811607,4238098
1985-06-05,1985,248,N,1,1,17663,5665816,7547457,9761,3821368,4238098
1985-06-06,1985,249,N,1,1,17423,5683239,7547457,9460,3830828,4238098
1985-06-07,1985,250,N,1,1,15908,5699147,7547457,6416,3837244,4238098
1985-06-08,1985,251,N,1,1,14686,5713833,7547457,4908,3842152,4238098
1985-06-09,1985,252,N,1,1,13665,5727498,7547457,3855,3846007,4238098
1985-06-10,1985,253,N,1,1,14191,5741689,7547457,4625,3850632,4238098
1985-06-11,1985,254,N,1,1,14223,5755912,7547457,4101,3854733,4238098
1985-06-12,1985,255,N,1,1,14155,5770067,7547457,3783,3858516,4238098
1985-06-13,1985,256,N,1,1,15098,5785165,7547457,5279,3863795,4238098
1985-06-14,1985,257,N,1,1,14352,5799517,7547457,3975,3867770,4238098
1985-06-15,1985,258,N,1,1,13739,5813256,7547457,3301,3871071,4238098
1985-06-16,1985,259,N,1,1,13166,5826422,7547457,2807,3873878,4238098
1985-06-17,1985,260,N,1,1,13546,5839968,7547457,2985,3876863,4238098
1985-06-18,1985,261,N,1,1,14609,5854577,7547457,4132,3880995,4238098
1985-06-19,1985,262,N,1,1,14406,5868983,7547457,3244,3884239,4238098
1985-06-20,1985,263,N,1,1,15005,5883988,7547457,3788,3888027,4238098
1985-06-21,1985,264,N,1,1,14589,5898577,7547457,3042,3891069,4238098
1985-06-22,1985,265,N,1,1,14724,5913301,7547457,3450,3894519,4238098
1985-06-23,1985,266,N,1,1,15114,5928415,7547457,3806,3898325,4238098
1985-06-24,1985,267,N,1,1,15261,5943676,7547457,3435,3901760,4238098
1985-06-25,1985,268,N,1,1,16012,5959688,7547457,5110,3906870,4238098
1985-06-26,1985,269,N,1,1,15123,5974811,7547457,2522,3909392,4238098
1985-06-27,1985,270,N,1,1,14182,5988993,7547457,2349,3911741,4238098
1985-06-28,1985,271,N,1,1,13576,6002569,7547457,2750,3914491,4238098
1985-06-29,1985,272,N,1,1,14130,6016699,7547457,3278,3917769,4238098
1985-06-30,1985,273,N,1,1,16064,6032763,7547457,5491,3923260,4238098
1985-07-01,1985,274,N,1,1,17316,6050079,7547457,4668,3927928,4238098
1985-07-02,1985,275,N,1,1,18040,6068119,7547457,4516,3932444,4238098
1985-07-03,1985,276,N,1,1,18409,6086528,7547457,4338,3936782,4238098
1985-07-04,1985,277,N,1,1,19167,6105695,7547457,5103,3941885,4238098
1985-07-05,1985,278,N,1,1,19180,6124875,7547457,4527,3946412,4238098
1985-07-06,1985,279,N,1,1,18474,6143349,7547457,4317,3950729,4238098
1985-07-07,1985,280,N,1,1,18352,6161701,7547457,4838,3955567,4238098
1985-07-08,1985,281,N,1,1,18534,6180235,7547457,4822,3960389,4238098
1985-07-09,1985,282,N,1,1,18109,6198344,7547457,4422,3964811,4238098
1985-07-10,1985,283,N,1,1,17606,6215950,7547457,3872,3968683,4238098
1985-07-11,1985,284,N,1,1,17260,6233210,7547457,3515,3972198,4238098
1985-07-12,1985,285,N,1,1,17335,6250545,7547457,3569,3975767,4238098
1985-07-13,1985,286,N,1,1,17915,6268460,7547457,4138,3979905,4238098
1985-07-14,1985,287,N,1,1,18432,6286892,7547457,4272,3984177,4238098
1985-07-15,1985,288,N,1,1,19376,6306268,7547457,5094,3989271,4238098
1985-07-16,1985,289,N,1,1,19334,6325602,7547457,5250,3994521,4238098
1985-07-17,1985,290,N,1,1,19602,6345204,7547457,5608,4000129,4238098
1985-07-18,1985,291,N,1,1,20082,6365286,7547457,5622,4005751,4238098
1985-07-19,1985,292,N,1,1,20166,6385452,7547457,5401,4011152,4238098
1985-07-20,1985,293,N,1,1,20168,6405620,7547457,5455,4016607,4238098
1985-07-21,1985,294,N,1,1,19797,6425417,7547457,5102,4021709,4238098
1985-07-22,1985,295,N,1,1,19826,6445243,7547457,6222,4027931,4238098
1985-07-23,1985,296,N,1,1,19896,6465139,7547457,6059,4033990,4238098
1985-07-24,1985,297,N,1,1,19853,6484992,7547457,6408,4040398,4238098
1985-07-25,1985,298,N,1,1,18750,6503742,7547457,4963,4045361,4238098
1985-07-26,1985,299,N,1,1,18818,6522560,7547457,5113,4050474,4238098
1985-07-27,1985,300,N,1,1,18643,6541203,7547457,5190,4055664,4238098
1985-07-28,1985,301,N,1,1,18035,6559238,7547457,4392,4060056,4238098
1985-07-29,1985,302,N,1,1,18985,6578223,7547457,5411,4065467,4238098
1985-07-30,1985,303,N,1,1,17914,6596137,7547457,3721,4069188,4238098
1985-07-31,1985,304,N,1,1,17894,6614031,7547457,3969,4073157,4238098
1985-08-01,1985,305,N,1,1,18447,6632478,7547457,4527,4077684,4238098
1985-08-02,1985,306,N,1,1,18747,6651225,7547457,4223,4081907,4238098
1985-08-03,1985,307,N,1,1,18188,6669413,7547457,3468,4085375,4238098
1985-08-04,1985,308,N,1,1,17042,6686455,7547457,2196,4087571,4238098
1985-08-05,1985,309,N,1,1,16599,6703054,7547457,3566,4091137,4238098
1985-08-06,1985,310,N,1,1,16114,6719168,7547457,3549,4094686,4238098
1985-08-07,1985,311,N,1,1,15040,6734208,7547457,2485,4097171,4238098
1985-08-08,1985,312,N,1,1,14933,6749141,7547457,2291,4099462,4238098
1985-08-09,1985,313,N,1,1,15037,6764178,7547457,2368,4101830,4238098
1985-08-10,1985,314,N,1,1,16075,6780253,7547457,3278,4105108,4238098
1985-08-11,1985,315,N,1,1,17440,6797693,7547457,2721,4107829,4238098
1985-08-12,1985,316,N,1,1,17276,6814969,7547457,2542,4110371,4238098
1985-08-13,1985,317,N,1,1,17410,6832379,7547457,2400,4112771,4238098
1985-08-14,1985,318,N,1,1,17080,6849459,7547457,2129,4114900,4238098
1985-08-15,1985,319,N,1,1,16234,6865693,7547457,782,4115682,4238098
1985-08-16,1985,320,N,1,1,15632,6881325,7547457,655,4116337,4238098
1985-08-17,1985,321,N,1,1,16112,6897437,7547457,1699,4118036,4238098
1985-08-18,1985,322,N,1,1,16507,6913944,7547457,1899,4119935,4238098
1985-08-19,1985,323,N,1,1,16775,6930719,7547457,3572,4123507,4238098
1985-08-20,1985,324,N,1,1,16533,6947252,7547457,1854,4125361,4238098
1985-08-21,1985,325,N,1,1,15845,6963097,7547457,1516,4126877,4238098
1985-08-22,1985,326,N,1,1,15535,6978632,7547457,1405,4128282,4238098
1985-08-23,1985,327,N,1,1,15596,6994228,7547457,2113,4130395,4238098
1985-08-24,1985,328,N,1,1,15603,7009831,7547457,2043,4132438,4238098
1985-08-25,1985,329,N,1,1,16195,7026026,7547457,1732,4134170,4238098
1985-08-26,1985,330,N,1,1,16153,7042179,7547457,1763,4135933,4238098
1985-08-27,1985,331,N,1,1,15450,7057629,7547457,1048,4136981,4238098
1985-08-28,1985,332,N,1,1,15120,7072749,7547457,1578,4138559,4238098
1985-08-29,1985,333,N,1,1,14732,7087481,7547457,1124,4139683,4238098
1985-08-30,1985,334,N,1,1,14579,7102060,7547457,1458,4141141,4238098
1985-08-31,1985,335,N,1,1,14840,7116900,7547457,1719,4142860,4238098
1985-09-01,1985,336,N,1,1,14554,7131454,7547457,1860,4144720,4238098
1985-09-02,1985,337,N,1,1,14930,7146384,7547457,2398,4147118,4238098
1985-09-03,1985,338,N,1,1,15103,7161487,7547457,2504,4149622,4238098
1985-09-04,1985,339,N,1,1,14553,7176040,7547457,899,4150521,4238098
1985-09-05,1985,340,N,1,1,14840,7190880,7547457,1836,4152357,4238098
1985-09-06,1985,341,N,1,1,14084,7204964,7547457,1264,4153621,4238098
1985-09-07,1985,342,N,1,1,14319,7219283,7547457,2428,4156049,4238098
1985-09-08,1985,343,N,1,1,14842,7234125,7547457,4383,4160432,4238098
1985-09-09,1985,344,N,1,1,16086,7250211,7547457,5681,4166113,4238098
1985-09-10,1985,345,N,1,1,17135,7267346,7547457,6396,4172509,4238098
1985-09-11,1985,346,N,1,1,17847,7285193,7547457,6149,4178658,4238098
1985-09-12,1985,347,N,1,1,18425,7303618,7547457,6069,4184727,4238098
1985-09-13,1985,348,N,1,1,17272,7320890,7547457,4998,4189725,4238098
1985-09-14,1985,349,N,1,1,16342,7337232,7547457,2953,4192678,4238098
1985-09-15,1985,350,N,1,1,15610,7352842,7547457,2774,4195452,4238098
1985-09-16,1985,351,N,1,1,14765,7367607,7547457,2647,4198099,4238098
1985-09-17,1985,352,N,1,1,14069,7381676,7547457,2556,4200655,4238098
1985-09-18,1985,353,N,1,1,14344,7396020,7547457,3520,4204175,4238098
1985-09-19,1985,354,N,1,1,13882,7409902,7547457,2511,4206686,4238098
1985-09-20,1985,355,N,1,1,13000,7422902,7547457,2300,4208986,4238098
1985-09-21,1985,356,N,1,1,12746,7435648,7547457,2575,4211561,4238098
1985-09-22,1985,357,N,1,1,12898,7448546,7547457,3303,4214864,4238098
1985-09-23,1985,358,N,1,1,12686,7461232,7547457,3165,4218029,4238098
1985-09-24,1985,359,N,1,1,12481,7473713,7547457,2810,4220839,4238098
1985-09-25,1985,360,N,1,1,11983,7485696,7547457,2572,4223411,4238098
1985-09-26,1985,361,N,1,1,11425,7497121,7547457,2105,4225516,4238098
1985-09-27,1985,362,N,1,1,11898,7509019,7547457,3349,4228865,4238098
1985-09-28,1985,363,N,1,1,12635,7521654,7547457,3321,4232186,4238098
1985-09-29,1985,364,N,1,1,12646,7534300,7547457,2894,4235080,4238098
1985-09-30,1985,365,N,1,1,13157,7547457,7547457,3018,4238098,4238098
1985-10-01,1986,1,N,2,2,13016,13016,17823923,2475,2475,14946806
1985-10-02,1986,2,N,2,2,12780,25796,17823923,2341,4816,14946806
1985-10-03,1986,3,N,2,2,12998,38794,17823923,2449,7265,14946806
1985-10-04,1986,4,N,2,2,12857,51651,17823923,2080,9345,14946806
1985-10-05,1986,5,N,2,2,12592,64243,17823923,2970,12315,14946806
1985-10-06,1986,6,N,2,2,12041,76284,17823923,2494,14809,14946806
1985-10-07,1986,7,N,2,2,12946,89230,17823923,3947,18756,14946806
1985-10-08,1986,8,N,2,2,12487,101717,17823923,2594,21350,14946806
1985-10-09,1986,9,N,2,2,12465,114182,17823923,2882,24232,14946806
1985-10-10,1986,10,N,2,2,11324,125506,17823923,1350,25582,14946806
1985-10-11,1986,11,N,2,2,11222,136728,17823923,1795,27377,14946806
1985-10-12,1986,12,N,2,2,11118,147846,17823923,1701,29078,14946806
1985-10-13,1986,13,N,2,2,11009,158855,17823923,1699,30777,14946806
1985-10-14,1986,14,N,2,2,10976,169831,17823923,1743,32520,14946806
1985-10-15,1986,15,N,2,2,10812,180643,17823923,1532,34052,14946806
1985-10-16,1986,16,N,2,2,10581,191224,17823923,1499,35551,14946806
1985-10-17,1986,17,N,2,2,10653,201877,17823923,1798,37349,14946806
1985-10-18,1986,18,N,2,2,10968,212845,17823923,2132,39481,14946806
1985-10-19,1986,19,N,2,2,11915,224760,17823923,3091,42572,14946806
1985-10-20,1986,20,N,2,2,11964,236724,17823923,8510,51082,14946806
1985-10-21,1986,21,N,2,2,13527,250251,17823923,11578,62660,14946806
1985-10-22,1986,22,N,2,2,13507,263758,17823923,9502,72162,14946806
1985-10-23,1986,23,N,2,2,12850,276608,17823923,8829,80991,14946806
1985-10-24,1986,24,N,2,2,12712,289320,17823923,8347,89338,14946806
1985-10-25,1986,25,N,2,2,12823,302143,17823923,5584,94922,14946806
1985-10-26,1986,26,N,2,2,12495,314638,17823923,2468,97390,14946806
1985-10-27,1986,27,N,2,2,11888,326526,17823923,365,97755,14946806
1985-10-28,1986,28,N,2,2,11901,338427,17823923,1991,99746,14946806
1985-10-29,1986,29,N,2,2,11442,349869,17823923,1228,100974,14946806
1985-10-30,1986,30,N,2,2,11482,361351,17823923,2078,103052,14946806
1985-10-31,1986,31,N,2,2,11020,372371,17823923,1280,104332,14946806
1985-11-01,1986,32,N,2,2,10919,383290,17823923,1706,106038,14946806
1985-11-02,1986,33,N,2,2,10622,393912,17823923,1368,107406,14946806
1985-11-03,1986,34,N,2,2,10546,404458,17823923,1590,108996,14946806
1985-11-04,1986,35,N,2,2,10658,415116,17823923,1463,110459,14946806
1985-11-05,1986,36,N,2,2,11294,426410,17823923,2142,112601,14946806
1985-11-06,1986,37,N,2,2,11173,437583,17823923,1928,114529,14946806
1985-11-07,1986,38,N,2,2,10883,448466,17823923,1667,116196,14946806
1985-11-08,1986,39,N,2,2,10708,459174,17823923,2263,118459,14946806
1985-11-09,1986,40,N,2,2,10823,469997,17823923,5846,124305,14946806
1985-11-10,1986,41,N,2,2,11046,481043,17823923,6306,130611,14946806
1985-11-11,1986,42,N,2,2,11961,493004,17823923,7808,138419,14946806
1985-11-12,1986,43,N,2,2,11605,504609,17823923,8693,147112,14946806
1985-11-13,1986,44,N,2,2,11545,516154,17823923,9179,156291,14946806
1985-11-14,1986,45,N,2,2,11084,527238,17823923,7164,163455,14946806
1985-11-15,1986,46,N,2,2,10984,538222,17823923,4220,167675,14946806
1985-11-16,1986,47,N,2,2,11157,549379,17823923,3825,171500,14946806
1985-11-17,1986,48,N,2,2,11521,560900,17823923,3996,175496,14946806
1985-11-18,1986,49,N,2,2,12578,573478,17823923,4940,180436,14946806
1985-11-19,1986,50,N,2,2,12337,585815,17823923,4222,184658,14946806
1985-11-20,1986,51,N,2,2,11891,597706,17823923,3555,188213,14946806
1985-11-21,1986,52,N,2,2,11632,609338,17823923,3673,191886,14946806
1985-11-22,1986,53,N,2,2,11685,621023,17823923,3932,195818,14946806
1985-11-23,1986,54,N,2,2,11828,632851,17823923,8221,204039,14946806
1985-11-24,1986,55,N,2,2,13499,646350,17823923,15086,219125,14946806
1985-11-25,1986,56,N,2,2,15955,662305,17823923,15912,235037,14946806
1985-11-26,1986,57,N,2,2,16528,678833,17823923,14869,249906,14946806
1985-11-27,1986,58,N,2,2,17083,695916,17823923,18847,268753,14946806
1985-11-28,1986,59,N,2,2,16592,712508,17823923,15193,283946,14946806
1985-11-29,1986,60,N,2,2,17740,730248,17823923,10593,294539,14946806
1985-11-30,1986,61,N,2,2,22545,752793,17823923,16484,311023,14946806
1985-12-01,1986,62,N,2,2,28208,781001,17823923,21751,332774,14946806
1985-12-02,1986,63,N,2,2,28434,809435,17823923,24708,357482,14946806
1985-12-03,1986,64,N,2,2,28842,838277,17823923,24655,382137,14946806
1985-12-04,1986,65,N,2,2,33765,872042,17823923,30425,412562,14946806
1985-12-05,1986,66,N,2,2,36045,908087,17823923,32564,445126,14946806
1985-12-06,1986,67,N,2,2,31810,939897,17823923,30029,475155,14946806
1985-12-07,1986,68,N,2,2,27329,967226,17823923,18820,493975,14946806
1985-12-08,1986,69,N,2,2,25719,992945,17823923,15772,509747,14946806
1985-12-09,1986,70,N,2,2,23217,1016162,17823923,12525,522272,14946806
1985-12-10,1986,71,N,2,2,21620,1037782,17823923,10671,532943,14946806
1985-12-11,1986,72,N,2,2,19802,1057584,17823923,7548,540491,14946806
1985-12-12,1986,73,N,2,2,18056,1075640,17823923,5471,545962,14946806
1985-12-13,1986,74,N,2,2,16578,1092218,17823923,4208,550170,14946806
1985-12-14,1986,75,N,2,2,15770,1107988,17823923,3209,553379,14946806
1985-12-15,1986,76,N,2,2,15266,1123254,17823923,2861,556240,14946806
1985-12-16,1986,77,N,2,2,14911,1138165,17823923,2672,558912,14946806
1985-12-17,1986,78,N,2,2,14587,1152752,17823923,3165,562077,14946806
1985-12-18,1986,79,N,2,2,14365,1167117,17823923,3368,565445,14946806
1985-12-19,1986,80,N,2,2,13839,1180956,17823923,2127,567572,14946806
1985-12-20,1986,81,N,2,2,13305,1194261,17823923,1637,569209,14946806
1985-12-21,1986,82,N,2,2,13180,1207441,17823923,1253,570462,14946806
1985-12-22,1986,83,N,2,2,13004,1220445,17823923,1240,571702,14946806
1985-12-23,1986,84,N,2,2,13153,1233598,17823923,1318,573020,14946806
1985-12-24,1986,85,N,2,2,13083,1246681,17823923,1240,574260,14946806
1985-12-25,1986,86,N,2,2,13094,1259775,17823923,1415,575675,14946806
1985-12-26,1986,87,N,2,2,13023,1272798,17823923,1361,577036,14946806
1985-12-27,1986,88,N,2,2,12866,1285664,17823923,1886,578922,14946806
1985-12-28,1986,89,N,2,2,13098,1298762,17823923,2709,581631,14946806
1985-12-29,1986,90,N,2,2,13441,1312203,17823923,2645,584276,14946806
1985-12-30,1986,91,N,2,2,16167,1328370,17823923,10076,594352,14946806
1985-12-31,1986,92,N,2,2,16253,1344623,17823923,9006,603358,14946806
1986-01-01,1986,93,N,2,2,15740,1360363,17823923,8830,612188,14946806
1986-01-02,1986,94,N,2,2,15436,1375799,17823923,8574,620762,14946806
1986-01-03,1986,95,N,2,2,15110,1390909,17823923,8876,629638,14946806
1986-01-04,1986,96,N,2,2,15691,1406600,17823923,6079,635717,14946806
1986-01-05,1986,97,N,2,2,18462,1425062,17823923,9742,645459,14946806
1986-01-06,1986,98,N,2,2,20090,1445152,17823923,11849,657308,14946806
1986-01-07,1986,99,N,2,2,21043,1466195,17823923,12905,670213,14946806
1986-01-08,1986,100,N,2,2,21556,1487751,17823923,13051,683264,14946806
1986-01-09,1986,101,N,2,2,20902,1508653,17823923,10722,693986,14946806
1986-01-10,1986,102,N,2,2,18876,1527529,17823923,7365,701351,14946806
1986-01-11,1986,103,N,2,2,17873,1545402,17823923,6224,707575,14946806
1986-01-12,1986,104,N,2,2,16890,1562292,17823923,5301,712876,14946806
1986-01-13,1986,105,N,2,2,16192,1578484,17823923,4801,717677,14946806
1986-01-14,1986,106,N,2,2,16000,1594484,17823923,5289,722966,14946806
1986-01-15,1986,107,N,2,2,17026,1611510,17823923,8085,731051,14946806
1986-01-16,1986,108,N,2,2,17900,1629410,17823923,9859,740910,14946806
1986-01-17,1986,109,N,2,2,23218,1652628,17823923,17954,758864,14946806
1986-01-18,1986,110,N,2,2,31554,1684182,17823923,25834,784698,14946806
1986-01-19,1986,111,N,2,2,38647,1722829,17823923,32167,816865,14946806
1986-01-20,1986,112,N,2,2,38416,1761245,17823923,31132,847997,14946806
1986-01-21,1986,113,N,2,2,33343,1794588,17823923,25376,873373,14946806
1986-01-22,1986,114,N,2,2,32122,1826710,17823923,22101,895474,14946806
1986-01-23,1986,115,N,2,2,30640,1857350,17823923,21187,916661,14946806
1986-01-24,1986,116,N,2,2,28691,1886041,17823923,20789,937450,14946806
1986-01-25,1986,117,N,2,2,26335,1912376,17823923,19362,956812,14946806
1986-01-26,1986,118,N,2,2,23932,1936308,17823923,16102,972914,14946806
1986-01-27,1986,119,N,2,2,22311,1958619,17823923,14862,987776,14946806
1986-01-28,1986,120,N,2,2,20648,1979267,17823923,12114,999890,14946806
1986-01-29,1986,121,N,2,2,20512,1999779,17823923,12478,1012368,14946806
1986-01-30,1986,122,N,2,2,26518,2026297,17823923,23057,1035425,14946806
1986-01-31,1986,123,N,2,2,41131,2067428,17823923,39407,1074832,14946806
1986-02-01,1986,124,N,2,2,55786,2123214,17823923,57333,1132165,14946806
1986-02-02,1986,125,N,2,2,60281,2183495,17823923,62442,1194607,14946806
1986-02-03,1986,126,N,2,2,65394,2248889,17823923,68009,1262616,14946806
1986-02-04,1986,127,N,2,2,69781,2318670,17823923,72739,1335355,14946806
1986-02-05,1986,128,N,2,2,73117,2391787,17823923,74923,1410278,14946806
1986-02-06,1986,129,N,2,2,73270,2465057,17823923,71425,1481703,14946806
1986-02-07,1986,130,N,2,2,66270,2531327,17823923,63446,1545149,14946806
1986-02-08,1986,131,N,2,2,57505,2588832,17823923,53255,1598404,14946806
1986-02-09,1986,132,N,2,2,49222,2638054,17823923,41130,1639534,14946806
1986-02-10,1986,133,N,2,2,42884,2680938,17823923,35467,1675001,14946806
1986-02-11,1986,134,N,2,2,38164,2719102,17823923,31011,1706012,14946806
1986-02-12,1986,135,N,2,2,34466,2753568,17823923,27538,1733550,14946806
1986-02-13,1986,136,N,2,2,38320,2791888,17823923,35726,1769276,14946806
1986-02-14,1986,137,N,2,2,58707,2850595,17823923,57439,1826715,14946806
1986-02-15,1986,138,N,2,2,102740,2953335,17823923,104998,1931713,14946806
1986-02-16,1986,139,N,2,2,167665,3121000,17823923,171380,2103093,14946806
1986-02-17,1986,140,N,2,2,336050,3457050,17823923,345513,2448606,14946806
1986-02-18,1986,141,N,2,2,509715,3966765,17823923,524712,2973318,14946806
1986-02-19,1986,142,N,2,2,594749,4561514,17823923,559775,3533093,14946806
1986-02-20,1986,143,N,2,2,661272,5222786,17823923,629494,4162587,14946806
1986-02-21,1986,144,N,2,2,552083,5774869,17823923,570483,4733070,14946806
1986-02-22,1986,145,N,2,2,440753,6215622,17823923,450966,5184036,14946806
1986-02-23,1986,146,N,2,2,371448,6587070,17823923,370540,5554576,14946806
1986-02-24,1986,147,N,2,2,320124,6907194,17823923,313407,5867983,14946806
1986-02-25,1986,148,N,2,2,282116,7189310,17823923,277152,6145135,14946806
1986-02-26,1986,149,N,2,2,254365,7443675,17823923,248407,6393542,14946806
1986-02-27,1986,150,N,2,2,228271,7671946,17823923,222640,6616182,14946806
1986-02-28,1986,151,N,2,2,214443,7886389,17823923,210245,6826427,14946806
1986-03-01,1986,152,N,2,2,204019,8090408,17823923,199170,7025597,14946806
1986-03-02,1986,153,N,2,2,185387,8275795,17823923,178601,7204198,14946806
1986-03-03,1986,154,N,2,2,164896,8440691,17823923,159072,7363270,14946806
1986-03-04,1986,155,N,2,2,149979,8590670,17823923,145998,7509268,14946806
1986-03-05,1986,156,N,2,2,138330,8729000,17823923,133564,7642832,14946806
1986-03-06,1986,157,N,2,2,124039,8853039,17823923,118944,7761776,14946806
1986-03-07,1986,158,N,2,2,117418,8970457,17823923,111780,7873556,14946806
1986-03-08,1986,159,N,2,2,142699,9113156,17823923,145279,8018835,14946806
1986-03-09,1986,160,N,2,2,200923,9314079,17823923,203262,8222097,14946806
1986-03-10,1986,161,N,2,2,246195,9560274,17823923,250939,8473036,14946806
1986-03-11,1986,162,N,2,2,270168,9830442,17823923,282254,8755290,14946806
1986-03-12,1986,163,N,2,2,271139,10101581,17823923,285785,9041075,14946806
1986-03-13,1986,164,N,2,2,268387,10369968,17823923,278336,9319411,14946806
1986-03-14,1986,165,N,2,2,251603,10621571,17823923,260789,9580200,14946806
1986-03-15,1986,166,N,2,2,240633,10862204,17823923,248281,9828481,14946806
1986-03-16,1986,167,N,2,2,246845,11109049,17823923,252850,10081331,14946806
1986-03-17,1986,168,N,2,2,220928,11329977,17823923,226423,10307754,14946806
1986-03-18,1986,169,N,2,2,202772,11532749,17823923,208251,10516005,14946806
1986-03-19,1986,170,N,2,2,182888,11715637,17823923,188323,10704328,14946806
1986-03-20,1986,171,N,2,2,163809,11879446,17823923,165948,10870276,14946806
1986-03-21,1986,172,N,2,2,148551,12027997,17823923,147045,11017321,14946806
1986-03-22,1986,173,N,2,2,138857,12166854,17823923,136881,11154202,14946806
1986-03-23,1986,174,N,2,2,129867,12296721,17823923,128467,11282669,14946806
1986-03-24,1986,175,N,2,2,121810,12418531,17823923,120424,11403093,14946806
1986-03-25,1986,176,N,2,2,114206,12532737,17823923,112372,11515465,14946806
1986-03-26,1986,177,N,2,2,107837,12640574,17823923,105801,11621266,14946806
1986-03-27,1986,178,N,2,2,102787,12743361,17823923,100403,11721669,14946806
1986-03-28,1986,179,N,2,2,99416,12842777,17823923,96490,11818159,14946806
1986-03-29,1986,180,N,2,2,94589,12937366,17823923,91533,11909692,14946806
1986-03-30,1986,181,N,2,2,89542,13026908,17823923,86596,11996288,14946806
1986-03-31,1986,182,N,2,2,85966,13112874,17823923,83011,12079299,14946806
1986-04-01,1986,183,N,2,2,82792,13195666,17823923,80292,12159591,14946806
1986-04-02,1986,184,N,2,2,80152,13275818,17823923,78013,12237604,14946806
1986-04-03,1986,185,N,2,2,77377,13353195,17823923,74723,12312327,14946806
1986-04-04,1986,186,N,2,2,73422,13426617,17823923,68996,12381323,14946806
1986-04-05,1986,187,N,2,2,69568,13496185,17823923,65472,12446795,14946806
1986-04-06,1986,188,N,2,2,65898,13562083,17823923,61793,12508588,14946806
1986-04-07,1986,189,N,2,2,63582,13625665,17823923,66357,12574945,14946806
1986-04-08,1986,190,N,2,2,60779,13686444,17823923,65870,12640815,14946806
1986-04-09,1986,191,N,2,2,59099,13745543,17823923,63273,12704088,14946806
1986-04-10,1986,192,N,2,2,57606,13803149,17823923,63644,12767732,14946806
1986-04-11,1986,193,N,2,2,55894,13859043,17823923,59741,12827473,14946806
1986-04-12,1986,194,N,2,2,54000,13913043,17823923,51616,12879089,14946806
1986-04-13,1986,195,N,2,2,53051,13966094,17823923,49381,12928470,14946806
1986-04-14,1986,196,N,2,2,50984,14017078,17823923,45799,12974269,14946806
1986-04-15,1986,197,N,2,2,49189,14066267,17823923,45145,13019414,14946806
1986-04-16,1986,198,N,2,2,48018,14114285,17823923,45569,13064983,14946806
1986-04-17,1986,199,N,2,2,45950,14160235,17823923,40381,13105364,14946806
1986-04-18,1986,200,N,2,2,44057,14204292,17823923,41458,13146822,14946806
1986-04-19,1986,201,N,2,2,43349,14247641,17823923,38019,13184841,14946806
1986-04-20,1986,202,N,2,2,42250,14289891,17823923,36911,13221752,14946806
1986-04-21,1986,203,N,2,2,40519,14330410,17823923,35488,13257240,14946806
1986-04-22,1986,204,N,2,2,35730,14366140,17823923,29221,13286461,14946806
1986-04-23,1986,205,N,2,2,35775,14401915,17823923,29262,13315723,14946806
1986-04-24,1986,206,N,2,2,34683,14436598,17823923,28514,13344237,14946806
1986-04-25,1986,207,N,2,2,32855,14469453,17823923,26662,13370899,14946806
1986-04-26,1986,208,N,2,2,31135,14500588,17823923,22901,13393800,14946806
1986-04-27,1986,209,N,2,2,30722,14531310,17823923,22400,13416200,14946806
1986-04-28,1986,210,N,2,2,29726,14561036,17823923,22000,13438200,14946806
1986-04-29,1986,211,N,2,2,28101,14589137,17823923,20298,13458498,14946806
1986-04-30,1986,212,N,2,2,25913,14615050,17823923,16973,13475471,14946806
1986-05-01,1986,213,N,2,2,25850,14640900,17823923,16747,13492218,14946806
1986-05-02,1986,214,N,2,2,24861,14665761,17823923,17858,13510076,14946806
1986-05-03,1986,215,N,2,2,23966,14689727,17823923,17045,13527121,14946806
1986-05-04,1986,216,N,2,2,24775,14714502,17823923,19056,13546177,14946806
1986-05-05,1986,217,N,2,2,24582,14739084,17823923,18330,13564507,14946806
1986-05-06,1986,218,N,2,2,25486,14764570,17823923,19655,13584162,14946806
1986-05-07,1986,219,N,2,2,25831,14790401,17823923,19642,13603804,14946806
1986-05-08,1986,220,N,2,2,25877,14816278,17823923,19219,13623023,14946806
1986-05-09,1986,221,N,2,2,25155,14841433,17823923,17428,13640451,14946806
1986-05-10,1986,222,N,2,2,24345,14865778,17823923,17013,13657464,14946806
1986-05-11,1986,223,N,2,2,23897,14889675,17823923,16131,13673595,14946806
1986-05-12,1986,224,N,2,2,23091,14912766,17823923,15767,13689362,14946806
1986-05-13,1986,225,N,2,2,22284,14935050,17823923,14837,13704199,14946806
1986-05-14,1986,226,N,2,2,21999,14957049,17823923,14493,13718692,14946806
1986-05-15,1986,227,N,2,2,22951,14980000,17823923,15053,13733745,14946806
1986-05-16,1986,228,N,2,2,25599,15005599,17823923,18329,13752074,14946806
1986-05-17,1986,229,N,2,2,26332,15031931,17823923,18100,13770174,14946806
1986-05-18,1986,230,N,2,2,24641,15056572,17823923,15094,13785268,14946806
1986-05-19,1986,231,N,2,2,22777,15079349,17823923,13417,13798685,14946806
1986-05-20,1986,232,N,2,2,22161,15101510,17823923,13290,13811975,14946806
1986-05-21,1986,233,N,2,2,21988,15123498,17823923,14248,13826223,14946806
1986-05-22,1986,234,N,2,2,21739,15145237,17823923,13319,13839542,14946806
1986-05-23,1986,235,N,2,2,21817,15167054,17823923,13128,13852670,14946806
1986-05-24,1986,236,N,2,2,22087,15189141,17823923,12026,13864696,14946806
1986-05-25,1986,237,N,2,2,21895,15211036,17823923,11259,13875955,14946806
1986-05-26,1986,238,N,2,2,21902,15232938,17823923,11294,13887249,14946806
1986-05-27,1986,239,N,2,2,21881,15254819,17823923,14408,13901657,14946806
1986-05-28,1986,240,N,2,2,22307,15277126,17823923,16589,13918246,14946806
1986-05-29,1986,241,N,2,2,22516,15299642,17823923,16028,13934274,14946806
1986-05-30,1986,242,N,2,2,22386,15322028,17823923,15106,13949380,14946806
1986-05-31,1986,243,N,2,2,22447,15344475,17823923,16205,13965585,14946806
1986-06-01,1986,244,N,2,2,22453,15366928,17823923,12969,13978554,14946806
1986-06-02,1986,245,N,2,2,22862,15389790,17823923,12835,13991389,14946806
1986-06-03,1986,246,N,2,2,22928,15412718,17823923,14272,14005661,14946806
1986-06-04,1986,247,N,2,2,22976,15435694,17823923,13659,14019320,14946806
1986-06-05,1986,248,N,2,2,22879,15458573,17823923,14149,14033469,14946806
1986-06-06,1986,249,N,2,2,22761,15481334,17823923,14086,14047555,14946806
1986-06-07,1986,250,N,2,2,22341,15503675,17823923,14046,14061601,14946806
1986-06-08,1986,251,N,2,2,21921,15525596,17823923,11221,14072822,14946806
1986-06-09,1986,252,N,2,2,21694,15547290,17823923,12349,14085171,14946806
1986-06-10,1986,253,N,2,2,20689,15567979,17823923,11001,14096172,14946806
1986-06-11,1986,254,N,2,2,20370,15588349,17823923,9847,14106019,14946806
1986-06-12,1986,255,N,2,2,20013,15608362,17823923,9799,14115818,14946806
1986-06-13,1986,256,N,2,2,18956,15627318,17823923,7710,14123528,14946806
1986-06-14,1986,257,N,2,2,18863,15646181,17823923,8416,14131944,14946806
1986-06-15,1986,258,N,2,2,18664,15664845,17823923,6929,14138873,14946806
1986-06-16,1986,259,N,2,2,18538,15683383,17823923,6697,14145570,14946806
1986-06-17,1986,260,N,2,2,18005,15701388,17823923,6595,14152165,14946806
1986-06-18,1986,261,N,2,2,18184,15719572,17823923,8114,14160279,14946806
1986-06-19,1986,262,N,2,2,17045,15736617,17823923,6711,14166990,14946806
1986-06-20,1986,263,N,2,2,16273,15752890,17823923,6669,14173659,14946806
1986-06-21,1986,264,N,2,2,15327,15768217,17823923,6101,14179760,14946806
1986-06-22,1986,265,N,2,2,15456,15783673,17823923,7402,14187162,14946806
1986-06-23,1986,266,N,2,2,15411,15799084,17823923,7497,14194659,14946806
1986-06-24,1986,267,N,2,2,16181,15815265,17823923,6834,14201493,14946806
1986-06-25,1986,268,N,2,2,16059,15831324,17823923,6742,14208235,14946806
1986-06-26,1986,269,N,2,2,16168,15847492,17823923,6051,14214286,14946806
1986-06-27,1986,270,N,2,2,16381,15863873,17823923,5705,14219991,14946806
1986-06-28,1986,271,N,2,2,17013,15880886,17823923,6756,14226747,14946806
1986-06-29,1986,272,N,2,2,18230,15899116,17823923,7467,14234214,14946806
1986-06-30,1986,273,N,2,2,19691,15918807,17823923,8052,14242266,14946806
1986-07-01,1986,274,N,2,2,20504,15939311,17823923,6986,14249252,14946806
1986-07-02,1986,275,N,2,2,20441,15959752,17823923,6531,14255783,14946806
1986-07-03,1986,276,N,2,2,20245,15979997,17823923,6773,14262556,14946806
1986-07-04,1986,277,N,2,2,20642,16000639,17823923,7606,14270162,14946806
1986-07-05,1986,278,N,2,2,20182,16020821,17823923,5700,14275862,14946806
1986-07-06,1986,279,N,2,2,20232,16041053,17823923,7076,14282938,14946806
1986-07-07,1986,280,N,2,2,20632,16061685,17823923,7160,14290098,14946806
1986-07-08,1986,281,N,2,2,20227,16081912,17823923,6013,14296111,14946806
1986-07-09,1986,282,N,2,2,19895,16101807,17823923,6239,14302350,14946806
1986-07-10,1986,283,N,2,2,19676,16121483,17823923,6017,14308367,14946806
1986-07-11,1986,284,N,2,2,19528,16141011,17823923,6207,14314574,14946806
1986-07-12,1986,285,N,2,2,19314,16160325,17823923,6665,14321239,14946806
1986-07-13,1986,286,N,2,2,19432,16179757,17823923,6494,14327733,14946806
1986-07-14,1986,287,N,2,2,20010,16199767,17823923,6791,14334524,14946806
1986-07-15,1986,288,N,2,2,19223,16218990,17823923,5698,14340222,14946806
1986-07-16,1986,289,N,2,2,20092,16239082,17823923,7362,14347584,14946806
1986-07-17,1986,290,N,2,2,19591,16258673,17823923,7374,14354958,14946806
1986-07-18,1986,291,N,2,2,19915,16278588,17823923,8214,14363172,14946806
1986-07-19,1986,292,N,2,2,19893,16298481,17823923,7974,14371146,14946806
1986-07-20,1986,293,N,2,2,19991,16318472,17823923,8106,14379252,14946806
1986-07-21,1986,294,N,2,2,20428,16338900,17823923,8608,14387860,14946806
1986-07-22,1986,295,N,2,2,20910,16359810,17823923,9779,14397639,14946806
1986-07-23,1986,296,N,2,2,21090,16380900,17823923,9597,14407236,14946806
1986-07-24,1986,297,N,2,2,20254,16401154,17823923,7853,14415089,14946806
1986-07-25,1986,298,N,2,2,20567,16421721,17823923,7093,14422182,14946806
1986-07-26,1986,299,N,2,2,21014,16442735,17823923,7706,14429888,14946806
1986-07-27,1986,300,N,2,2,21187,16463922,17823923,9167,14439055,14946806
1986-07-28,1986,301,N,2,2,21497,16485419,17823923,7807,14446862,14946806
1986-07-29,1986,302,N,2,2,21656,16507075,17823923,8098,14454960,14946806
1986-07-30,1986,303,N,2,2,20911,16527986,17823923,7062,14462022,14946806
1986-07-31,1986,304,N,2,2,20296,16548282,17823923,6324,14468346,14946806
1986-08-01,1986,305,N,2,2,19965,16568247,17823923,6477,14474823,14946806
1986-08-02,1986,306,N,2,2,19808,16588055,17823923,6606,14481429,14946806
1986-08-03,1986,307,N,2,2,20029,16608084,17823923,6661,14488090,14946806
1986-08-04,1986,308,N,2,2,20331,16628415,17823923,7035,14495125,14946806
1986-08-05,1986,309,N,2,2,19705,16648120,17823923,6152,14501277,14946806
1986-08-06,1986,310,N,2,2,19821,16667941,17823923,6278,14507555,14946806
1986-08-07,1986,311,N,2,2,19817,16687758,17823923,6075,14513630,14946806
1986-08-08,1986,312,N,2,2,19614,16707372,17823923,5991,14519621,14946806
1986-08-09,1986,313,N,2,2,19409,16726781,17823923,6074,14525695,14946806
1986-08-10,1986,314,N,2,2,19526,16746307,17823923,5809,14531504,14946806
1986-08-11,1986,315,N,2,2,19876,16766183,17823923,5965,14537469,14946806
1986-08-12,1986,316,N,2,2,19607,16785790,17823923,5468,14542937,14946806
1986-08-13,1986,317,N,2,2,19012,16804802,17823923,5169,14548106,14946806
1986-08-14,1986,318,N,2,2,18789,16823591,17823923,5157,14553263,14946806
1986-08-15,1986,319,N,2,2,18211,16841802,17823923,4459,14557722,14946806
1986-08-16,1986,320,N,2,2,17765,16859567,17823923,3936,14561658,14946806
1986-08-17,1986,321,N,2,2,17824,16877391,17823923,4088,14565746,14946806
1986-08-18,1986,322,N,2,2,17828,16895219,17823923,4375,14570121,14946806
1986-08-19,1986,323,N,2,2,17482,16912701,17823923,3899,14574020,14946806
1986-08-20,1986,324,N,2,2,17617,16930318,17823923,3741,14577761,14946806
1986-08-21,1986,325,N,2,2,17858,16948176,17823923,3917,14581678,14946806
1986-08-22,1986,326,N,2,2,18289,16966465,17823923,4320,14585998,14946806
1986-08-23,1986,327,N,2,2,18595,16985060,17823923,4199,14590197,14946806
1986-08-24,1986,328,N,2,2,18627,17003687,17823923,4186,14594383,14946806
1986-08-25,1986,329,N,2,2,18579,17022266,17823923,4203,14598586,14946806
1986-08-26,1986,330,N,2,2,18297,17040563,17823923,3212,14601798,14946806
1986-08-27,1986,331,N,2,2,18289,17058852,17823923,4134,14605932,14946806
1986-08-28,1986,332,N,2,2,18159,17077011,17823923,4149,14610081,14946806
1986-08-29,1986,333,N,2,2,18452,17095463,17823923,4633,14614714,14946806
1986-08-30,1986,334,N,2,2,18747,17114210,17823923,5055,14619769,14946806
1986-08-31,1986,335,N,2,2,19081,17133291,17823923,5259,14625028,14946806
1986-09-01,1986,336,N,2,2,19562,17152853,17823923,5375,14630403,14946806
1986-09-02,1986,337,N,2,2,19246,17172099,17823923,5181,14635584,14946806
1986-09-03,1986,338,N,2,2,19473,17191572,17823923,5682,14641266,14946806
1986-09-04,1986,339,N,2,2,19976,17211548,17823923,6428,14647694,14946806
1986-09-05,1986,340,N,2,2,20449,17231997,17823923,6899,14654593,14946806
1986-09-06,1986,341,N,2,2,20408,17252405,17823923,6625,14661218,14946806
1986-09-07,1986,342,N,2,2,20222,17272627,17823923,6635,14667853,14946806
1986-09-08,1986,343,N,2,2,19435,17292062,17823923,6508,14674361,14946806
1986-09-09,1986,344,N,2,2,18744,17310806,17823923,5875,14680236,14946806
1986-09-10,1986,345,N,2,2,18343,17329149,17823923,4835,14685071,14946806
1986-09-11,1986,346,N,2,2,18176,17347325,17823923,4723,14689794,14946806
1986-09-12,1986,347,N,2,2,18472,17365797,17823923,4156,14693950,14946806
1986-09-13,1986,348,N,2,2,19516,17385313,17823923,6733,14700683,14946806
1986-09-14,1986,349,N,2,2,19578,17404891,17823923,6847,14707530,14946806
1986-09-15,1986,350,N,2,2,19748,17424639,17823923,7334,14714864,14946806
1986-09-16,1986,351,N,2,2,20286,17444925,17823923,7575,14722439,14946806
1986-09-17,1986,352,N,2,2,22029,17466954,17823923,9612,14732051,14946806
1986-09-18,1986,353,N,2,2,25539,17492493,17823923,13269,14745320,14946806
1986-09-19,1986,354,N,2,2,27287,17519780,17823923,14767,14760087,14946806
1986-09-20,1986,355,N,2,2,28718,17548498,17823923,16519,14776606,14946806
1986-09-21,1986,356,N,2,2,28689,17577187,17823923,16301,14792907,14946806
1986-09-22,1986,357,N,2,2,27987,17605174,17823923,14943,14807850,14946806
1986-09-23,1986,358,N,2,2,27420,17632594,17823923,16432,14824282,14946806
1986-09-24,1986,359,N,2,2,27695,17660289,17823923,17173,14841455,14946806
1986-09-25,1986,360,N,2,2,28007,17688296,17823923,18336,14859791,14946806
1986-09-26,1986,361,N,2,2,28681,17716977,17823923,20556,14880347,14946806
1986-09-27,1986,362,N,2,2,28528,17745505,17823923,20528,14900875,14946806
1986-09-28,1986,363,N,2,2,27386,17772891,17823923,17110,14917985,14946806
1986-09-29,1986,364,N,2,2,26582,17799473,17823923,15497,14933482,14946806
1986-09-30,1986,365,N,2,2,24450,17823923,17823923,13324,14946806,14946806
1986-10-01,1987,1,D,1,1,25390,25390,6189202,12455,12455,3048726
1986-10-02,1987,2,D,1,1,26604,51994,6189202,14078,26533,3048726
1986-10-03,1987,3,D,1,1,25811,77805,6189202,13250,39783,3048726
1986-10-04,1987,4,D,1,1,25750,103555,6189202,12883,52666,3048726
1986-10-05,1987,5,D,1,1,25141,128696,6189202,12294,64960,3048726
1986-10-06,1987,6,D,1,1,24234,152930,6189202,11928,76888,3048726
1986-10-07,1987,7,D,1,1,22859,175789,6189202,11810,88698,3048726
1986-10-08,1987,8,D,1,1,23089,198878,6189202,13382,102080,3048726
1986-10-09,1987,9,D,1,1,23263,222141,6189202,13905,115985,3048726
1986-10-10,1987,10,D,1,1,23158,245299,6189202,13465,129450,3048726
1986-10-11,1987,11,D,1,1,22847,268146,6189202,13604,143054,3048726
1986-10-12,1987,12,D,1,1,22341,290487,6189202,10912,153966,3048726
1986-10-13,1987,13,D,1,1,21521,312008,6189202,11957,165923,3048726
1986-10-14,1987,14,D,1,1,20118,332126,6189202,12491,178414,3048726
1986-10-15,1987,15,D,1,1,19539,351665,6189202,10556,188970,3048726
1986-10-16,1987,16,D,1,1,19019,370684,6189202,10592,199562,3048726
1986-10-17,1987,17,D,1,1,18719,389403,6189202,10911,210473,3048726
1986-10-18,1987,18,D,1,1,18157,407560,6189202,10282,220755,3048726
1986-10-19,1987,19,D,1,1,17271,424831,6189202,8155,228910,3048726
1986-10-20,1987,20,D,1,1,17217,442048,6189202,9294,238204,3048726
1986-10-21,1987,21,D,1,1,16851,458899,6189202,8930,247134,3048726
1986-10-22,1987,22,D,1,1,16180,475079,6189202,8184,255318,3048726
1986-10-23,1987,23,D,1,1,15974,491053,6189202,7797,263115,3048726
1986-10-24,1987,24,D,1,1,15760,506813,6189202,8140,271255,3048726
1986-10-25,1987,25,D,1,1,15851,522664,6189202,6791,278046,3048726
1986-10-26,1987,26,D,1,1,15929,538593,6189202,6097,284143,3048726
1986-10-27,1987,27,D,1,1,16640,555233,6189202,9217,293360,3048726
1986-10-28,1987,28,D,1,1,16693,571926,6189202,9073,302433,3048726
1986-10-29,1987,29,D,1,1,16670,588596,6189202,8974,311407,3048726
1986-10-30,1987,30,D,1,1,16814,605410,6189202,9163,320570,3048726
1986-10-31,1987,31,D,1,1,16390,621800,6189202,8291,328861,3048726
1986-11-01,1987,32,D,1,1,16751,638551,6189202,8712,337573,3048726
1986-11-02,1987,33,D,1,1,16886,655437,6189202,8140,345713,3048726
1986-11-03,1987,34,D,1,1,16832,672269,6189202,9676,355389,3048726
1986-11-04,1987,35,D,1,1,17005,689274,6189202,9702,365091,3048726
1986-11-05,1987,36,D,1,1,16804,706078,6189202,9719,374810,3048726
1986-11-06,1987,37,D,1,1,16551,722629,6189202,9253,384063,3048726
1986-11-07,1987,38,D,1,1,16070,738699,6189202,9387,393450,3048726
1986-11-08,1987,39,D,1,1,15829,754528,6189202,9555,403005,3048726
1986-11-09,1987,40,D,1,1,15638,770166,6189202,7869,410874,3048726
1986-11-10,1987,41,D,1,1,16241,786407,6189202,8639,419513,3048726
1986-11-11,1987,42,D,1,1,16271,802678,6189202,7976,427489,3048726
1986-11-12,1987,43,D,1,1,16400,819078,6189202,7869,435358,3048726
1986-11-13,1987,44,D,1,1,17155,836233,6189202,8460,443818,3048726
1986-11-14,1987,45,D,1,1,16390,852623,6189202,7899,451717,3048726
1986-11-15,1987,46,D,1,1,16457,869080,6189202,8174,459891,3048726
1986-11-16,1987,47,D,1,1,16252,885332,6189202,7098,466989,3048726
1986-11-17,1987,48,D,1,1,16011,901343,6189202,6594,473583,3048726
1986-11-18,1987,49,D,1,1,15815,917158,6189202,6324,479907,3048726
1986-11-19,1987,50,D,1,1,16567,933725,6189202,8214,488121,3048726
1986-11-20,1987,51,D,1,1,16136,949861,6189202,6038,494159,3048726
1986-11-21,1987,52,D,1,1,16286,966147,6189202,7294,501453,3048726
1986-11-22,1987,53,D,1,1,16296,982443,6189202,6696,508149,3048726
1986-11-23,1987,54,D,1,1,16098,998541,6189202,6587,514736,3048726
1986-11-24,1987,55,D,1,1,15869,1014410,6189202,6446,521182,3048726
1986-11-25,1987,56,D,1,1,15635,1030045,6189202,6969,528151,3048726
1986-11-26,1987,57,D,1,1,15824,1045869,6189202,6968,535119,3048726
1986-11-27,1987,58,D,1,1,15897,1061766,6189202,5946,541065,3048726
1986-11-28,1987,59,D,1,1,16157,1077923,6189202,6029,547094,3048726
1986-11-29,1987,60,D,1,1,15587,1093510,6189202,6672,553766,3048726
1986-11-30,1987,61,D,1,1,16801,1110311,6189202,7045,560811,3048726
1986-12-01,1987,62,D,1,1,16839,1127150,6189202,7711,568522,3048726
1986-12-02,1987,63,D,1,1,16988,1144138,6189202,8030,576552,3048726
1986-12-03,1987,64,D,1,1,17174,1161312,6189202,9526,586078,3048726
1986-12-04,1987,65,D,1,1,17541,1178853,6189202,7406,593484,3048726
1986-12-05,1987,66,D,1,1,17678,1196531,6189202,11137,604621,3048726
1986-12-06,1987,67,D,1,1,17361,1213892,6189202,10470,615091,3048726
1986-12-07,1987,68,D,1,1,17162,1231054,6189202,9890,624981,3048726
1986-12-08,1987,69,D,1,1,17256,1248310,6189202,10636,635617,3048726
1986-12-09,1987,70,D,1,1,17278,1265588,6189202,10332,645949,3048726
1986-12-10,1987,71,D,1,1,18302,1283890,6189202,8705,654654,3048726
1986-12-11,1987,72,D,1,1,18385,1302275,6189202,10535,665189,3048726
1986-12-12,1987,73,D,1,1,18374,1320649,6189202,7338,672527,3048726
1986-12-13,1987,74,D,1,1,18712,1339361,6189202,8741,681268,3048726
1986-12-14,1987,75,D,1,1,18454,1357815,6189202,6875,688143,3048726
1986-12-15,1987,76,D,1,1,17573,1375388,6189202,6500,694643,3048726
1986-12-16,1987,77,D,1,1,16464,1391852,6189202,6695,701338,3048726
1986-12-17,1987,78,D,1,1,17545,1409397,6189202,8259,709597,3048726
1986-12-18,1987,79,D,1,1,17636,1427033,6189202,7921,717518,3048726
1986-12-19,1987,80,D,1,1,17994,1445027,6189202,10329,727847,3048726
1986-12-20,1987,81,D,1,1,18018,1463045,6189202,10082,737929,3048726
1986-12-21,1987,82,D,1,1,17808,1480853,6189202,10203,748132,3048726
1986-12-22,1987,83,D,1,1,17174,1498027,6189202,10550,758682,3048726
1986-12-23,1987,84,D,1,1,16498,1514525,6189202,10911,769593,3048726
1986-12-24,1987,85,D,1,1,17740,1532265,6189202,10004,779597,3048726
1986-12-25,1987,86,D,1,1,17568,1549833,6189202,8697,788294,3048726
1986-12-26,1987,87,D,1,1,17177,1567010,6189202,7890,796184,3048726
1986-12-27,1987,88,D,1,1,16168,1583178,6189202,7369,803553,3048726
1986-12-28,1987,89,D,1,1,16884,1600062,6189202,8083,811636,3048726
1986-12-29,1987,90,D,1,1,16438,1616500,6189202,7626,819262,3048726
1986-12-30,1987,91,D,1,1,16023,1632523,6189202,8735,827997,3048726
1986-12-31,1987,92,D,1,1,17379,1649902,6189202,11391,839388,3048726
1987-01-01,1987,93,D,1,1,17429,1667331,6189202,10631,850019,3048726
1987-01-02,1987,94,D,1,1,17269,1684600,6189202,11482,861501,3048726
1987-01-03,1987,95,D,1,1,16758,1701358,6189202,13962,875463,3048726
1987-01-04,1987,96,D,1,1,19348,1720706,6189202,16834,892297,3048726
1987-01-05,1987,97,D,1,1,21060,1741766,6189202,19152,911449,3048726
1987-01-06,1987,98,D,1,1,23098,1764864,6189202,22121,933570,3048726
1987-01-07,1987,99,D,1,1,21348,1786212,6189202,19475,953045,3048726
1987-01-08,1987,100,D,1,1,19326,1805538,6189202,13700,966745,3048726
1987-01-09,1987,101,D,1,1,17723,1823261,6189202,12399,979144,3048726
1987-01-10,1987,102,D,1,1,15891,1839152,6189202,9879,989023,3048726
1987-01-11,1987,103,D,1,1,15061,1854213,6189202,6735,995758,3048726
1987-01-12,1987,104,D,1,1,14543,1868756,6189202,5835,1001593,3048726
1987-01-13,1987,105,D,1,1,14106,1882862,6189202,7222,1008815,3048726
1987-01-14,1987,106,D,1,1,14409,1897271,6189202,7208,1016023,3048726
1987-01-15,1987,107,D,1,1,14398,1911669,6189202,5719,1021742,3048726
1987-01-16,1987,108,D,1,1,14199,1925868,6189202,6503,1028245,3048726
1987-01-17,1987,109,D,1,1,14077,1939945,6189202,6522,1034767,3048726
1987-01-18,1987,110,D,1,1,13387,1953332,6189202,4798,1039565,3048726
1987-01-19,1987,111,D,1,1,13316,1966648,6189202,5789,1045354,3048726
1987-01-20,1987,112,D,1,1,12802,1979450,6189202,6296,1051650,3048726
1987-01-21,1987,113,D,1,1,12579,1992029,6189202,5706,1057356,3048726
1987-01-22,1987,114,D,1,1,12807,2004836,6189202,8126,1065482,3048726
1987-01-23,1987,115,D,1,1,13081,2017917,6189202,10348,1075830,3048726
1987-01-24,1987,116,D,1,1,13572,2031489,6189202,10826,1086656,3048726
1987-01-25,1987,117,D,1,1,13956,2045445,6189202,10253,1096909,3048726
1987-01-26,1987,118,D,1,1,14444,2059889,6189202,10866,1107775,3048726
1987-01-27,1987,119,D,1,1,16045,2075934,6189202,11648,1119423,3048726
1987-01-28,1987,120,D,1,1,16308,2092242,6189202,11150,1130573,3048726
1987-01-29,1987,121,D,1,1,16845,2109087,6189202,13905,1144478,3048726
1987-01-30,1987,122,D,1,1,18715,2127802,6189202,15825,1160303,3048726
1987-01-31,1987,123,D,1,1,17632,2145434,6189202,14448,1174751,3048726
1987-02-01,1987,124,D,1,1,17709,2163143,6189202,10292,1185043,3048726
1987-02-02,1987,125,D,1,1,17268,2180411,6189202,17507,1202550,3048726
1987-02-03,1987,126,D,1,1,18769,2199180,6189202,19867,1222417,3048726
1987-02-04,1987,127,D,1,1,21679,2220859,6189202,22265,1244682,3048726
1987-02-05,1987,128,D,1,1,21010,2241869,6189202,20610,1265292,3048726
1987-02-06,1987,129,D,1,1,19627,2261496,6189202,18315,1283607,3048726
1987-02-07,1987,130,D,1,1,17861,2279357,6189202,10205,1293812,3048726
1987-02-08,1987,131,D,1,1,16160,2295517,6189202,7171,1300983,3048726
1987-02-09,1987,132,D,1,1,14859,2310376,6189202,5422,1306405,3048726
1987-02-10,1987,133,D,1,1,14040,2324416,6189202,10290,1316695,3048726
1987-02-11,1987,134,D,1,1,13746,2338162,6189202,9824,1326519,3048726
1987-02-12,1987,135,D,1,1,14560,2352722,6189202,23231,1349750,3048726
1987-02-13,1987,136,D,1,1,21071,2373793,6189202,29299,1379049,3048726
1987-02-14,1987,137,D,1,1,31404,2405197,6189202,41123,1420172,3048726
1987-02-15,1987,138,D,1,1,37954,2443151,6189202,43049,1463221,3048726
1987-02-16,1987,139,D,1,1,36533,2479684,6189202,43422,1506643,3048726
1987-02-17,1987,140,D,1,1,33510,2513194,6189202,27725,1534368,3048726
1987-02-18,1987,141,D,1,1,27261,2540455,6189202,21542,1555910,3048726
1987-02-19,1987,142,D,1,1,23429,2563884,6189202,16695,1572605,3048726
1987-02-20,1987,143,D,1,1,21006,2584890,6189202,13988,1586593,3048726
1987-02-21,1987,144,D,1,1,18593,2603483,6189202,10444,1597037,3048726
1987-02-22,1987,145,D,1,1,17058,2620541,6189202,8548,1605585,3048726
1987-02-23,1987,146,D,1,1,16159,2636700,6189202,6999,1612584,3048726
1987-02-24,1987,147,D,1,1,15517,2652217,6189202,7847,1620431,3048726
1987-02-25,1987,148,D,1,1,15111,2667328,6189202,7969,1628400,3048726
1987-02-26,1987,149,D,1,1,14499,2681827,6189202,6758,1635158,3048726
1987-02-27,1987,150,D,1,1,14101,2695928,6189202,6081,1641239,3048726
1987-02-28,1987,151,D,1,1,13714,2709642,6189202,5568,1646807,3048726
1987-03-01,1987,152,D,1,1,13349,2722991,6189202,2503,1649310,3048726
1987-03-02,1987,153,D,1,1,13262,2736253,6189202,3866,1653176,3048726
1987-03-03,1987,154,D,1,1,13414,2749667,6189202,4209,1657385,3048726
1987-03-04,1987,155,D,1,1,13285,2762952,6189202,9888,1667273,3048726
1987-03-05,1987,156,D,1,1,16767,2779719,6189202,22451,1689724,3048726
1987-03-06,1987,157,D,1,1,25192,2804911,6189202,31359,1721083,3048726
1987-03-07,1987,158,D,1,1,35265,2840176,6189202,42007,1763090,3048726
1987-03-08,1987,159,D,1,1,37584,2877760,6189202,43268,1806358,3048726
1987-03-09,1987,160,D,1,1,31689,2909449,6189202,32715,1839073,3048726
1987-03-10,1987,161,D,1,1,26064,2935513,6189202,23206,1862279,3048726
1987-03-11,1987,162,D,1,1,23092,2958605,6189202,19178,1881457,3048726
1987-03-12,1987,163,D,1,1,20555,2979160,6189202,18089,1899546,3048726
1987-03-13,1987,164,D,1,1,23840,3003000,6189202,21410,1920956,3048726
1987-03-14,1987,165,D,1,1,35823,3038823,6189202,31762,1952718,3048726
1987-03-15,1987,166,D,1,1,42742,3081565,6189202,38828,1991546,3048726
1987-03-16,1987,167,D,1,1,44060,3125625,6189202,42229,2033775,3048726
1987-03-17,1987,168,D,1,1,43057,3168682,6189202,39180,2072955,3048726
1987-03-18,1987,169,D,1,1,38137,3206819,6189202,33934,2106889,3048726
1987-03-19,1987,170,D,1,1,33861,3240680,6189202,29398,2136287,3048726
1987-03-20,1987,171,D,1,1,30718,3271398,6189202,24826,2161113,3048726
1987-03-21,1987,172,D,1,1,28241,3299639,6189202,22716,2183829,3048726
1987-03-22,1987,173,D,1,1,26353,3325992,6189202,21310,2205139,3048726
1987-03-23,1987,174,D,1,1,25536,3351528,6189202,20801,2225940,3048726
1987-03-24,1987,175,D,1,1,25855,3377383,6189202,23145,2249085,3048726
1987-03-25,1987,176,D,1,1,25332,3402715,6189202,22501,2271586,3048726
1987-03-26,1987,177,D,1,1,24409,3427124,6189202,20216,2291802,3048726
1987-03-27,1987,178,D,1,1,22590,3449714,6189202,17145,2308947,3048726
1987-03-28,1987,179,D,1,1,20817,3470531,6189202,15112,2324059,3048726
1987-03-29,1987,180,D,1,1,19546,3490077,6189202,12084,2336143,3048726
1987-03-30,1987,181,D,1,1,18458,3508535,6189202,11317,2347460,3048726
1987-03-31,1987,182,D,1,1,17079,3525614,6189202,9742,2357202,3048726
1987-04-01,1987,183,D,1,1,16098,3541712,6189202,7886,2365088,3048726
1987-04-02,1987,184,D,1,1,15649,3557361,6189202,6910,2371998,3048726
1987-04-03,1987,185,D,1,1,15081,3572442,6189202,5969,2377967,3048726
1987-04-04,1987,186,D,1,1,15058,3587500,6189202,6283,2384250,3048726
1987-04-05,1987,187,D,1,1,15506,3603006,6189202,7022,2391272,3048726
1987-04-06,1987,188,D,1,1,15854,3618860,6189202,7191,2398463,3048726
1987-04-07,1987,189,D,1,1,15743,3634603,6189202,6459,2404922,3048726
1987-04-08,1987,190,D,1,1,14665,3649268,6189202,5561,2410483,3048726
1987-04-09,1987,191,D,1,1,13925,3663193,6189202,4895,2415378,3048726
1987-04-10,1987,192,D,1,1,13211,3676404,6189202,5354,2420732,3048726
1987-04-11,1987,193,D,1,1,13937,3690341,6189202,6884,2427616,3048726
1987-04-12,1987,194,D,1,1,14547,3704888,6189202,7559,2435175,3048726
1987-04-13,1987,195,D,1,1,15191,3720079,6189202,5841,2441016,3048726
1987-04-14,1987,196,D,1,1,15030,3735109,6189202,4314,2445330,3048726
1987-04-15,1987,197,D,1,1,15150,3750259,6189202,5533,2450863,3048726
1987-04-16,1987,198,D,1,1,14583,3764842,6189202,5438,2456301,3048726
1987-04-17,1987,199,D,1,1,13815,3778657,6189202,4647,2460948,3048726
1987-04-18,1987,200,D,1,1,15463,3794120,6189202,7131,2468079,3048726
1987-04-19,1987,201,D,1,1,15514,3809634,6189202,6503,2474582,3048726
1987-04-20,1987,202,D,1,1,15053,3824687,6189202,5288,2479870,3048726
1987-04-21,1987,203,D,1,1,15873,3840560,6189202,7137,2487007,3048726
1987-04-22,1987,204,D,1,1,16556,3857116,6189202,6395,2493402,3048726
1987-04-23,1987,205,D,1,1,16218,3873334,6189202,6163,2499565,3048726
1987-04-24,1987,206,D,1,1,16389,3889723,6189202,6655,2506220,3048726
1987-04-25,1987,207,D,1,1,16021,3905744,6189202,6257,2512477,3048726
1987-04-26,1987,208,D,1,1,15626,3921370,6189202,6357,2518834,3048726
1987-04-27,1987,209,D,1,1,15797,3937167,6189202,5559,2524393,3048726
1987-04-28,1987,210,D,1,1,14757,3951924,6189202,5869,2530262,3048726
1987-04-29,1987,211,D,1,1,14472,3966396,6189202,6155,2536417,3048726
1987-04-30,1987,212,D,1,1,14194,3980590,6189202,7152,2543569,3048726
1987-05-01,1987,213,D,1,1,14092,3994682,6189202,6153,2549722,3048726
1987-05-02,1987,214,D,1,1,13913,4008595,6189202,7461,2557183,3048726
1987-05-03,1987,215,D,1,1,13588,4022183,6189202,6988,2564171,3048726
1987-05-04,1987,216,D,1,1,13951,4036134,6189202,7267,2571438,3048726
1987-05-05,1987,217,D,1,1,13614,4049748,6189202,5471,2576909,3048726
1987-05-06,1987,218,D,1,1,12708,4062456,6189202,4121,2581030,3048726
1987-05-07,1987,219,D,1,1,11691,4074147,6189202,3753,2584783,3048726
1987-05-08,1987,220,D,1,1,11117,4085264,6189202,3518,2588301,3048726
1987-05-09,1987,221,D,1,1,11081,4096345,6189202,3726,2592027,3048726
1987-05-10,1987,222,D,1,1,11681,4108026,6189202,4975,2597002,3048726
1987-05-11,1987,223,D,1,1,12617,4120643,6189202,4601,2601603,3048726
1987-05-12,1987,224,D,1,1,13614,4134257,6189202,4936,2606539,3048726
1987-05-13,1987,225,D,1,1,13894,4148151,6189202,4733,2611272,3048726
1987-05-14,1987,226,D,1,1,13627,4161778,6189202,4108,2615380,3048726
1987-05-15,1987,227,D,1,1,14174,4175952,6189202,4489,2619869,3048726
1987-05-16,1987,228,D,1,1,14388,4190340,6189202,4341,2624210,3048726
1987-05-17,1987,229,D,1,1,14632,4204972,6189202,4275,2628485,3048726
1987-05-18,1987,230,D,1,1,14241,4219213,6189202,4000,2632485,3048726
1987-05-19,1987,231,D,1,1,13000,4232213,6189202,2848,2635333,3048726
1987-05-20,1987,232,D,1,1,12623,4244836,6189202,5251,2640584,3048726
1987-05-21,1987,233,D,1,1,12493,4257329,6189202,5274,2645858,3048726
1987-05-22,1987,234,D,1,1,12476,4269805,6189202,5528,2651386,3048726
1987-05-23,1987,235,D,1,1,11711,4281516,6189202,4678,2656064,3048726
1987-05-24,1987,236,D,1,1,11463,4292979,6189202,4420,2660484,3048726
1987-05-25,1987,237,D,1,1,11425,4304404,6189202,4827,2665311,3048726
1987-05-26,1987,238,D,1,1,11126,4315530,6189202,4886,2670197,3048726
1987-05-27,1987,239,D,1,1,10938,4326468,6189202,4805,2675002,3048726
1987-05-28,1987,240,D,1,1,10937,4337405,6189202,4665,2679667,3048726
1987-05-29,1987,241,D,1,1,10590,4347995,6189202,4082,2683749,3048726
1987-05-30,1987,242,D,1,1,10845,4358840,6189202,4597,2688346,3048726
1987-05-31,1987,243,D,1,1,12193,4371033,6189202,5419,2693765,3048726
1987-06-01,1987,244,D,1,1,12746,4383779,6189202,5142,2698907,3048726
1987-06-02,1987,245,D,1,1,12410,4396189,6189202,3407,2702314,3048726
1987-06-03,1987,246,D,1,1,12038,4408227,6189202,2812,2705126,3048726
1987-06-04,1987,247,D,1,1,11715,4419942,6189202,2516,2707642,3048726
1987-06-05,1987,248,D,1,1,11513,4431455,6189202,2868,2710510,3048726
1987-06-06,1987,249,D,1,1,10924,4442379,6189202,2952,2713462,3048726
1987-06-07,1987,250,D,1,1,10825,4453204,6189202,3277,2716739,3048726
1987-06-08,1987,251,D,1,1,11746,4464950,6189202,4156,2720895,3048726
1987-06-09,1987,252,D,1,1,12522,4477472,6189202,4755,2725650,3048726
1987-06-10,1987,253,D,1,1,12894,4490366,6189202,4635,2730285,3048726
1987-06-11,1987,254,D,1,1,12850,4503216,6189202,3317,2733602,3048726
1987-06-12,1987,255,D,1,1,13323,4516539,6189202,4356,2737958,3048726
1987-06-13,1987,256,D,1,1,12312,4528851,6189202,3182,2741140,3048726
1987-06-14,1987,257,D,1,1,12913,4541764,6189202,3730,2744870,3048726
1987-06-15,1987,258,D,1,1,13746,4555510,6189202,4758,2749628,3048726
1987-06-16,1987,259,D,1,1,13108,4568618,6189202,3264,2752892,3048726
1987-06-17,1987,260,D,1,1,13475,4582093,6189202,3702,2756594,3048726
1987-06-18,1987,261,D,1,1,13555,4595648,6189202,2531,2759125,3048726
1987-06-19,1987,262,D,1,1,12746,4608394,6189202,2117,2761242,3048726
1987-06-20,1987,263,D,1,1,12726,4621120,6189202,2687,2763929,3048726
1987-06-21,1987,264,D,1,1,13189,4634309,6189202,2794,2766723,3048726
1987-06-22,1987,265,D,1,1,13074,4647383,6189202,3119,2769842,3048726
1987-06-23,1987,266,D,1,1,12828,4660211,6189202,3930,2773772,3048726
1987-06-24,1987,267,D,1,1,12779,4672990,6189202,3822,2777594,3048726
1987-06-25,1987,268,D,1,1,11941,4684931,6189202,2566,2780160,3048726
1987-06-26,1987,269,D,1,1,11255,4696186,6189202,2337,2782497,3048726
1987-06-27,1987,270,D,1,1,10906,4707092,6189202,2703,2785200,3048726
1987-06-28,1987,271,D,1,1,11190,4718282,6189202,2929,2788129,3048726
1987-06-29,1987,272,D,1,1,11959,4730241,6189202,2971,2791100,3048726
1987-06-30,1987,273,D,1,1,13563,4743804,6189202,4130,2795230,3048726
1987-07-01,1987,274,D,1,1,15299,4759103,6189202,4261,2799491,3048726
1987-07-02,1987,275,D,1,1,15764,4774867,6189202,2930,2802421,3048726
1987-07-03,1987,276,D,1,1,15439,4790306,6189202,2246,2804667,3048726
1987-07-04,1987,277,D,1,1,16287,4806593,6189202,3553,2808220,3048726
1987-07-05,1987,278,D,1,1,16712,4823305,6189202,3390,2811610,3048726
1987-07-06,1987,279,D,1,1,17240,4840545,6189202,4689,2816299,3048726
1987-07-07,1987,280,D,1,1,17434,4857979,6189202,3989,2820288,3048726
1987-07-08,1987,281,D,1,1,17664,4875643,6189202,4087,2824375,3048726
1987-07-09,1987,282,D,1,1,17386,4893029,6189202,4048,2828423,3048726
1987-07-10,1987,283,D,1,1,16922,4909951,6189202,3731,2832154,3048726
1987-07-11,1987,284,D,1,1,17199,4927150,6189202,4427,2836581,3048726
1987-07-12,1987,285,D,1,1,17294,4944444,6189202,4551,2841132,3048726
1987-07-13,1987,286,D,1,1,17692,4962136,6189202,4262,2845394,3048726
1987-07-14,1987,287,D,1,1,17525,4979661,6189202,3351,2848745,3048726
1987-07-15,1987,288,D,1,1,17687,4997348,6189202,3771,2852516,3048726
1987-07-16,1987,289,D,1,1,16457,5013805,6189202,3177,2855693,3048726
1987-07-17,1987,290,D,1,1,16953,5030758,6189202,3431,2859124,3048726
1987-07-18,1987,291,D,1,1,16761,5047519,6189202,3673,2862797,3048726
1987-07-19,1987,292,D,1,1,17148,5064667,6189202,4056,2866853,3048726
1987-07-20,1987,293,D,1,1,16853,5081520,6189202,2662,2869515,3048726
1987-07-21,1987,294,D,1,1,17412,5098932,6189202,3773,2873288,3048726
1987-07-22,1987,295,D,1,1,17546,5116478,6189202,4340,2877628,3048726
1987-07-23,1987,296,D,1,1,17397,5133875,6189202,4010,2881638,3048726
1987-07-24,1987,297,D,1,1,17794,5151669,6189202,4445,2886083,3048726
1987-07-25,1987,298,D,1,1,18176,5169845,6189202,3667,2889750,3048726
1987-07-26,1987,299,D,1,1,17931,5187776,6189202,3522,2893272,3048726
1987-07-27,1987,300,D,1,1,18004,5205780,6189202,3402,2896674,3048726
1987-07-28,1987,301,D,1,1,17453,5223233,6189202,3529,2900203,3048726
1987-07-29,1987,302,D,1,1,17110,5240343,6189202,4186,2904389,3048726
1987-07-30,1987,303,D,1,1,17243,5257586,6189202,2938,2907327,3048726
1987-07-31,1987,304,D,1,1,17334,5274920,6189202,3342,2910669,3048726
1987-08-01,1987,305,D,1,1,17318,5292238,6189202,3330,2913999,3048726
1987-08-02,1987,306,D,1,1,17087,5309325,6189202,2796,2916795,3048726
1987-08-03,1987,307,D,1,1,17489,5326814,6189202,3193,2919988,3048726
1987-08-04,1987,308,D,1,1,17593,5344407,6189202,3090,2923078,3048726
1987-08-05,1987,309,D,1,1,18181,5362588,6189202,4029,2927107,3048726
1987-08-06,1987,310,D,1,1,17502,5380090,6189202,2868,2929975,3048726
1987-08-07,1987,311,D,1,1,17258,5397348,6189202,3757,2933732,3048726
1987-08-08,1987,312,D,1,1,17365,5414713,6189202,4181,2937913,3048726
1987-08-09,1987,313,D,1,1,17006,5431719,6189202,3757,2941670,3048726
1987-08-10,1987,314,D,1,1,16430,5448149,6189202,2306,2943976,3048726
1987-08-11,1987,315,D,1,1,15690,5463839,6189202,1710,2945686,3048726
1987-08-12,1987,316,D,1,1,16117,5479956,6189202,3166,2948852,3048726
1987-08-13,1987,317,D,1,1,15824,5495780,6189202,3027,2951879,3048726
1987-08-14,1987,318,D,1,1,16627,5512407,6189202,4017,2955896,3048726
1987-08-15,1987,319,D,1,1,16551,5528958,6189202,4047,2959943,3048726
1987-08-16,1987,320,D,1,1,16630,5545588,6189202,4077,2964020,3048726
1987-08-17,1987,321,D,1,1,16566,5562154,6189202,3459,2967479,3048726
1987-08-18,1987,322,D,1,1,16512,5578666,6189202,2806,2970285,3048726
1987-08-19,1987,323,D,1,1,16938,5595604,6189202,3423,2973708,3048726
1987-08-20,1987,324,D,1,1,16505,5612109,6189202,2622,2976330,3048726
1987-08-21,1987,325,D,1,1,15986,5628095,6189202,1892,2978222,3048726
1987-08-22,1987,326,D,1,1,15894,5643989,6189202,1495,2979717,3048726
1987-08-23,1987,327,D,1,1,16271,5660260,6189202,2300,2982017,3048726
1987-08-24,1987,328,D,1,1,16292,5676552,6189202,1917,2983934,3048726
1987-08-25,1987,329,D,1,1,15909,5692461,6189202,1673,2985607,3048726
1987-08-26,1987,330,D,1,1,15638,5708099,6189202,1920,2987527,3048726
1987-08-27,1987,331,D,1,1,16083,5724182,6189202,2374,2989901,3048726
1987-08-28,1987,332,D,1,1,15804,5739986,6189202,1888,2991789,3048726
1987-08-29,1987,333,D,1,1,14954,5754940,6189202,1687,2993476,3048726
1987-08-30,1987,334,D,1,1,14441,5769381,6189202,1222,2994698,3048726
1987-08-31,1987,335,D,1,1,15067,5784448,6189202,1907,2996605,3048726
1987-09-01,1987,336,D,1,1,15388,5799836,6189202,1761,2998366,3048726
1987-09-02,1987,337,D,1,1,14730,5814566,6189202,578,2998944,3048726
1987-09-03,1987,338,D,1,1,14124,5828690,6189202,392,2999336,3048726
1987-09-04,1987,339,D,1,1,13673,5842363,6189202,1184,3000520,3048726
1987-09-05,1987,340,D,1,1,13840,5856203,6189202,1723,3002243,3048726
1987-09-06,1987,341,D,1,1,13502,5869705,6189202,793,3003036,3048726
1987-09-07,1987,342,D,1,1,14060,5883765,6189202,1810,3004846,3048726
1987-09-08,1987,343,D,1,1,14122,5897887,6189202,1166,3006012,3048726
1987-09-09,1987,344,D,1,1,13579,5911466,6189202,674,3006686,3048726
1987-09-10,1987,345,D,1,1,14138,5925604,6189202,1968,3008654,3048726
1987-09-11,1987,346,D,1,1,13958,5939562,6189202,1654,3010308,3048726
1987-09-12,1987,347,D,1,1,13768,5953330,6189202,1834,3012142,3048726
1987-09-13,1987,348,D,1,1,14417,5967747,6189202,2854,3014996,3048726
1987-09-14,1987,349,D,1,1,14984,5982731,6189202,2259,3017255,3048726
1987-09-15,1987,350,D,1,1,14458,5997189,6189202,873,3018128,3048726
1987-09-16,1987,351,D,1,1,13682,6010871,6189202,397,3018525,3048726
1987-09-17,1987,352,D,1,1,13466,6024337,6189202,896,3019421,3048726
1987-09-18,1987,353,D,1,1,13363,6037700,6189202,1437,3020858,3048726
1987-09-19,1987,354,D,1,1,12787,6050487,6189202,1382,3022240,3048726
1987-09-20,1987,355,D,1,1,12009,6062496,6189202,1134,3023374,3048726
1987-09-21,1987,356,D,1,1,11702,6074198,6189202,1322,3024696,3048726
1987-09-22,1987,357,D,1,1,11642,6085840,6189202,1895,3026591,3048726
1987-09-23,1987,358,D,1,1,12163,6098003,6189202,2529,3029120,3048726
1987-09-24,1987,359,D,1,1,12186,6110189,6189202,2238,3031358,3048726
1987-09-25,1987,360,D,1,1,12672,6122861,6189202,3001,3034359,3048726
1987-09-26,1987,361,D,1,1,12891,6135752,6189202,2696,3037055,3048726
1987-09-27,1987,362,D,1,1,13385,6149137,6189202,2814,3039869,3048726
1987-09-28,1987,363,D,1,1,13398,6162535,6189202,2357,3042226,3048726
1987-09-29,1987,364,D,1,1,13386,6175921,6189202,2781,3045007,3048726
1987-09-30,1987,365,D,1,1,13281,6189202,6189202,3719,3048726,3048726
1987-10-01,1988,1,D,2,2,13202,13202,5615480,4193,4193,2206822
1987-10-02,1988,2,D,2,2,13908,27110,5615480,7512,11705,2206822
1987-10-03,1988,3,D,2,2,13625,40735,5615480,4666,16371,2206822
1987-10-04,1988,4,D,2,2,13193,53928,5615480,4486,20857,2206822
1987-10-05,1988,5,D,2,2,12977,66905,5615480,4080,24937,2206822
1987-10-06,1988,6,D,2,2,13407,80312,5615480,4414,29351,2206822
1987-10-07,1988,7,D,2,2,12314,92626,5615480,3448,32799,2206822
1987-10-08,1988,8,D,2,2,12488,105114,5615480,4093,36892,2206822
1987-10-09,1988,9,D,2,2,12196,117310,5615480,3469,40361,2206822
1987-10-10,1988,10,D,2,2,12713,130023,5615480,4140,44501,2206822
1987-10-11,1988,11,D,2,2,12190,142213,5615480,3500,48001,2206822
1987-10-12,1988,12,D,2,2,12116,154329,5615480,3704,51705,2206822
1987-10-13,1988,13,D,2,2,12080,166409,5615480,4555,56260,2206822
1987-10-14,1988,14,D,2,2,11726,178135,5615480,3455,59715,2206822
1987-10-15,1988,15,D,2,2,10790,188925,5615480,2785,62500,2206822
1987-10-16,1988,16,D,2,2,11340,200265,5615480,4192,66692,2206822
1987-10-17,1988,17,D,2,2,10723,210988,5615480,2433,69125,2206822
1987-10-18,1988,18,D,2,2,9882,220870,5615480,1926,71051,2206822
1987-10-19,1988,19,D,2,2,9539,230409,5615480,2141,73192,2206822
1987-10-20,1988,20,D,2,2,9626,240035,5615480,2597,75789,2206822
1987-10-21,1988,21,D,2,2,9865,249900,5615480,2640,78429,2206822
1987-10-22,1988,22,D,2,2,9189,259089,5615480,2506,80935,2206822
1987-10-23,1988,23,D,2,2,8997,268086,5615480,3031,83966,2206822
1987-10-24,1988,24,D,2,2,8791,276877,5615480,4924,88890,2206822
1987-10-25,1988,25,D,2,2,8899,285776,5615480,5280,94170,2206822
1987-10-26,1988,26,D,2,2,8841,294617,5615480,4999,99169,2206822
1987-10-27,1988,27,D,2,2,8525,303142,5615480,3853,103022,2206822
1987-10-28,1988,28,D,2,2,9033,312175,5615480,5213,108235,2206822
1987-10-29,1988,29,D,2,2,9506,321681,5615480,3259,111494,2206822
1987-10-30,1988,30,D,2,2,10518,332199,5615480,3309,114803,2206822
1987-10-31,1988,31,D,2,2,9569,341768,5615480,1796,116599,2206822
1987-11-01,1988,32,D,2,2,9243,351011,5615480,1966,118565,2206822
1987-11-02,1988,33,D,2,2,9756,360767,5615480,2499,121064,2206822
1987-11-03,1988,34,D,2,2,9237,370004,5615480,1588,122652,2206822
1987-11-04,1988,35,D,2,2,9162,379166,5615480,2018,124670,2206822
1987-11-05,1988,36,D,2,2,9223,388389,5615480,2182,126852,2206822
1987-11-06,1988,37,D,2,2,9573,397962,5615480,2366,129218,2206822
1987-11-07,1988,38,D,2,2,9072,407034,5615480,3118,132336,2206822
1987-11-08,1988,39,D,2,2,8900,415934,5615480,2977,135313,2206822
1987-11-09,1988,40,D,2,2,9046,424980,5615480,4271,139584,2206822
1987-11-10,1988,41,D,2,2,8973,433953,5615480,4733,144317,2206822
1987-11-11,1988,42,D,2,2,9093,443046,5615480,5074,149391,2206822
1987-11-12,1988,43,D,2,2,9146,452192,5615480,4113,153504,2206822
1987-11-13,1988,44,D,2,2,9284,461476,5615480,4140,157644,2206822
1987-11-14,1988,45,D,2,2,10300,471776,5615480,5214,162858,2206822
1987-11-15,1988,46,D,2,2,9883,481659,5615480,3119,165977,2206822
1987-11-16,1988,47,D,2,2,9680,491339,5615480,4402,170379,2206822
1987-11-17,1988,48,D,2,2,10201,501540,5615480,7826,178205,2206822
1987-11-18,1988,49,D,2,2,10527,512067,5615480,7608,185813,2206822
1987-11-19,1988,50,D,2,2,10401,522468,5615480,5651,191464,2206822
1987-11-20,1988,51,D,2,2,10068,532536,5615480,7644,199108,2206822
1987-11-21,1988,52,D,2,2,10738,543274,5615480,8009,207117,2206822
1987-11-22,1988,53,D,2,2,10529,553803,5615480,5613,212730,2206822
1987-11-23,1988,54,D,2,2,10582,564385,5615480,6225,218955,2206822
1987-11-24,1988,55,D,2,2,10386,574771,5615480,5448,224403,2206822
1987-11-25,1988,56,D,2,2,10648,585419,5615480,3349,227752,2206822
1987-11-26,1988,57,D,2,2,9986,595405,5615480,2042,229794,2206822
1987-11-27,1988,58,D,2,2,9887,605292,5615480,1997,231791,2206822
1987-11-28,1988,59,D,2,2,10067,615359,5615480,1940,233731,2206822
1987-11-29,1988,60,D,2,2,10484,625843,5615480,2886,236617,2206822
1987-11-30,1988,61,D,2,2,10367,636210,5615480,8713,245330,2206822
1987-12-01,1988,62,D,2,2,10813,647023,5615480,8653,253983,2206822
1987-12-02,1988,63,D,2,2,10617,657640,5615480,8912,262895,2206822
1987-12-03,1988,64,D,2,2,12242,669882,5615480,11546,274441,2206822
1987-12-04,1988,65,D,2,2,16979,686861,5615480,20140,294581,2206822
1987-12-05,1988,66,D,2,2,20379,707240,5615480,18504,313085,2206822
1987-12-06,1988,67,D,2,2,18245,725485,5615480,15498,328583,2206822
1987-12-07,1988,68,D,2,2,18411,743896,5615480,16785,345368,2206822
1987-12-08,1988,69,D,2,2,19879,763775,5615480,19241,364609,2206822
1987-12-09,1988,70,D,2,2,23358,787133,5615480,17821,382430,2206822
1987-12-10,1988,71,D,2,2,23437,810570,5615480,14300,396730,2206822
1987-12-11,1988,72,D,2,2,25100,835670,5615480,14829,411559,2206822
1987-12-12,1988,73,D,2,2,28941,864611,5615480,16492,428051,2206822
1987-12-13,1988,74,D,2,2,27825,892436,5615480,16499,444550,2206822
1987-12-14,1988,75,D,2,2,23301,915737,5615480,11475,456025,2206822
1987-12-15,1988,76,D,2,2,19791,935528,5615480,7916,463941,2206822
1987-12-16,1988,77,D,2,2,17598,953126,5615480,5278,469219,2206822
1987-12-17,1988,78,D,2,2,16220,969346,5615480,4346,473565,2206822
1987-12-18,1988,79,D,2,2,16408,985754,5615480,5466,479031,2206822
1987-12-19,1988,80,D,2,2,16674,1002428,5615480,5508,484539,2206822
1987-12-20,1988,81,D,2,2,16219,1018647,5615480,4992,489531,2206822
1987-12-21,1988,82,D,2,2,14709,1033356,5615480,2659,492190,2206822
1987-12-22,1988,83,D,2,2,13912,1047268,5615480,2514,494704,2206822
1987-12-23,1988,84,D,2,2,13241,1060509,5615480,3094,497798,2206822
1987-12-24,1988,85,D,2,2,13064,1073573,5615480,2995,500793,2206822
1987-12-25,1988,86,D,2,2,12922,1086495,5615480,2536,503329,2206822
1987-12-26,1988,87,D,2,2,12809,1099304,5615480,2129,505458,2206822
1987-12-27,1988,88,D,2,2,12780,1112084,5615480,3667,509125,2206822
1987-12-28,1988,89,D,2,2,12732,1124816,5615480,4245,513370,2206822
1987-12-29,1988,90,D,2,2,12972,1137788,5615480,6124,519494,2206822
1987-12-30,1988,91,D,2,2,13841,1151629,5615480,7468,526962,2206822
1987-12-31,1988,92,D,2,2,17829,1169458,5615480,11445,538407,2206822
1988-01-01,1988,93,D,2,2,17954,1187412,5615480,8377,546784,2206822
1988-01-02,1988,94,D,2,2,16151,1203563,5615480,6594,553378,2206822
1988-01-03,1988,95,D,2,2,15197,1218760,5615480,5634,559012,2206822
1988-01-04,1988,96,D,2,2,16556,1235316,5615480,8253,567265,2206822
1988-01-05,1988,97,D,2,2,32237,1267553,5615480,24729,591994,2206822
1988-01-06,1988,98,D,2,2,41110,1308663,5615480,33697,625691,2206822
1988-01-07,1988,99,D,2,2,42023,1350686,5615480,34119,659810,2206822
1988-01-08,1988,100,D,2,2,41517,1392203,5615480,32060,691870,2206822
1988-01-09,1988,101,D,2,2,39546,1431749,5615480,28918,720788,2206822
1988-01-10,1988,102,D,2,2,38241,1469990,5615480,26773,747561,2206822
1988-01-11,1988,103,D,2,2,38791,1508781,5615480,27951,775512,2206822
1988-01-12,1988,104,D,2,2,39386,1548167,5615480,28664,804176,2206822
1988-01-13,1988,105,D,2,2,37920,1586087,5615480,27079,831255,2206822
1988-01-14,1988,106,D,2,2,34779,1620866,5615480,22969,854224,2206822
1988-01-15,1988,107,D,2,2,31104,1651970,5615480,20863,875087,2206822
1988-01-16,1988,108,D,2,2,29421,1681391,5615480,18793,893880,2206822
1988-01-17,1988,109,D,2,2,35024,1716415,5615480,30307,924187,2206822
1988-01-18,1988,110,D,2,2,40364,1756779,5615480,37194,961381,2206822
1988-01-19,1988,111,D,2,2,39163,1795942,5615480,36712,998093,2206822
1988-01-20,1988,112,D,2,2,34605,1830547,5615480,30455,1028548,2206822
1988-01-21,1988,113,D,2,2,30006,1860553,5615480,25015,1053563,2206822
1988-01-22,1988,114,D,2,2,25745,1886298,5615480,16790,1070353,2206822
1988-01-23,1988,115,D,2,2,23447,1909745,5615480,12124,1082477,2206822
1988-01-24,1988,116,D,2,2,21757,1931502,5615480,10648,1093125,2206822
1988-01-25,1988,117,D,2,2,20191,1951693,5615480,9172,1102297,2206822
1988-01-26,1988,118,D,2,2,19048,1970741,5615480,7644,1109941,2206822
1988-01-27,1988,119,D,2,2,18646,1989387,5615480,7103,1117044,2206822
1988-01-28,1988,120,D,2,2,18245,2007632,5615480,6687,1123731,2206822
1988-01-29,1988,121,D,2,2,17957,2025589,5615480,6698,1130429,2206822
1988-01-30,1988,122,D,2,2,17893,2043482,5615480,7355,1137784,2206822
1988-01-31,1988,123,D,2,2,18423,2061905,5615480,7935,1145719,2206822
1988-02-01,1988,124,D,2,2,21097,2083002,5615480,10534,1156253,2206822
1988-02-02,1988,125,D,2,2,20779,2103781,5615480,10191,1166444,2206822
1988-02-03,1988,126,D,2,2,19461,2123242,5615480,8559,1175003,2206822
1988-02-04,1988,127,D,2,2,18109,2141351,5615480,6765,1181768,2206822
1988-02-05,1988,128,D,2,2,17074,2158425,5615480,5674,1187442,2206822
1988-02-06,1988,129,D,2,2,15958,2174383,5615480,4551,1191993,2206822
1988-02-07,1988,130,D,2,2,15468,2189851,5615480,4022,1196015,2206822
1988-02-08,1988,131,D,2,2,14854,2204705,5615480,3430,1199445,2206822
1988-02-09,1988,132,D,2,2,14642,2219347,5615480,3183,1202628,2206822
1988-02-10,1988,133,D,2,2,14365,2233712,5615480,2931,1205559,2206822
1988-02-11,1988,134,D,2,2,13650,2247362,5615480,2180,1207739,2206822
1988-02-12,1988,135,D,2,2,13309,2260671,5615480,2929,1210668,2206822
1988-02-13,1988,136,D,2,2,13291,2273962,5615480,1821,1212489,2206822
1988-02-14,1988,137,D,2,2,13362,2287324,5615480,1858,1214347,2206822
1988-02-15,1988,138,D,2,2,13034,2300358,5615480,1520,1215867,2206822
1988-02-16,1988,139,D,2,2,13133,2313491,5615480,1624,1217491,2206822
1988-02-17,1988,140,D,2,2,12509,2326000,5615480,1019,1218510,2206822
1988-02-18,1988,141,D,2,2,12893,2338893,5615480,1392,1219902,2206822
1988-02-19,1988,142,D,2,2,11869,2350762,5615480,544,1220446,2206822
1988-02-20,1988,143,D,2,2,11290,2362052,5615480,-27,1220419,2206822
1988-02-21,1988,144,D,2,2,11120,2373172,5615480,-155,1220264,2206822
1988-02-22,1988,145,D,2,2,10986,2384158,5615480,-478,1219786,2206822
1988-02-23,1988,146,D,2,2,11032,2395190,5615480,450,1220236,2206822
1988-02-24,1988,147,D,2,2,10942,2406132,5615480,1697,1221933,2206822
1988-02-25,1988,148,D,2,2,10808,2416940,5615480,1800,1223733,2206822
1988-02-26,1988,149,D,2,2,10420,2427360,5615480,1365,1225098,2206822
1988-02-27,1988,150,D,2,2,10662,2438022,5615480,1569,1226667,2206822
1988-02-28,1988,151,D,2,2,11261,2449283,5615480,3182,1229849,2206822
1988-02-29,1988,152,D,2,2,11739,2461022,5615480,4010,1233859,2206822
1988-03-01,1988,153,D,2,2,12247,2473269,5615480,5010,1238869,2206822
1988-03-02,1988,154,D,2,2,13354,2486623,5615480,7240,1246109,2206822
1988-03-03,1988,155,D,2,2,13471,2500094,5615480,6156,1252265,2206822
1988-03-04,1988,156,D,2,2,13509,2513603,5615480,4688,1256953,2206822
1988-03-05,1988,157,D,2,2,13293,2526896,5615480,3451,1260404,2206822
1988-03-06,1988,158,D,2,2,13001,2539897,5615480,3397,1263801,2206822
1988-03-07,1988,159,D,2,2,13029,2552926,5615480,2769,1266570,2206822
1988-03-08,1988,160,D,2,2,12802,2565728,5615480,2690,1269260,2206822
1988-03-09,1988,161,D,2,2,12673,2578401,5615480,2229,1271489,2206822
1988-03-10,1988,162,D,2,2,12582,2590983,5615480,2176,1273665,2206822
1988-03-11,1988,163,D,2,2,12058,2603041,5615480,1876,1275541,2206822
1988-03-12,1988,164,D,2,2,11718,2614759,5615480,2523,1278064,2206822
1988-03-13,1988,165,D,2,2,11487,2626246,5615480,1960,1280024,2206822
1988-03-14,1988,166,D,2,2,11450,2637696,5615480,2211,1282235,2206822
1988-03-15,1988,167,D,2,2,11767,2649463,5615480,2691,1284926,2206822
1988-03-16,1988,168,D,2,2,12334,2661797,5615480,1211,1286137,2206822
1988-03-17,1988,169,D,2,2,12560,2674357,5615480,3757,1289894,2206822
1988-03-18,1988,170,D,2,2,12253,2686610,5615480,5208,1295102,2206822
1988-03-19,1988,171,D,2,2,12171,2698781,5615480,4225,1299327,2206822
1988-03-20,1988,172,D,2,2,12888,2711669,5615480,2005,1301332,2206822
1988-03-21,1988,173,D,2,2,14359,2726028,5615480,3775,1305107,2206822
1988-03-22,1988,174,D,2,2,15950,2741978,5615480,5257,1310364,2206822
1988-03-23,1988,175,D,2,2,16730,2758708,5615480,6742,1317106,2206822
1988-03-24,1988,176,D,2,2,16450,2775158,5615480,6855,1323961,2206822
1988-03-25,1988,177,D,2,2,15905,2791063,5615480,5875,1329836,2206822
1988-03-26,1988,178,D,2,2,15283,2806346,5615480,5003,1334839,2206822
1988-03-27,1988,179,D,2,2,15701,2822047,5615480,5399,1340238,2206822
1988-03-28,1988,180,D,2,2,16906,2838953,5615480,6567,1346805,2206822
1988-03-29,1988,181,D,2,2,17066,2856019,5615480,6850,1353655,2206822
1988-03-30,1988,182,D,2,2,17741,2873760,5615480,9742,1363397,2206822
1988-03-31,1988,183,D,2,2,17542,2891302,5615480,9362,1372759,2206822
1988-04-01,1988,184,D,2,2,17406,2908708,5615480,9169,1381928,2206822
1988-04-02,1988,185,D,2,2,17268,2925976,5615480,9014,1390942,2206822
1988-04-03,1988,186,D,2,2,17586,2943562,5615480,9544,1400486,2206822
1988-04-04,1988,187,D,2,2,18411,2961973,5615480,10130,1410616,2206822
1988-04-05,1988,188,D,2,2,19378,2981351,5615480,10983,1421599,2206822
1988-04-06,1988,189,D,2,2,19365,3000716,5615480,9784,1431383,2206822
1988-04-07,1988,190,D,2,2,18897,3019613,5615480,8486,1439869,2206822
1988-04-08,1988,191,D,2,2,19005,3038618,5615480,10048,1449917,2206822
1988-04-09,1988,192,D,2,2,18989,3057607,5615480,9434,1459351,2206822
1988-04-10,1988,193,D,2,2,19144,3076751,5615480,9440,1468791,2206822
1988-04-11,1988,194,D,2,2,19599,3096350,5615480,9899,1478690,2206822
1988-04-12,1988,195,D,2,2,19801,3116151,5615480,9431,1488121,2206822
1988-04-13,1988,196,D,2,2,19987,3136138,5615480,9438,1497559,2206822
1988-04-14,1988,197,D,2,2,20359,3156497,5615480,9918,1507477,2206822
1988-04-15,1988,198,D,2,2,20381,3176878,5615480,9980,1517457,2206822
1988-04-16,1988,199,D,2,2,20504,3197382,5615480,10216,1527673,2206822
1988-04-17,1988,200,D,2,2,20201,3217583,5615480,9902,1537575,2206822
1988-04-18,1988,201,D,2,2,20084,3237667,5615480,10053,1547628,2206822
1988-04-19,1988,202,D,2,2,20510,3258177,5615480,11301,1558929,2206822
1988-04-20,1988,203,D,2,2,22776,3280953,5615480,21455,1580384,2206822
1988-04-21,1988,204,D,2,2,23979,3304932,5615480,22120,1602504,2206822
1988-04-22,1988,205,D,2,2,23125,3328057,5615480,21017,1623521,2206822
1988-04-23,1988,206,D,2,2,21826,3349883,5615480,24210,1647731,2206822
1988-04-24,1988,207,D,2,2,20204,3370087,5615480,21108,1668839,2206822
1988-04-25,1988,208,D,2,2,20122,3390209,5615480,13557,1682396,2206822
1988-04-26,1988,209,D,2,2,19418,3409627,5615480,11691,1694087,2206822
1988-04-27,1988,210,D,2,2,17703,3427330,5615480,9489,1703576,2206822
1988-04-28,1988,211,D,2,2,16627,3443957,5615480,4367,1707943,2206822
1988-04-29,1988,212,D,2,2,14927,3458884,5615480,3476,1711419,2206822
1988-04-30,1988,213,D,2,2,13510,3472394,5615480,3863,1715282,2206822
1988-05-01,1988,214,D,2,2,11833,3484227,5615480,3571,1718853,2206822
1988-05-02,1988,215,D,2,2,10791,3495018,5615480,2828,1721681,2206822
1988-05-03,1988,216,D,2,2,9809,3504827,5615480,1987,1723668,2206822
1988-05-04,1988,217,D,2,2,10090,3514917,5615480,2665,1726333,2206822
1988-05-05,1988,218,D,2,2,11837,3526754,5615480,4339,1730672,2206822
1988-05-06,1988,219,D,2,2,13793,3540547,5615480,5091,1735763,2206822
1988-05-07,1988,220,D,2,2,14314,3554861,5615480,6322,1742085,2206822
1988-05-08,1988,221,D,2,2,15250,3570111,5615480,8070,1750155,2206822
1988-05-09,1988,222,D,2,2,15968,3586079,5615480,7970,1758125,2206822
1988-05-10,1988,223,D,2,2,17672,3603751,5615480,8992,1767117,2206822
1988-05-11,1988,224,D,2,2,17994,3621745,5615480,8479,1775596,2206822
1988-05-12,1988,225,D,2,2,17673,3639418,5615480,6881,1782477,2206822
1988-05-13,1988,226,D,2,2,17403,3656821,5615480,6395,1788872,2206822
1988-05-14,1988,227,D,2,2,16028,3672849,5615480,4809,1793681,2206822
1988-05-15,1988,228,D,2,2,14340,3687189,5615480,2815,1796496,2206822
1988-05-16,1988,229,D,2,2,13455,3700644,5615480,2209,1798705,2206822
1988-05-17,1988,230,D,2,2,12696,3713340,5615480,3463,1802168,2206822
1988-05-18,1988,231,D,2,2,12570,3725910,5615480,3725,1805893,2206822
1988-05-19,1988,232,D,2,2,13335,3739245,5615480,4641,1810534,2206822
1988-05-20,1988,233,D,2,2,13544,3752789,5615480,4118,1814652,2206822
1988-05-21,1988,234,D,2,2,12576,3765365,5615480,4026,1818678,2206822
1988-05-22,1988,235,D,2,2,11964,3777329,5615480,2328,1821006,2206822
1988-05-23,1988,236,D,2,2,11210,3788539,5615480,2801,1823807,2206822
1988-05-24,1988,237,D,2,2,10365,3798904,5615480,2967,1826774,2206822
1988-05-25,1988,238,D,2,2,10569,3809473,5615480,4868,1831642,2206822
1988-05-26,1988,239,D,2,2,10191,3819664,5615480,4280,1835922,2206822
1988-05-27,1988,240,D,2,2,10393,3830057,5615480,4230,1840152,2206822
1988-05-28,1988,241,D,2,2,10213,3840270,5615480,4085,1844237,2206822
1988-05-29,1988,242,D,2,2,10669,3850939,5615480,4505,1848742,2206822
1988-05-30,1988,243,D,2,2,11648,3862587,5615480,5708,1854450,2206822
1988-05-31,1988,244,D,2,2,12536,3875123,5615480,5250,1859700,2206822
1988-06-01,1988,245,D,2,2,12677,3887800,5615480,3875,1863575,2206822
1988-06-02,1988,246,D,2,2,12229,3900029,5615480,2711,1866286,2206822
1988-06-03,1988,247,D,2,2,11963,3911992,5615480,2340,1868626,2206822
1988-06-04,1988,248,D,2,2,11825,3923817,5615480,3004,1871630,2206822
1988-06-05,1988,249,D,2,2,11550,3935367,5615480,2829,1874459,2206822
1988-06-06,1988,250,D,2,2,11764,3947131,5615480,2812,1877271,2206822
1988-06-07,1988,251,D,2,2,11797,3958928,5615480,2882,1880153,2206822
1988-06-08,1988,252,D,2,2,12256,3971184,5615480,3335,1883488,2206822
1988-06-09,1988,253,D,2,2,12349,3983533,5615480,2288,1885776,2206822
1988-06-10,1988,254,D,2,2,12995,3996528,5615480,2658,1888434,2206822
1988-06-11,1988,255,D,2,2,12381,4008909,5615480,2358,1890792,2206822
1988-06-12,1988,256,D,2,2,11742,4020651,5615480,3291,1894083,2206822
1988-06-13,1988,257,D,2,2,11015,4031666,5615480,3123,1897206,2206822
1988-06-14,1988,258,D,2,2,9837,4041503,5615480,3178,1900384,2206822
1988-06-15,1988,259,D,2,2,8955,4050458,5615480,3549,1903933,2206822
1988-06-16,1988,260,D,2,2,9987,4060445,5615480,4133,1908066,2206822
1988-06-17,1988,261,D,2,2,12377,4072822,5615480,4473,1912539,2206822
1988-06-18,1988,262,D,2,2,14457,4087279,5615480,5198,1917737,2206822
1988-06-19,1988,263,D,2,2,14284,4101563,5615480,2629,1920366,2206822
1988-06-20,1988,264,D,2,2,13747,4115310,5615480,2379,1922745,2206822
1988-06-21,1988,265,D,2,2,13380,4128690,5615480,2853,1925598,2206822
1988-06-22,1988,266,D,2,2,13114,4141804,5615480,2468,1928066,2206822
1988-06-23,1988,267,D,2,2,14034,4155838,5615480,3690,1931756,2206822
1988-06-24,1988,268,D,2,2,15052,4170890,5615480,4149,1935905,2206822
1988-06-25,1988,269,D,2,2,15482,4186372,5615480,3753,1939658,2206822
1988-06-26,1988,270,D,2,2,15131,4201503,5615480,3497,1943155,2206822
1988-06-27,1988,271,D,2,2,13131,4214634,5615480,1207,1944362,2206822
1988-06-28,1988,272,D,2,2,11651,4226285,5615480,1477,1945839,2206822
1988-06-29,1988,273,D,2,2,12010,4238295,5615480,3133,1948972,2206822
1988-06-30,1988,274,D,2,2,12949,4251244,5615480,3190,1952162,2206822
1988-07-01,1988,275,D,2,2,13852,4265096,5615480,2685,1954847,2206822
1988-07-02,1988,276,D,2,2,14209,4279305,5615480,2816,1957663,2206822
1988-07-03,1988,277,D,2,2,14323,4293628,5615480,2515,1960178,2206822
1988-07-04,1988,278,D,2,2,15105,4308733,5615480,3486,1963664,2206822
1988-07-05,1988,279,D,2,2,15492,4324225,5615480,2903,1966567,2206822
1988-07-06,1988,280,D,2,2,15881,4340106,5615480,2085,1968652,2206822
1988-07-07,1988,281,D,2,2,15164,4355270,5615480,1996,1970648,2206822
1988-07-08,1988,282,D,2,2,14766,4370036,5615480,1471,1972119,2206822
1988-07-09,1988,283,D,2,2,14965,4385001,5615480,1815,1973934,2206822
1988-07-10,1988,284,D,2,2,14857,4399858,5615480,1669,1975603,2206822
1988-07-11,1988,285,D,2,2,14731,4414589,5615480,2935,1978538,2206822
1988-07-12,1988,286,D,2,2,15493,4430082,5615480,4039,1982577,2206822
1988-07-13,1988,287,D,2,2,15737,4445819,5615480,2175,1984752,2206822
1988-07-14,1988,288,D,2,2,16070,4461889,5615480,5658,1990410,2206822
1988-07-15,1988,289,D,2,2,16773,4478662,5615480,5089,1995499,2206822
1988-07-16,1988,290,D,2,2,16875,4495537,5615480,5068,2000567,2206822
1988-07-17,1988,291,D,2,2,16891,4512428,5615480,3735,2004302,2206822
1988-07-18,1988,292,D,2,2,16683,4529111,5615480,4080,2008382,2206822
1988-07-19,1988,293,D,2,2,16513,4545624,5615480,4205,2012587,2206822
1988-07-20,1988,294,D,2,2,16843,4562467,5615480,4629,2017216,2206822
1988-07-21,1988,295,D,2,2,17088,4579555,5615480,5025,2022241,2206822
1988-07-22,1988,296,D,2,2,17584,4597139,5615480,4781,2027022,2206822
1988-07-23,1988,297,D,2,2,17402,4614541,5615480,4180,2031202,2206822
1988-07-24,1988,298,D,2,2,17492,4632033,5615480,4452,2035654,2206822
1988-07-25,1988,299,D,2,2,17807,4649840,5615480,4871,2040525,2206822
1988-07-26,1988,300,D,2,2,17476,4667316,5615480,4689,2045214,2206822
1988-07-27,1988,301,D,2,2,18329,4685645,5615480,5706,2050920,2206822
1988-07-28,1988,302,D,2,2,17991,4703636,5615480,5278,2056198,2206822
1988-07-29,1988,303,D,2,2,18388,4722024,5615480,4362,2060560,2206822
1988-07-30,1988,304,D,2,2,16197,4738221,5615480,2934,2063494,2206822
1988-07-31,1988,305,D,2,2,16415,4754636,5615480,4349,2067843,2206822
1988-08-01,1988,306,D,2,2,17118,4771754,5615480,4365,2072208,2206822
1988-08-02,1988,307,D,2,2,16980,4788734,5615480,3023,2075231,2206822
1988-08-03,1988,308,D,2,2,17237,4805971,5615480,3825,2079056,2206822
1988-08-04,1988,309,D,2,2,17186,4823157,5615480,2702,2081758,2206822
1988-08-05,1988,310,D,2,2,16384,4839541,5615480,2115,2083873,2206822
1988-08-06,1988,311,D,2,2,16379,4855920,5615480,2161,2086034,2206822
1988-08-07,1988,312,D,2,2,16659,4872579,5615480,2417,2088451,2206822
1988-08-08,1988,313,D,2,2,16871,4889450,5615480,2121,2090572,2206822
1988-08-09,1988,314,D,2,2,16481,4905931,5615480,1788,2092360,2206822
1988-08-10,1988,315,D,2,2,15331,4921262,5615480,1315,2093675,2206822
1988-08-11,1988,316,D,2,2,14580,4935842,5615480,972,2094647,2206822
1988-08-12,1988,317,D,2,2,14739,4950581,5615480,2281,2096928,2206822
1988-08-13,1988,318,D,2,2,14139,4964720,5615480,2909,2099837,2206822
1988-08-14,1988,319,D,2,2,14656,4979376,5615480,1528,2101365,2206822
1988-08-15,1988,320,D,2,2,15473,4994849,5615480,2856,2104221,2206822
1988-08-16,1988,321,D,2,2,15820,5010669,5615480,2548,2106769,2206822
1988-08-17,1988,322,D,2,2,16063,5026732,5615480,2079,2108848,2206822
1988-08-18,1988,323,D,2,2,16008,5042740,5615480,2216,2111064,2206822
1988-08-19,1988,324,D,2,2,15449,5058189,5615480,1236,2112300,2206822
1988-08-20,1988,325,D,2,2,15163,5073352,5615480,1261,2113561,2206822
1988-08-21,1988,326,D,2,2,14428,5087780,5615480,861,2114422,2206822
1988-08-22,1988,327,D,2,2,14503,5102283,5615480,1943,2116365,2206822
1988-08-23,1988,328,D,2,2,13411,5115694,5615480,1673,2118038,2206822
1988-08-24,1988,329,D,2,2,14224,5129918,5615480,2752,2120790,2206822
1988-08-25,1988,330,D,2,2,13901,5143819,5615480,2277,2123067,2206822
1988-08-26,1988,331,D,2,2,13538,5157357,5615480,1977,2125044,2206822
1988-08-27,1988,332,D,2,2,12735,5170092,5615480,2456,2127500,2206822
1988-08-28,1988,333,D,2,2,13406,5183498,5615480,3081,2130581,2206822
1988-08-29,1988,334,D,2,2,12874,5196372,5615480,2594,2133175,2206822
1988-08-30,1988,335,D,2,2,12347,5208719,5615480,2837,2136012,2206822
1988-08-31,1988,336,D,2,2,12521,5221240,5615480,3282,2139294,2206822
1988-09-01,1988,337,D,2,2,12864,5234104,5615480,3542,2142836,2206822
1988-09-02,1988,338,D,2,2,12990,5247094,5615480,2980,2145816,2206822
1988-09-03,1988,339,D,2,2,13805,5260899,5615480,3940,2149756,2206822
1988-09-04,1988,340,D,2,2,14118,5275017,5615480,3414,2153170,2206822
1988-09-05,1988,341,D,2,2,14051,5289068,5615480,3122,2156292,2206822
1988-09-06,1988,342,D,2,2,13991,5303059,5615480,3076,2159368,2206822
1988-09-07,1988,343,D,2,2,14387,5317446,5615480,3506,2162874,2206822
1988-09-08,1988,344,D,2,2,13808,5331254,5615480,2759,2165633,2206822
1988-09-09,1988,345,D,2,2,13150,5344404,5615480,1690,2167323,2206822
1988-09-10,1988,346,D,2,2,14290,5358694,5615480,2992,2170315,2206822
1988-09-11,1988,347,D,2,2,13991,5372685,5615480,2443,2172758,2206822
1988-09-12,1988,348,D,2,2,12785,5385470,5615480,990,2173748,2206822
1988-09-13,1988,349,D,2,2,13710,5399180,5615480,2383,2176131,2206822
1988-09-14,1988,350,D,2,2,13308,5412488,5615480,1937,2178068,2206822
1988-09-15,1988,351,D,2,2,13246,5425734,5615480,1609,2179677,2206822
1988-09-16,1988,352,D,2,2,13252,5438986,5615480,1527,2181204,2206822
1988-09-17,1988,353,D,2,2,13241,5452227,5615480,1609,2182813,2206822
1988-09-18,1988,354,D,2,2,12844,5465071,5615480,1062,2183875,2206822
1988-09-19,1988,355,D,2,2,12374,5477445,5615480,938,2184813,2206822
1988-09-20,1988,356,D,2,2,13428,5490873,5615480,3597,2188410,2206822
1988-09-21,1988,357,D,2,2,12860,5503733,5615480,1971,2190381,2206822
1988-09-22,1988,358,D,2,2,13093,5516826,5615480,2864,2193245,2206822
1988-09-23,1988,359,D,2,2,12375,5529201,5615480,2125,2195370,2206822
1988-09-24,1988,360,D,2,2,11823,5541024,5615480,1647,2197017,2206822
1988-09-25,1988,361,D,2,2,12723,5553747,5615480,2650,2199667,2206822
1988-09-26,1988,362,D,2,2,12662,5566409,5615480,2036,2201703,2206822
1988-09-27,1988,363,D,2,2,12202,5578611,5615480,1502,2203205,2206822
1988-09-28,1988,364,D,2,2,12383,5590994,5615480,1492,2204697,2206822
1988-09-29,1988,365,D,2,2,12624,5603618,5615480,1212,2205909,2206822
1988-09-30,1988,366,D,2,2,11862,5615480,5615480,913,2206822,2206822
1988-10-01,1989,1,D,3,3+,11721,11721,6869609,2566,2566,3304173
1988-10-02,1989,2,D,3,3+,12642,24363,6869609,4266,6832,3304173
1988-10-03,1989,3,D,3,3+,13098,37461,6869609,4740,11572,3304173
1988-10-04,1989,4,D,3,3+,12623,50084,6869609,4546,16118,3304173
1988-10-05,1989,5,D,3,3+,12640,62724,6869609,3997,20115,3304173
1988-10-06,1989,6,D,3,3+,12639,75363,6869609,2886,23001,3304173
1988-10-07,1989,7,D,3,3+,12398,87761,6869609,2386,25387,3304173
1988-10-08,1989,8,D,3,3+,12352,100113,6869609,2411,27798,3304173
1988-10-09,1989,9,D,3,3+,11998,112111,6869609,2068,29866,3304173
1988-10-10,1989,10,D,3,3+,11827,123938,6869609,2148,32014,3304173
1988-10-11,1989,11,D,3,3+,12106,136044,6869609,2153,34167,3304173
1988-10-12,1989,12,D,3,3+,12205,148249,6869609,1232,35399,3304173
1988-10-13,1989,13,D,3,3+,12506,160755,6869609,1423,36822,3304173
1988-10-14,1989,14,D,3,3+,12301,173056,6869609,3361,40183,3304173
1988-10-15,1989,15,D,3,3+,11501,184557,6869609,1399,41582,3304173
1988-10-16,1989,16,D,3,3+,10498,195055,6869609,2002,43584,3304173
1988-10-17,1989,17,D,3,3+,10272,205327,6869609,2934,46518,3304173
1988-10-18,1989,18,D,3,3+,9903,215230,6869609,3991,50509,3304173
1988-10-19,1989,19,D,3,3+,9931,225161,6869609,4230,54739,3304173
1988-10-20,1989,20,D,3,3+,9392,234553,6869609,3080,57819,3304173
1988-10-21,1989,21,D,3,3+,8838,243391,6869609,2961,60780,3304173
1988-10-22,1989,22,D,3,3+,8351,251742,6869609,3095,63875,3304173
1988-10-23,1989,23,D,3,3+,7754,259496,6869609,2768,66643,3304173
1988-10-24,1989,24,D,3,3+,7712,267208,6869609,2912,69555,3304173
1988-10-25,1989,25,D,3,3+,8109,275317,6869609,3822,73377,3304173
1988-10-26,1989,26,D,3,3+,8001,283318,6869609,3392,76769,3304173
1988-10-27,1989,27,D,3,3+,7683,291001,6869609,3026,79795,3304173
1988-10-28,1989,28,D,3,3+,8715,299716,6869609,4049,83844,3304173
1988-10-29,1989,29,D,3,3+,8523,308239,6869609,4339,88183,3304173
1988-10-30,1989,30,D,3,3+,8793,317032,6869609,4919,93102,3304173
1988-10-31,1989,31,D,3,3+,9052,326084,6869609,4289,97391,3304173
1988-11-01,1989,32,D,3,3+,8958,335042,6869609,3225,100616,3304173
1988-11-02,1989,33,D,3,3+,9647,344689,6869609,3504,104120,3304173
1988-11-03,1989,34,D,3,3+,9439,354128,6869609,3128,107248,3304173
1988-11-04,1989,35,D,3,3+,9278,363406,6869609,2711,109959,3304173
1988-11-05,1989,36,D,3,3+,8947,372353,6869609,2686,112645,3304173
1988-11-06,1989,37,D,3,3+,9267,381620,6869609,3205,115850,3304173
1988-11-07,1989,38,D,3,3+,9121,390741,6869609,2542,118392,3304173
1988-11-08,1989,39,D,3,3+,9181,399922,6869609,2905,121297,3304173
1988-11-09,1989,40,D,3,3+,9153,409075,6869609,3162,124459,3304173
1988-11-10,1989,41,D,3,3+,9203,418278,6869609,3064,127523,3304173
1988-11-11,1989,42,D,3,3+,9542,427820,6869609,4319,131842,3304173
1988-11-12,1989,43,D,3,3+,9814,437634,6869609,4769,136611,3304173
1988-11-13,1989,44,D,3,3+,9450,447084,6869609,4034,140645,3304173
1988-11-14,1989,45,D,3,3+,11161,458245,6869609,6629,147274,3304173
1988-11-15,1989,46,D,3,3+,10916,469161,6869609,3172,150446,3304173
1988-11-16,1989,47,D,3,3+,10363,479524,6869609,2152,152598,3304173
1988-11-17,1989,48,D,3,3+,11759,491283,6869609,5318,157916,3304173
1988-11-18,1989,49,D,3,3+,11582,502865,6869609,4738,162654,3304173
1988-11-19,1989,50,D,3,3+,11892,514757,6869609,3670,166324,3304173
1988-11-20,1989,51,D,3,3+,11301,526058,6869609,2993,169317,3304173
1988-11-21,1989,52,D,3,3+,10383,536441,6869609,2013,171330,3304173
1988-11-22,1989,53,D,3,3+,10142,546583,6869609,1887,173217,3304173
1988-11-23,1989,54,D,3,3+,11286,557869,6869609,10437,183654,3304173
1988-11-24,1989,55,D,3,3+,21304,579173,6869609,19700,203354,3304173
1988-11-25,1989,56,D,3,3+,30508,609681,6869609,27065,230419,3304173
1988-11-26,1989,57,D,3,3+,26841,636522,6869609,27012,257431,3304173
1988-11-27,1989,58,D,3,3+,22098,658620,6869609,18502,275933,3304173
1988-11-28,1989,59,D,3,3+,18881,677501,6869609,10196,286129,3304173
1988-11-29,1989,60,D,3,3+,16368,693869,6869609,6780,292909,3304173
1988-11-30,1989,61,D,3,3+,14371,708240,6869609,3061,295970,3304173
1988-12-01,1989,62,D,3,3+,13267,721507,6869609,1363,297333,3304173
1988-12-02,1989,63,D,3,3+,12363,733870,6869609,870,298203,3304173
1988-12-03,1989,64,D,3,3+,11553,745423,6869609,1308,299511,3304173
1988-12-04,1989,65,D,3,3+,10893,756316,6869609,1887,301398,3304173
1988-12-05,1989,66,D,3,3+,11023,767339,6869609,1934,303332,3304173
1988-12-06,1989,67,D,3,3+,11279,778618,6869609,2821,306153,3304173
1988-12-07,1989,68,D,3,3+,11407,790025,6869609,3118,309271,3304173
1988-12-08,1989,69,D,3,3+,11025,801050,6869609,3259,312530,3304173
1988-12-09,1989,70,D,3,3+,11055,812105,6869609,3664,316194,3304173
1988-12-10,1989,71,D,3,3+,11858,823963,6869609,4565,320759,3304173
1988-12-11,1989,72,D,3,3+,11307,835270,6869609,3488,324247,3304173
1988-12-12,1989,73,D,3,3+,12256,847526,6869609,4050,328297,3304173
1988-12-13,1989,74,D,3,3+,12426,859952,6869609,3930,332227,3304173
1988-12-14,1989,75,D,3,3+,13097,873049,6869609,5431,337658,3304173
1988-12-15,1989,76,D,3,3+,12889,885938,6869609,4808,342466,3304173
1988-12-16,1989,77,D,3,3+,12289,898227,6869609,3563,346029,3304173
1988-12-17,1989,78,D,3,3+,12890,911117,6869609,4331,350360,3304173
1988-12-18,1989,79,D,3,3+,12788,923905,6869609,4856,355216,3304173
1988-12-19,1989,80,D,3,3+,12616,936521,6869609,5500,360716,3304173
1988-12-20,1989,81,D,3,3+,12176,948697,6869609,7694,368410,3304173
1988-12-21,1989,82,D,3,3+,12870,961567,6869609,14179,382589,3304173
1988-12-22,1989,83,D,3,3+,13448,975015,6869609,15909,398498,3304173
1988-12-23,1989,84,D,3,3+,16027,991042,6869609,20334,418832,3304173
1988-12-24,1989,85,D,3,3+,17377,1008419,6869609,20775,439607,3304173
1988-12-25,1989,86,D,3,3+,22380,1030799,6869609,22705,462312,3304173
1988-12-26,1989,87,D,3,3+,22839,1053638,6869609,17075,479387,3304173
1988-12-27,1989,88,D,3,3+,20594,1074232,6869609,12880,492267,3304173
1988-12-28,1989,89,D,3,3+,18394,1092626,6869609,10935,503202,3304173
1988-12-29,1989,90,D,3,3+,16618,1109244,6869609,6503,509705,3304173
1988-12-30,1989,91,D,3,3+,14784,1124028,6869609,4049,513754,3304173
1988-12-31,1989,92,D,3,3+,14689,1138717,6869609,6375,520129,3304173
1989-01-01,1989,93,D,3,3+,14782,1153499,6869609,5785,525914,3304173
1989-01-02,1989,94,D,3,3+,15711,1169210,6869609,5329,531243,3304173
1989-01-03,1989,95,D,3,3+,15047,1184257,6869609,4935,536178,3304173
1989-01-04,1989,96,D,3,3+,13989,1198246,6869609,3293,539471,3304173
1989-01-05,1989,97,D,3,3+,13994,1212240,6869609,5985,545456,3304173
1989-01-06,1989,98,D,3,3+,15545,1227785,6869609,8477,553933,3304173
1989-01-07,1989,99,D,3,3+,17488,1245273,6869609,8567,562500,3304173
1989-01-08,1989,100,D,3,3+,19458,1264731,6869609,10058,572558,3304173
1989-01-09,1989,101,D,3,3+,18541,1283272,6869609,9641,582199,3304173
1989-01-10,1989,102,D,3,3+,16985,1300257,6869609,6134,588333,3304173
1989-01-11,1989,103,D,3,3+,16812,1317069,6869609,4451,592784,3304173
1989-01-12,1989,104,D,3,3+,17004,1334073,6869609,5609,598393,3304173
1989-01-13,1989,105,D,3,3+,17461,1351534,6869609,6061,604454,3304173
1989-01-14,1989,106,D,3,3+,16429,1367963,6869609,4815,609269,3304173
1989-01-15,1989,107,D,3,3+,15411,1383374,6869609,3921,613190,3304173
1989-01-16,1989,108,D,3,3+,14281,1397655,6869609,2367,615557,3304173
1989-01-17,1989,109,D,3,3+,13365,1411020,6869609,1343,616900,3304173
1989-01-18,1989,110,D,3,3+,12662,1423682,6869609,1162,618062,3304173
1989-01-19,1989,111,D,3,3+,11451,1435133,6869609,-445,617617,3304173
1989-01-20,1989,112,D,3,3+,11950,1447083,6869609,53,617670,3304173
1989-01-21,1989,113,D,3,3+,11730,1458813,6869609,-122,617548,3304173
1989-01-22,1989,114,D,3,3+,11413,1470226,6869609,-522,617026,3304173
1989-01-23,1989,115,D,3,3+,11857,1482083,6869609,1850,618876,3304173
1989-01-24,1989,116,D,3,3+,13029,1495112,6869609,2885,621761,3304173
1989-01-25,1989,117,D,3,3+,13829,1508941,6869609,2668,624429,3304173
1989-01-26,1989,118,D,3,3+,13403,1522344,6869609,2881,627310,3304173
1989-01-27,1989,119,D,3,3+,12872,1535216,6869609,2423,629733,3304173
1989-01-28,1989,120,D,3,3+,11952,1547168,6869609,1802,631535,3304173
1989-01-29,1989,121,D,3,3+,11541,1558709,6869609,-22,631513,3304173
1989-01-30,1989,122,D,3,3+,11080,1569789,6869609,-416,631097,3304173
1989-01-31,1989,123,D,3,3+,10252,1580041,6869609,750,631847,3304173
1989-02-01,1989,124,D,3,3+,10067,1590108,6869609,3138,634985,3304173
1989-02-02,1989,125,D,3,3+,10473,1600581,6869609,5246,640231,3304173
1989-02-03,1989,126,D,3,3+,11013,1611594,6869609,6856,647087,3304173
1989-02-04,1989,127,D,3,3+,11023,1622617,6869609,8470,655557,3304173
1989-02-05,1989,128,D,3,3+,15589,1638206,6869609,12155,667712,3304173
1989-02-06,1989,129,D,3,3+,15109,1653315,6869609,11011,678723,3304173
1989-02-07,1989,130,D,3,3+,14826,1668141,6869609,9570,688293,3304173
1989-02-08,1989,131,D,3,3+,14758,1682899,6869609,7821,696114,3304173
1989-02-09,1989,132,D,3,3+,15204,1698103,6869609,9211,705325,3304173
1989-02-10,1989,133,D,3,3+,15475,1713578,6869609,9362,714687,3304173
1989-02-11,1989,134,D,3,3+,15104,1728682,6869609,8705,723392,3304173
1989-02-12,1989,135,D,3,3+,14541,1743223,6869609,8687,732079,3304173
1989-02-13,1989,136,D,3,3+,14255,1757478,6869609,8397,740476,3304173
1989-02-14,1989,137,D,3,3+,13676,1771154,6869609,5063,745539,3304173
1989-02-15,1989,138,D,3,3+,13382,1784536,6869609,4548,750087,3304173
1989-02-16,1989,139,D,3,3+,13456,1797992,6869609,5035,755122,3304173
1989-02-17,1989,140,D,3,3+,13401,1811393,6869609,4016,759138,3304173
1989-02-18,1989,141,D,3,3+,12961,1824354,6869609,3636,762774,3304173
1989-02-19,1989,142,D,3,3+,13152,1837506,6869609,7155,769929,3304173
1989-02-20,1989,143,D,3,3+,13471,1850977,6869609,6867,776796,3304173
1989-02-21,1989,144,D,3,3+,13357,1864334,6869609,5442,782238,3304173
1989-02-22,1989,145,D,3,3+,13240,1877574,6869609,5412,787650,3304173
1989-02-23,1989,146,D,3,3+,13012,1890586,6869609,5878,793528,3304173
1989-02-24,1989,147,D,3,3+,13305,1903891,6869609,3460,796988,3304173
1989-02-25,1989,148,D,3,3+,14299,1918190,6869609,4384,801372,3304173
1989-02-26,1989,149,D,3,3+,14302,1932492,6869609,3377,804749,3304173
1989-02-27,1989,150,D,3,3+,13403,1945895,6869609,2271,807020,3304173
1989-02-28,1989,151,D,3,3+,12463,1958358,6869609,3426,810446,3304173
1989-03-01,1989,152,D,3,3+,14414,1972772,6869609,5612,816058,3304173
1989-03-02,1989,153,D,3,3+,19368,1992140,6869609,17350,833408,3304173
1989-03-03,1989,154,D,3,3+,23517,2015657,6869609,20075,853483,3304173
1989-03-04,1989,155,D,3,3+,29012,2044669,6869609,24444,877927,3304173
1989-03-05,1989,156,D,3,3+,28856,2073525,6869609,25268,903195,3304173
1989-03-06,1989,157,D,3,3+,24611,2098136,6869609,20364,923559,3304173
1989-03-07,1989,158,D,3,3+,26306,2124442,6869609,16776,940335,3304173
1989-03-08,1989,159,D,3,3+,30850,2155292,6869609,21756,962091,3304173
1989-03-09,1989,160,D,3,3+,31404,2186696,6869609,21688,983779,3304173
1989-03-10,1989,161,D,3,3+,40566,2227262,6869609,33780,1017559,3304173
1989-03-11,1989,162,D,3,3+,57709,2284971,6869609,53092,1070651,3304173
1989-03-12,1989,163,D,3,3+,63708,2348679,6869609,59006,1129657,3304173
1989-03-13,1989,164,D,3,3+,67964,2416643,6869609,62680,1192337,3304173
1989-03-14,1989,165,D,3,3+,67165,2483808,6869609,61346,1253683,3304173
1989-03-15,1989,166,D,3,3+,62591,2546399,6869609,53904,1307587,3304173
1989-03-16,1989,167,D,3,3+,55474,2601873,6869609,44983,1352570,3304173
1989-03-17,1989,168,D,3,3+,47786,2649659,6869609,37936,1390506,3304173
1989-03-18,1989,169,D,3,3+,43428,2693087,6869609,32833,1423339,3304173
1989-03-19,1989,170,D,3,3+,46287,2739374,6869609,36675,1460014,3304173
1989-03-20,1989,171,D,3,3+,51994,2791368,6869609,41898,1501912,3304173
1989-03-21,1989,172,D,3,3+,50551,2841919,6869609,39092,1541004,3304173
1989-03-22,1989,173,D,3,3+,45160,2887079,6869609,33607,1574611,3304173
1989-03-23,1989,174,D,3,3+,40618,2927697,6869609,29179,1603790,3304173
1989-03-24,1989,175,D,3,3+,41657,2969354,6869609,30260,1634050,3304173
1989-03-25,1989,176,D,3,3+,57371,3026725,6869609,46506,1680556,3304173
1989-03-26,1989,177,D,3,3+,74683,3101408,6869609,64899,1745455,3304173
1989-03-27,1989,178,D,3,3+,77384,3178792,6869609,67929,1813384,3304173
1989-03-28,1989,179,D,3,3+,68595,3247387,6869609,59603,1872987,3304173
1989-03-29,1989,180,D,3,3+,64215,3311602,6869609,53819,1926806,3304173
1989-03-30,1989,181,D,3,3+,59602,3371204,6869609,48978,1975784,3304173
1989-03-31,1989,182,D,3,3+,53243,3424447,6869609,41440,2017224,3304173
1989-04-01,1989,183,D,3,3+,46460,3470907,6869609,34361,2051585,3304173
1989-04-02,1989,184,D,3,3+,40701,3511608,6869609,29042,2080627,3304173
1989-04-03,1989,185,D,3,3+,37965,3549573,6869609,26112,2106739,3304173
1989-04-04,1989,186,D,3,3+,35520,3585093,6869609,23608,2130347,3304173
1989-04-05,1989,187,D,3,3+,33156,3618249,6869609,20306,2150653,3304173
1989-04-06,1989,188,D,3,3+,30984,3649233,6869609,18797,2169450,3304173
1989-04-07,1989,189,D,3,3+,28818,3678051,6869609,16374,2185824,3304173
1989-04-08,1989,190,D,3,3+,26312,3704363,6869609,13672,2199496,3304173
1989-04-09,1989,191,D,3,3+,24781,3729144,6869609,12340,2211836,3304173
1989-04-10,1989,192,D,3,3+,23969,3753113,6869609,11718,2223554,3304173
1989-04-11,1989,193,D,3,3+,23734,3776847,6869609,11572,2235126,3304173
1989-04-12,1989,194,D,3,3+,22870,3799717,6869609,10359,2245485,3304173
1989-04-13,1989,195,D,3,3+,21985,3821702,6869609,9489,2254974,3304173
1989-04-14,1989,196,D,3,3+,20335,3842037,6869609,7843,2262817,3304173
1989-04-15,1989,197,D,3,3+,19745,3861782,6869609,7308,2270125,3304173
1989-04-16,1989,198,D,3,3+,18661,3880443,6869609,5946,2276071,3304173
1989-04-17,1989,199,D,3,3+,19602,3900045,6869609,7035,2283106,3304173
1989-04-18,1989,200,D,3,3+,17710,3917755,6869609,5251,2288357,3304173
1989-04-19,1989,201,D,3,3+,17203,3934958,6869609,4611,2292968,3304173
1989-04-20,1989,202,D,3,3+,17429,3952387,6869609,4748,2297716,3304173
1989-04-21,1989,203,D,3,3+,17277,3969664,6869609,4801,2302517,3304173
1989-04-22,1989,204,D,3,3+,17992,3987656,6869609,5809,2308326,3304173
1989-04-23,1989,205,D,3,3+,18250,4005906,6869609,5907,2314233,3304173
1989-04-24,1989,206,D,3,3+,18720,4024626,6869609,7413,2321646,3304173
1989-04-25,1989,207,D,3,3+,19035,4043661,6869609,7774,2329420,3304173
1989-04-26,1989,208,D,3,3+,20117,4063778,6869609,8942,2338362,3304173
1989-04-27,1989,209,D,3,3+,20338,4084116,6869609,9103,2347465,3304173
1989-04-28,1989,210,D,3,3+,20283,4104399,6869609,8846,2356311,3304173
1989-04-29,1989,211,D,3,3+,18977,4123376,6869609,6309,2362620,3304173
1989-04-30,1989,212,D,3,3+,18006,4141382,6869609,5199,2367819,3304173
1989-05-01,1989,213,D,3,3+,16765,4158147,6869609,6504,2374323,3304173
1989-05-02,1989,214,D,3,3+,14581,4172728,6869609,8743,2383066,3304173
1989-05-03,1989,215,D,3,3+,13207,4185935,6869609,9137,2392203,3304173
1989-05-04,1989,216,D,3,3+,12145,4198080,6869609,8040,2400243,3304173
1989-05-05,1989,217,D,3,3+,11939,4210019,6869609,7832,2408075,3304173
1989-05-06,1989,218,D,3,3+,11410,4221429,6869609,7276,2415351,3304173
1989-05-07,1989,219,D,3,3+,11305,4232734,6869609,7110,2422461,3304173
1989-05-08,1989,220,D,3,3+,11272,4244006,6869609,7083,2429544,3304173
1989-05-09,1989,221,D,3,3+,13300,4257306,6869609,9067,2438611,3304173
1989-05-10,1989,222,D,3,3+,15623,4272929,6869609,9593,2448204,3304173
1989-05-11,1989,223,D,3,3+,16935,4289864,6869609,9505,2457709,3304173
1989-05-12,1989,224,D,3,3+,17986,4307850,6869609,8384,2466093,3304173
1989-05-13,1989,225,D,3,3+,17117,4324967,6869609,6422,2472515,3304173
1989-05-14,1989,226,D,3,3+,15891,4340858,6869609,5456,2477971,3304173
1989-05-15,1989,227,D,3,3+,17523,4358381,6869609,7737,2485708,3304173
1989-05-16,1989,228,D,3,3+,19757,4378138,6869609,8605,2494313,3304173
1989-05-17,1989,229,D,3,3+,17851,4395989,6869609,5381,2499694,3304173
1989-05-18,1989,230,D,3,3+,17792,4413781,6869609,7787,2507481,3304173
1989-05-19,1989,231,D,3,3+,17634,4431415,6869609,6592,2514073,3304173
1989-05-20,1989,232,D,3,3+,16554,4447969,6869609,5541,2519614,3304173
1989-05-21,1989,233,D,3,3+,15771,4463740,6869609,5967,2525581,3304173
1989-05-22,1989,234,D,3,3+,17769,4481509,6869609,9711,2535292,3304173
1989-05-23,1989,235,D,3,3+,20140,4501649,6869609,10303,2545595,3304173
1989-05-24,1989,236,D,3,3+,20024,4521673,6869609,7943,2553538,3304173
1989-05-25,1989,237,D,3,3+,18576,4540249,6869609,6750,2560288,3304173
1989-05-26,1989,238,D,3,3+,17685,4557934,6869609,5859,2566147,3304173
1989-05-27,1989,239,D,3,3+,17206,4575140,6869609,5930,2572077,3304173
1989-05-28,1989,240,D,3,3+,17500,4592640,6869609,6209,2578286,3304173
1989-05-29,1989,241,D,3,3+,16913,4609553,6869609,6641,2584927,3304173
1989-05-30,1989,242,D,3,3+,16422,4625975,6869609,6351,2591278,3304173
1989-05-31,1989,243,D,3,3+,15686,4641661,6869609,5278,2596556,3304173
1989-06-01,1989,244,D,3,3+,15365,4657026,6869609,6146,2602702,3304173
1989-06-02,1989,245,D,3,3+,13995,4671021,6869609,5232,2607934,3304173
1989-06-03,1989,246,D,3,3+,14066,4685087,6869609,7264,2615198,3304173
1989-06-04,1989,247,D,3,3+,15729,4700816,6869609,9939,2625137,3304173
1989-06-05,1989,248,D,3,3+,16517,4717333,6869609,9026,2634163,3304173
1989-06-06,1989,249,D,3,3+,16888,4734221,6869609,9227,2643390,3304173
1989-06-07,1989,250,D,3,3+,17758,4751979,6869609,10671,2654061,3304173
1989-06-08,1989,251,D,3,3+,17554,4769533,6869609,9125,2663186,3304173
1989-06-09,1989,252,D,3,3+,17499,4787032,6869609,7892,2671078,3304173
1989-06-10,1989,253,D,3,3+,17340,4804372,6869609,7710,2678788,3304173
1989-06-11,1989,254,D,3,3+,16611,4820983,6869609,6820,2685608,3304173
1989-06-12,1989,255,D,3,3+,15707,4836690,6869609,5178,2690786,3304173
1989-06-13,1989,256,D,3,3+,14342,4851032,6869609,4764,2695550,3304173
1989-06-14,1989,257,D,3,3+,13398,4864430,6869609,5044,2700594,3304173
1989-06-15,1989,258,D,3,3+,13965,4878395,6869609,6150,2706744,3304173
1989-06-16,1989,259,D,3,3+,15073,4893468,6869609,7693,2714437,3304173
1989-06-17,1989,260,D,3,3+,14945,4908413,6869609,6634,2721071,3304173
1989-06-18,1989,261,D,3,3+,14929,4923342,6869609,6768,2727839,3304173
1989-06-19,1989,262,D,3,3+,15700,4939042,6869609,7699,2735538,3304173
1989-06-20,1989,263,D,3,3+,15637,4954679,6869609,6033,2741571,3304173
1989-06-21,1989,264,D,3,3+,14670,4969349,6869609,3785,2745356,3304173
1989-06-22,1989,265,D,3,3+,13931,4983280,6869609,3868,2749224,3304173
1989-06-23,1989,266,D,3,3+,12823,4996103,6869609,3273,2752497,3304173
1989-06-24,1989,267,D,3,3+,13486,5009589,6869609,4972,2757469,3304173
1989-06-25,1989,268,D,3,3+,13998,5023587,6869609,5476,2762945,3304173
1989-06-26,1989,269,D,3,3+,13754,5037341,6869609,3438,2766383,3304173
1989-06-27,1989,270,D,3,3+,12709,5050050,6869609,1834,2768217,3304173
1989-06-28,1989,271,D,3,3+,13112,5063162,6869609,3849,2772066,3304173
1989-06-29,1989,272,D,3,3+,14163,5077325,6869609,3530,2775596,3304173
1989-06-30,1989,273,D,3,3+,16357,5093682,6869609,5632,2781228,3304173
1989-07-01,1989,274,D,3,3+,18284,5111966,6869609,5597,2786825,3304173
1989-07-02,1989,275,D,3,3+,19140,5131106,6869609,4892,2791717,3304173
1989-07-03,1989,276,D,3,3+,19349,5150455,6869609,4423,2796140,3304173
1989-07-04,1989,277,D,3,3+,19290,5169745,6869609,3469,2799609,3304173
1989-07-05,1989,278,D,3,3+,18995,5188740,6869609,4167,2803776,3304173
1989-07-06,1989,279,D,3,3+,17413,5206153,6869609,2824,2806600,3304173
1989-07-07,1989,280,D,3,3+,16465,5222618,6869609,1755,2808355,3304173
1989-07-08,1989,281,D,3,3+,16329,5238947,6869609,2703,2811058,3304173
1989-07-09,1989,282,D,3,3+,16866,5255813,6869609,3601,2814659,3304173
1989-07-10,1989,283,D,3,3+,16607,5272420,6869609,2457,2817116,3304173
1989-07-11,1989,284,D,3,3+,16895,5289315,6869609,4223,2821339,3304173
1989-07-12,1989,285,D,3,3+,18463,5307778,6869609,5859,2827198,3304173
1989-07-13,1989,286,D,3,3+,18715,5326493,6869609,4536,2831734,3304173
1989-07-14,1989,287,D,3,3+,18820,5345313,6869609,6453,2838187,3304173
1989-07-15,1989,288,D,3,3+,18403,5363716,6869609,7058,2845245,3304173
1989-07-16,1989,289,D,3,3+,18516,5382232,6869609,7284,2852529,3304173
1989-07-17,1989,290,D,3,3+,18687,5400919,6869609,7656,2860185,3304173
1989-07-18,1989,291,D,3,3+,19253,5420172,6869609,8210,2868395,3304173
1989-07-19,1989,292,D,3,3+,21062,5441234,6869609,10017,2878412,3304173
1989-07-20,1989,293,D,3,3+,22030,5463264,6869609,8928,2887340,3304173
1989-07-21,1989,294,D,3,3+,22409,5485673,6869609,7290,2894630,3304173
1989-07-22,1989,295,D,3,3+,23488,5509161,6869609,8175,2902805,3304173
1989-07-23,1989,296,D,3,3+,23724,5532885,6869609,8283,2911088,3304173
1989-07-24,1989,297,D,3,3+,23347,5556232,6869609,7146,2918234,3304173
1989-07-25,1989,298,D,3,3+,22488,5578720,6869609,6576,2924810,3304173
1989-07-26,1989,299,D,3,3+,22561,5601281,6869609,7569,2932379,3304173
1989-07-27,1989,300,D,3,3+,23494,5624775,6869609,8665,2941044,3304173
1989-07-28,1989,301,D,3,3+,23919,5648694,6869609,8332,2949376,3304173
1989-07-29,1989,302,D,3,3+,24492,5673186,6869609,8505,2957881,3304173
1989-07-30,1989,303,D,3,3+,24567,5697753,6869609,7925,2965806,3304173
1989-07-31,1989,304,D,3,3+,22851,5720604,6869609,6463,2972269,3304173
1989-08-01,1989,305,D,3,3+,24336,5744940,6869609,8693,2980962,3304173
1989-08-02,1989,306,D,3,3+,24076,5769016,6869609,8035,2988997,3304173
1989-08-03,1989,307,D,3,3+,23676,5792692,6869609,8027,2997024,3304173
1989-08-04,1989,308,D,3,3+,23075,5815767,6869609,7150,3004174,3304173
1989-08-05,1989,309,D,3,3+,23072,5838839,6869609,8899,3013073,3304173
1989-08-06,1989,310,D,3,3+,22770,5861609,6869609,7098,3020171,3304173
1989-08-07,1989,311,D,3,3+,22701,5884310,6869609,7194,3027365,3304173
1989-08-08,1989,312,D,3,3+,22654,5906964,6869609,6928,3034293,3304173
1989-08-09,1989,313,D,3,3+,22429,5929393,6869609,6656,3040949,3304173
1989-08-10,1989,314,D,3,3+,22394,5951787,6869609,7206,3048155,3304173
1989-08-11,1989,315,D,3,3+,21738,5973525,6869609,6022,3054177,3304173
1989-08-12,1989,316,D,3,3+,20650,5994175,6869609,5746,3059923,3304173
1989-08-13,1989,317,D,3,3+,20189,6014364,6869609,4984,3064907,3304173
1989-08-14,1989,318,D,3,3+,20407,6034771,6869609,5252,3070159,3304173
1989-08-15,1989,319,D,3,3+,20072,6054843,6869609,4570,3074729,3304173
1989-08-16,1989,320,D,3,3+,18872,6073715,6869609,3502,3078231,3304173
1989-08-17,1989,321,D,3,3+,19167,6092882,6869609,4282,3082513,3304173
1989-08-18,1989,322,D,3,3+,19631,6112513,6869609,3637,3086150,3304173
1989-08-19,1989,323,D,3,3+,18547,6131060,6869609,4321,3090471,3304173
1989-08-20,1989,324,D,3,3+,18515,6149575,6869609,3552,3094023,3304173
1989-08-21,1989,325,D,3,3+,18277,6167852,6869609,3128,3097151,3304173
1989-08-22,1989,326,D,3,3+,17719,6185571,6869609,2492,3099643,3304173
1989-08-23,1989,327,D,3,3+,17874,6203445,6869609,2607,3102250,3304173
1989-08-24,1989,328,D,3,3+,16995,6220440,6869609,1656,3103906,3304173
1989-08-25,1989,329,D,3,3+,16162,6236602,6869609,857,3104763,3304173
1989-08-26,1989,330,D,3,3+,15541,6252143,6869609,637,3105400,3304173
1989-08-27,1989,331,D,3,3+,15837,6267980,6869609,1486,3106886,3304173
1989-08-28,1989,332,D,3,3+,16154,6284134,6869609,1506,3108392,3304173
1989-08-29,1989,333,D,3,3+,15399,6299533,6869609,436,3108828,3304173
1989-08-30,1989,334,D,3,3+,15789,6315322,6869609,1739,3110567,3304173
1989-08-31,1989,335,D,3,3+,14865,6330187,6869609,227,3110794,3304173
1989-09-01,1989,336,D,3,3+,14404,6344591,6869609,-162,3110632,3304173
1989-09-02,1989,337,D,3,3+,14920,6359511,6869609,1483,3112115,3304173
1989-09-03,1989,338,D,3,3+,14741,6374252,6869609,550,3112665,3304173
1989-09-04,1989,339,D,3,3+,14730,6388982,6869609,492,3113157,3304173
1989-09-05,1989,340,D,3,3+,14646,6403628,6869609,523,3113680,3304173
1989-09-06,1989,341,D,3,3+,14500,6418128,6869609,-167,3113513,3304173
1989-09-07,1989,342,D,3,3+,17509,6435637,6869609,3096,3116609,3304173
1989-09-08,1989,343,D,3,3+,16133,6451770,6869609,655,3117264,3304173
1989-09-09,1989,344,D,3,3+,17526,6469296,6869609,3491,3120755,3304173
1989-09-10,1989,345,D,3,3+,18521,6487817,6869609,5844,3126599,3304173
1989-09-11,1989,346,D,3,3+,18924,6506741,6869609,6682,3133281,3304173
1989-09-12,1989,347,D,3,3+,18598,6525339,6869609,6404,3139685,3304173
1989-09-13,1989,348,D,3,3+,18195,6543534,6869609,4399,3144084,3304173
1989-09-14,1989,349,D,3,3+,17590,6561124,6869609,4128,3148212,3304173
1989-09-15,1989,350,D,3,3+,16799,6577923,6869609,2780,3150992,3304173
1989-09-16,1989,351,D,3,3+,17703,6595626,6869609,10814,3161806,3304173
1989-09-17,1989,352,D,3,3+,20031,6615657,6869609,13367,3175173,3304173
1989-09-18,1989,353,D,3,3+,21882,6637539,6869609,19526,3194699,3304173
1989-09-19,1989,354,D,3,3+,23531,6661070,6869609,19641,3214340,3304173
1989-09-20,1989,355,D,3,3+,26266,6687336,6869609,22569,3236909,3304173
1989-09-21,1989,356,D,3,3+,24828,6712164,6869609,15341,3252250,3304173
1989-09-22,1989,357,D,3,3+,21662,6733826,6869609,11129,3263379,3304173
1989-09-23,1989,358,D,3,3+,19343,6753169,6869609,5647,3269026,3304173
1989-09-24,1989,359,D,3,3+,18859,6772028,6869609,6148,3275174,3304173
1989-09-25,1989,360,D,3,3+,17892,6789920,6869609,5020,3280194,3304173
1989-09-26,1989,361,D,3,3+,17067,6806987,6869609,3927,3284121,3304173
1989-09-27,1989,362,D,3,3+,16456,6823443,6869609,3975,3288096,3304173
1989-09-28,1989,363,D,3,3+,15530,6838973,6869609,2547,3290643,3304173
1989-09-29,1989,364,D,3,3+,15470,6854443,6869609,6768,3297411,3304173
1989-09-30,1989,365,D,3,3+,15166,6869609,6869609,6762,3304173,3304173
1989-10-01,1990,1,D,4,3+,14145,14145,5538349,5390,5390,1963450
1989-10-02,1990,2,D,4,3+,13600,27745,5538349,4935,10325,1963450
1989-10-03,1990,3,D,4,3+,13361,41106,5538349,4994,15319,1963450
1989-10-04,1990,4,D,4,3+,12707,53813,5538349,145,15464,1963450
1989-10-05,1990,5,D,4,3+,12606,66419,5538349,-341,15123,1963450
1989-10-06,1990,6,D,4,3+,12127,78546,5538349,-846,14277,1963450
1989-10-07,1990,7,D,4,3+,13007,91553,5538349,110,14387,1963450
1989-10-08,1990,8,D,4,3+,13631,105184,5538349,750,15137,1963450
1989-10-09,1990,9,D,4,3+,13600,118784,5538349,696,15833,1963450
1989-10-10,1990,10,D,4,3+,13487,132271,5538349,1400,17233,1963450
1989-10-11,1990,11,D,4,3+,14012,146283,5538349,1802,19035,1963450
1989-10-12,1990,12,D,4,3+,15427,161710,5538349,2776,21811,1963450
1989-10-13,1990,13,D,4,3+,16289,177999,5538349,3758,25569,1963450
1989-10-14,1990,14,D,4,3+,16423,194422,5538349,3624,29193,1963450
1989-10-15,1990,15,D,4,3+,16900,211322,5538349,4392,33585,1963450
1989-10-16,1990,16,D,4,3+,16086,227408,5538349,3523,37108,1963450
1989-10-17,1990,17,D,4,3+,15941,243349,5538349,3553,40661,1963450
1989-10-18,1990,18,D,4,3+,15851,259200,5538349,3643,44304,1963450
1989-10-19,1990,19,D,4,3+,15914,275114,5538349,3193,47497,1963450
1989-10-20,1990,20,D,4,3+,15933,291047,5538349,3276,50773,1963450
1989-10-21,1990,21,D,4,3+,16915,307962,5538349,5234,56007,1963450
1989-10-22,1990,22,D,4,3+,17077,325039,5538349,4799,60806,1963450
1989-10-23,1990,23,D,4,3+,17769,342808,5538349,5736,66542,1963450
1989-10-24,1990,24,D,4,3+,19771,362579,5538349,13428,79970,1963450
1989-10-25,1990,25,D,4,3+,21872,384451,5538349,15672,95642,1963450
1989-10-26,1990,26,D,4,3+,23052,407503,5538349,17686,113328,1963450
1989-10-27,1990,27,D,4,3+,22413,429916,5538349,16157,129485,1963450
1989-10-28,1990,28,D,4,3+,19055,448971,5538349,12644,142129,1963450
1989-10-29,1990,29,D,4,3+,15447,464418,5538349,4145,146274,1963450
1989-10-30,1990,30,D,4,3+,13205,477623,5538349,1316,147590,1963450
1989-10-31,1990,31,D,4,3+,12254,489877,5538349,3921,151511,1963450
1989-11-01,1990,32,D,4,3+,13052,502929,5538349,2073,153584,1963450
1989-11-02,1990,33,D,4,3+,13540,516469,5538349,2464,156048,1963450
1989-11-03,1990,34,D,4,3+,14359,530828,5538349,3305,159353,1963450
1989-11-04,1990,35,D,4,3+,14486,545314,5538349,3595,162948,1963450
1989-11-05,1990,36,D,4,3+,15311,560625,5538349,2754,165702,1963450
1989-11-06,1990,37,D,4,3+,15766,576391,5538349,3313,169015,1963450
1989-11-07,1990,38,D,4,3+,15742,592133,5538349,4489,173504,1963450
1989-11-08,1990,39,D,4,3+,15475,607608,5538349,3606,177110,1963450
1989-11-09,1990,40,D,4,3+,15170,622778,5538349,3453,180563,1963450
1989-11-10,1990,41,D,4,3+,15084,637862,5538349,2619,183182,1963450
1989-11-11,1990,42,D,4,3+,14971,652833,5538349,2469,185651,1963450
1989-11-12,1990,43,D,4,3+,15167,668000,5538349,2889,188540,1963450
1989-11-13,1990,44,D,4,3+,16084,684084,5538349,3793,192333,1963450
1989-11-14,1990,45,D,4,3+,16487,700571,5538349,3874,196207,1963450
1989-11-15,1990,46,D,4,3+,16895,717466,5538349,4253,200460,1963450
1989-11-16,1990,47,D,4,3+,16872,734338,5538349,4196,204656,1963450
1989-11-17,1990,48,D,4,3+,17168,751506,5538349,3769,208425,1963450
1989-11-18,1990,49,D,4,3+,17768,769274,5538349,7268,215693,1963450
1989-11-19,1990,50,D,4,3+,17955,787229,5538349,5434,221127,1963450
1989-11-20,1990,51,D,4,3+,17934,805163,5538349,6812,227939,1963450
1989-11-21,1990,52,D,4,3+,17840,823003,5538349,6012,233951,1963450
1989-11-22,1990,53,D,4,3+,17640,840643,5538349,5559,239510,1963450
1989-11-23,1990,54,D,4,3+,17212,857855,5538349,4625,244135,1963450
1989-11-24,1990,55,D,4,3+,16903,874758,5538349,4389,248524,1963450
1989-11-25,1990,56,D,4,3+,17261,892019,5538349,4740,253264,1963450
1989-11-26,1990,57,D,4,3+,19319,911338,5538349,13363,266627,1963450
1989-11-27,1990,58,D,4,3+,19591,930929,5538349,13820,280447,1963450
1989-11-28,1990,59,D,4,3+,19028,949957,5538349,13030,293477,1963450
1989-11-29,1990,60,D,4,3+,17817,967774,5538349,11617,305094,1963450
1989-11-30,1990,61,D,4,3+,17205,984979,5538349,10751,315845,1963450
1989-12-01,1990,62,D,4,3+,16903,1001882,5538349,4248,320093,1963450
1989-12-02,1990,63,D,4,3+,16283,1018165,5538349,3890,323983,1963450
1989-12-03,1990,64,D,4,3+,16442,1034607,5538349,4065,328048,1963450
1989-12-04,1990,65,D,4,3+,16933,1051540,5538349,4151,332199,1963450
1989-12-05,1990,66,D,4,3+,17172,1068712,5538349,4561,336760,1963450
1989-12-06,1990,67,D,4,3+,17185,1085897,5538349,5068,341828,1963450
1989-12-07,1990,68,D,4,3+,17687,1103584,5538349,5703,347531,1963450
1989-12-08,1990,69,D,4,3+,18672,1122256,5538349,5897,353428,1963450
1989-12-09,1990,70,D,4,3+,19345,1141601,5538349,5898,359326,1963450
1989-12-10,1990,71,D,4,3+,19608,1161209,5538349,6460,365786,1963450
1989-12-11,1990,72,D,4,3+,19280,1180489,5538349,6383,372169,1963450
1989-12-12,1990,73,D,4,3+,18162,1198651,5538349,5769,377938,1963450
1989-12-13,1990,74,D,4,3+,17553,1216204,5538349,4935,382873,1963450
1989-12-14,1990,75,D,4,3+,17149,1233353,5538349,3439,386312,1963450
1989-12-15,1990,76,D,4,3+,16960,1250313,5538349,4095,390407,1963450
1989-12-16,1990,77,D,4,3+,16799,1267112,5538349,3941,394348,1963450
1989-12-17,1990,78,D,4,3+,16586,1283698,5538349,3634,397982,1963450
1989-12-18,1990,79,D,4,3+,16215,1299913,5538349,4327,402309,1963450
1989-12-19,1990,80,D,4,3+,15854,1315767,5538349,3584,405893,1963450
1989-12-20,1990,81,D,4,3+,15462,1331229,5538349,3345,409238,1963450
1989-12-21,1990,82,D,4,3+,15379,1346608,5538349,2873,412111,1963450
1989-12-22,1990,83,D,4,3+,15418,1362026,5538349,3276,415387,1963450
1989-12-23,1990,84,D,4,3+,15409,1377435,5538349,2600,417987,1963450
1989-12-24,1990,85,D,4,3+,15288,1392723,5538349,2178,420165,1963450
1989-12-25,1990,86,D,4,3+,15367,1408090,5538349,2425,422590,1963450
1989-12-26,1990,87,D,4,3+,15146,1423236,5538349,2113,424703,1963450
1989-12-27,1990,88,D,4,3+,15425,1438661,5538349,3328,428031,1963450
1989-12-28,1990,89,D,4,3+,16824,1455485,5538349,5698,433729,1963450
1989-12-29,1990,90,D,4,3+,17904,1473389,5538349,6407,440136,1963450
1989-12-30,1990,91,D,4,3+,18411,1491800,5538349,6236,446372,1963450
1989-12-31,1990,92,D,4,3+,18473,1510273,5538349,5847,452219,1963450
1990-01-01,1990,93,D,4,3+,18225,1528498,5538349,5790,458009,1963450
1990-01-02,1990,94,D,4,3+,18327,1546825,5538349,9077,467086,1963450
1990-01-03,1990,95,D,4,3+,17208,1564033,5538349,7896,474982,1963450
1990-01-04,1990,96,D,4,3+,16780,1580813,5538349,7606,482588,1963450
1990-01-05,1990,97,D,4,3+,16190,1597003,5538349,6888,489476,1963450
1990-01-06,1990,98,D,4,3+,15803,1612806,5538349,6153,495629,1963450
1990-01-07,1990,99,D,4,3+,16211,1629017,5538349,4643,500272,1963450
1990-01-08,1990,100,D,4,3+,17240,1646257,5538349,5303,505575,1963450
1990-01-09,1990,101,D,4,3+,18439,1664696,5538349,5101,510676,1963450
1990-01-10,1990,102,D,4,3+,24869,1689565,5538349,13019,523695,1963450
1990-01-11,1990,103,D,4,3+,25846,1715411,5538349,13609,537304,1963450
1990-01-12,1990,104,D,4,3+,22035,1737446,5538349,9960,547264,1963450
1990-01-13,1990,105,D,4,3+,23070,1760516,5538349,13856,561120,1963450
1990-01-14,1990,106,D,4,3+,28079,1788595,5538349,20571,581691,1963450
1990-01-15,1990,107,D,4,3+,36088,1824683,5538349,28839,610530,1963450
1990-01-16,1990,108,D,4,3+,38654,1863337,5538349,31820,642350,1963450
1990-01-17,1990,109,D,4,3+,33698,1897035,5538349,27776,670126,1963450
1990-01-18,1990,110,D,4,3+,30108,1927143,5538349,21211,691337,1963450
1990-01-19,1990,111,D,4,3+,27148,1954291,5538349,16993,708330,1963450
1990-01-20,1990,112,D,4,3+,23413,1977704,5538349,12412,720742,1963450
1990-01-21,1990,113,D,4,3+,20377,1998081,5538349,8435,729177,1963450
1990-01-22,1990,114,D,4,3+,18156,2016237,5538349,6205,735382,1963450
1990-01-23,1990,115,D,4,3+,16356,2032593,5538349,4651,740033,1963450
1990-01-24,1990,116,D,4,3+,15539,2048132,5538349,3717,743750,1963450
1990-01-25,1990,117,D,4,3+,14634,2062766,5538349,3077,746827,1963450
1990-01-26,1990,118,D,4,3+,13799,2076565,5538349,1999,748826,1963450
1990-01-27,1990,119,D,4,3+,13687,2090252,5538349,2254,751080,1963450
1990-01-28,1990,120,D,4,3+,13073,2103325,5538349,1503,752583,1963450
1990-01-29,1990,121,D,4,3+,12565,2115890,5538349,800,753383,1963450
1990-01-30,1990,122,D,4,3+,12277,2128167,5538349,1933,755316,1963450
1990-01-31,1990,123,D,4,3+,13144,2141311,5538349,3361,758677,1963450
1990-02-01,1990,124,D,4,3+,13851,2155162,5538349,5091,763768,1963450
1990-02-02,1990,125,D,4,3+,15176,2170338,5538349,6667,770435,1963450
1990-02-03,1990,126,D,4,3+,14964,2185302,5538349,5553,775988,1963450
1990-02-04,1990,127,D,4,3+,15766,2201068,5538349,7566,783554,1963450
1990-02-05,1990,128,D,4,3+,16312,2217380,5538349,8203,791757,1963450
1990-02-06,1990,129,D,4,3+,16777,2234157,5538349,9016,800773,1963450
1990-02-07,1990,130,D,4,3+,17288,2251445,5538349,9535,810308,1963450
1990-02-08,1990,131,D,4,3+,16630,2268075,5538349,8896,819204,1963450
1990-02-09,1990,132,D,4,3+,15805,2283880,5538349,5587,824791,1963450
1990-02-10,1990,133,D,4,3+,14785,2298665,5538349,4780,829571,1963450
1990-02-11,1990,134,D,4,3+,13966,2312631,5538349,2524,832095,1963450
1990-02-12,1990,135,D,4,3+,13346,2325977,5538349,1797,833892,1963450
1990-02-13,1990,136,D,4,3+,13030,2339007,5538349,1620,835512,1963450
1990-02-14,1990,137,D,4,3+,12997,2352004,5538349,1992,837504,1963450
1990-02-15,1990,138,D,4,3+,11974,2363978,5538349,1064,838568,1963450
1990-02-16,1990,139,D,4,3+,13335,2377313,5538349,2336,840904,1963450
1990-02-17,1990,140,D,4,3+,19548,2396861,5538349,16338,857242,1963450
1990-02-18,1990,141,D,4,3+,21294,2418155,5538349,19492,876734,1963450
1990-02-19,1990,142,D,4,3+,20007,2438162,5538349,18323,895057,1963450
1990-02-20,1990,143,D,4,3+,18271,2456433,5538349,16721,911778,1963450
1990-02-21,1990,144,D,4,3+,16665,2473098,5538349,14760,926538,1963450
1990-02-22,1990,145,D,4,3+,15816,2488914,5538349,5879,932417,1963450
1990-02-23,1990,146,D,4,3+,15338,2504252,5538349,3840,936257,1963450
1990-02-24,1990,147,D,4,3+,14973,2519225,5538349,3379,939636,1963450
1990-02-25,1990,148,D,4,3+,14520,2533745,5538349,3128,942764,1963450
1990-02-26,1990,149,D,4,3+,13893,2547638,5538349,2174,944938,1963450
1990-02-27,1990,150,D,4,3+,13691,2561329,5538349,2109,947047,1963450
1990-02-28,1990,151,D,4,3+,13265,2574594,5538349,1682,948729,1963450
1990-03-01,1990,152,D,4,3+,13267,2587861,5538349,1872,950601,1963450
1990-03-02,1990,153,D,4,3+,13340,2601201,5538349,2203,952804,1963450
1990-03-03,1990,154,D,4,3+,14020,2615221,5538349,5086,957890,1963450
1990-03-04,1990,155,D,4,3+,14439,2629660,5538349,5263,963153,1963450
1990-03-05,1990,156,D,4,3+,17144,2646804,5538349,9372,972525,1963450
1990-03-06,1990,157,D,4,3+,19466,2666270,5538349,12199,984724,1963450
1990-03-07,1990,158,D,4,3+,20139,2686409,5538349,12030,996754,1963450
1990-03-08,1990,159,D,4,3+,19653,2706062,5538349,9282,1006036,1963450
1990-03-09,1990,160,D,4,3+,17715,2723777,5538349,7465,1013501,1963450
1990-03-10,1990,161,D,4,3+,16204,2739981,5538349,4109,1017610,1963450
1990-03-11,1990,162,D,4,3+,16458,2756439,5538349,4651,1022261,1963450
1990-03-12,1990,163,D,4,3+,16933,2773372,5538349,5563,1027824,1963450
1990-03-13,1990,164,D,4,3+,17524,2790896,5538349,6035,1033859,1963450
1990-03-14,1990,165,D,4,3+,17070,2807966,5538349,5331,1039190,1963450
1990-03-15,1990,166,D,4,3+,15653,2823619,5538349,4080,1043270,1963450
1990-03-16,1990,167,D,4,3+,14919,2838538,5538349,3110,1046380,1963450
1990-03-17,1990,168,D,4,3+,13999,2852537,5538349,1949,1048329,1963450
1990-03-18,1990,169,D,4,3+,13711,2866248,5538349,1947,1050276,1963450
1990-03-19,1990,170,D,4,3+,13525,2879773,5538349,1709,1051985,1963450
1990-03-20,1990,171,D,4,3+,13060,2892833,5538349,1193,1053178,1963450
1990-03-21,1990,172,D,4,3+,12591,2905424,5538349,382,1053560,1963450
1990-03-22,1990,173,D,4,3+,12760,2918184,5538349,469,1054029,1963450
1990-03-23,1990,174,D,4,3+,13209,2931393,5538349,864,1054893,1963450
1990-03-24,1990,175,D,4,3+,13183,2944576,5538349,741,1055634,1963450
1990-03-25,1990,176,D,4,3+,13400,2957976,5538349,895,1056529,1963450
1990-03-26,1990,177,D,4,3+,14001,2971977,5538349,1447,1057976,1963450
1990-03-27,1990,178,D,4,3+,13513,2985490,5538349,1058,1059034,1963450
1990-03-28,1990,179,D,4,3+,14263,2999753,5538349,1671,1060705,1963450
1990-03-29,1990,180,D,4,3+,14696,3014449,5538349,2117,1062822,1963450
1990-03-30,1990,181,D,4,3+,14544,3028993,5538349,1951,1064773,1963450
1990-03-31,1990,182,D,4,3+,14825,3043818,5538349,2163,1066936,1963450
1990-04-01,1990,183,D,4,3+,15276,3059094,5538349,2892,1069828,1963450
1990-04-02,1990,184,D,4,3+,15920,3075014,5538349,3435,1073263,1963450
1990-04-03,1990,185,D,4,3+,15793,3090807,5538349,3151,1076414,1963450
1990-04-04,1990,186,D,4,3+,14694,3105501,5538349,1834,1078248,1963450
1990-04-05,1990,187,D,4,3+,15094,3120595,5538349,3344,1081592,1963450
1990-04-06,1990,188,D,4,3+,16683,3137278,5538349,4892,1086484,1963450
1990-04-07,1990,189,D,4,3+,17432,3154710,5538349,5608,1092092,1963450
1990-04-08,1990,190,D,4,3+,17529,3172239,5538349,4713,1096805,1963450
1990-04-09,1990,191,D,4,3+,17701,3189940,5538349,4823,1101628,1963450
1990-04-10,1990,192,D,4,3+,17838,3207778,5538349,6037,1107665,1963450
1990-04-11,1990,193,D,4,3+,18430,3226208,5538349,6695,1114360,1963450
1990-04-12,1990,194,D,4,3+,19086,3245294,5538349,7185,1121545,1963450
1990-04-13,1990,195,D,4,3+,18743,3264037,5538349,7282,1128827,1963450
1990-04-14,1990,196,D,4,3+,18394,3282431,5538349,6980,1135807,1963450
1990-04-15,1990,197,D,4,3+,19321,3301752,5538349,7839,1143646,1963450
1990-04-16,1990,198,D,4,3+,19783,3321535,5538349,8415,1152061,1963450
1990-04-17,1990,199,D,4,3+,19731,3341266,5538349,8741,1160802,1963450
1990-04-18,1990,200,D,4,3+,19275,3360541,5538349,8335,1169137,1963450
1990-04-19,1990,201,D,4,3+,18977,3379518,5538349,8101,1177238,1963450
1990-04-20,1990,202,D,4,3+,19039,3398557,5538349,7664,1184902,1963450
1990-04-21,1990,203,D,4,3+,18074,3416631,5538349,6659,1191561,1963450
1990-04-22,1990,204,D,4,3+,17186,3433817,5538349,5284,1196845,1963450
1990-04-23,1990,205,D,4,3+,17234,3451051,5538349,8048,1204893,1963450
1990-04-24,1990,206,D,4,3+,17927,3468978,5538349,9573,1214466,1963450
1990-04-25,1990,207,D,4,3+,17047,3486025,5538349,8838,1223304,1963450
1990-04-26,1990,208,D,4,3+,16674,3502699,5538349,7736,1231040,1963450
1990-04-27,1990,209,D,4,3+,15409,3518108,5538349,7170,1238210,1963450
1990-04-28,1990,210,D,4,3+,12876,3530984,5538349,2008,1240218,1963450
1990-04-29,1990,211,D,4,3+,11096,3542080,5538349,2339,1242557,1963450
1990-04-30,1990,212,D,4,3+,10737,3552817,5538349,2062,1244619,1963450
1990-05-01,1990,213,D,4,3+,9858,3562675,5538349,3948,1248567,1963450
1990-05-02,1990,214,D,4,3+,9444,3572119,5538349,4070,1252637,1963450
1990-05-03,1990,215,D,4,3+,8832,3580951,5538349,3178,1255815,1963450
1990-05-04,1990,216,D,4,3+,7845,3588796,5538349,2231,1258046,1963450
1990-05-05,1990,217,D,4,3+,7297,3596093,5538349,2546,1260592,1963450
1990-05-06,1990,218,D,4,3+,7243,3603336,5538349,2508,1263100,1963450
1990-05-07,1990,219,D,4,3+,7817,3611153,5538349,3245,1266345,1963450
1990-05-08,1990,220,D,4,3+,7705,3618858,5538349,3398,1269743,1963450
1990-05-09,1990,221,D,4,3+,8867,3627725,5538349,4499,1274242,1963450
1990-05-10,1990,222,D,4,3+,9929,3637654,5538349,5363,1279605,1963450
1990-05-11,1990,223,D,4,3+,10176,3647830,5538349,5767,1285372,1963450
1990-05-12,1990,224,D,4,3+,10743,3658573,5538349,5808,1291180,1963450
1990-05-13,1990,225,D,4,3+,10944,3669517,5538349,5954,1297134,1963450
1990-05-14,1990,226,D,4,3+,11073,3680590,5538349,5759,1302893,1963450
1990-05-15,1990,227,D,4,3+,11136,3691726,5538349,5768,1308661,1963450
1990-05-16,1990,228,D,4,3+,11653,3703379,5538349,5073,1313734,1963450
1990-05-17,1990,229,D,4,3+,11666,3715045,5538349,4397,1318131,1963450
1990-05-18,1990,230,D,4,3+,12392,3727437,5538349,5199,1323330,1963450
1990-05-19,1990,231,D,4,3+,11026,3738463,5538349,4352,1327682,1963450
1990-05-20,1990,232,D,4,3+,11071,3749534,5538349,4492,1332174,1963450
1990-05-21,1990,233,D,4,3+,11718,3761252,5538349,5076,1337250,1963450
1990-05-22,1990,234,D,4,3+,12093,3773345,5538349,5267,1342517,1963450
1990-05-23,1990,235,D,4,3+,11963,3785308,5538349,5176,1347693,1963450
1990-05-24,1990,236,D,4,3+,13287,3798595,5538349,6604,1354297,1963450
1990-05-25,1990,237,D,4,3+,14298,3812893,5538349,7844,1362141,1963450
1990-05-26,1990,238,D,4,3+,15144,3828037,5538349,8900,1371041,1963450
1990-05-27,1990,239,D,4,3+,14937,3842974,5538349,10371,1381412,1963450
1990-05-28,1990,240,D,4,3+,17090,3860064,5538349,21838,1403250,1963450
1990-05-29,1990,241,D,4,3+,19823,3879887,5538349,24730,1427980,1963450
1990-05-30,1990,242,D,4,3+,22472,3902359,5538349,27587,1455567,1963450
1990-05-31,1990,243,D,4,3+,22454,3924813,5538349,27757,1483324,1963450
1990-06-01,1990,244,D,4,3+,21152,3945965,5538349,23502,1506826,1963450
1990-06-02,1990,245,D,4,3+,22253,3968218,5538349,14888,1521714,1963450
1990-06-03,1990,246,D,4,3+,20578,3988796,5538349,13537,1535251,1963450
1990-06-04,1990,247,D,4,3+,17465,4006261,5538349,10177,1545428,1963450
1990-06-05,1990,248,D,4,3+,13310,4019571,5538349,5373,1550801,1963450
1990-06-06,1990,249,D,4,3+,11271,4030842,5538349,2963,1553764,1963450
1990-06-07,1990,250,D,4,3+,10355,4041197,5538349,2272,1556036,1963450
1990-06-08,1990,251,D,4,3+,9345,4050542,5538349,2163,1558199,1963450
1990-06-09,1990,252,D,4,3+,9306,4059848,5538349,2816,1561015,1963450
1990-06-10,1990,253,D,4,3+,9716,4069564,5538349,3066,1564081,1963450
1990-06-11,1990,254,D,4,3+,9432,4078996,5538349,2407,1566488,1963450
1990-06-12,1990,255,D,4,3+,8803,4087799,5538349,1923,1568411,1963450
1990-06-13,1990,256,D,4,3+,8680,4096479,5538349,1774,1570185,1963450
1990-06-14,1990,257,D,4,3+,9447,4105926,5538349,2169,1572354,1963450
1990-06-15,1990,258,D,4,3+,10666,4116592,5538349,3207,1575561,1963450
1990-06-16,1990,259,D,4,3+,11439,4128031,5538349,4040,1579601,1963450
1990-06-17,1990,260,D,4,3+,10953,4138984,5538349,3224,1582825,1963450
1990-06-18,1990,261,D,4,3+,11977,4150961,5538349,4170,1586995,1963450
1990-06-19,1990,262,D,4,3+,12089,4163050,5538349,4234,1591229,1963450
1990-06-20,1990,263,D,4,3+,11299,4174349,5538349,3359,1594588,1963450
1990-06-21,1990,264,D,4,3+,10174,4184523,5538349,3246,1597834,1963450
1990-06-22,1990,265,D,4,3+,10690,4195213,5538349,3945,1601779,1963450
1990-06-23,1990,266,D,4,3+,11612,4206825,5538349,5053,1606832,1963450
1990-06-24,1990,267,D,4,3+,11825,4218650,5538349,4739,1611571,1963450
1990-06-25,1990,268,D,4,3+,11592,4230242,5538349,4224,1615795,1963450
1990-06-26,1990,269,D,4,3+,10712,4240954,5538349,3792,1619587,1963450
1990-06-27,1990,270,D,4,3+,9706,4250660,5538349,2535,1622122,1963450
1990-06-28,1990,271,D,4,3+,9879,4260539,5538349,1949,1624071,1963450
1990-06-29,1990,272,D,4,3+,9941,4270480,5538349,1929,1626000,1963450
1990-06-30,1990,273,D,4,3+,11361,4281841,5538349,2717,1628717,1963450
1990-07-01,1990,274,D,4,3+,12981,4294822,5538349,3612,1632329,1963450
1990-07-02,1990,275,D,4,3+,13812,4308634,5538349,4640,1636969,1963450
1990-07-03,1990,276,D,4,3+,13409,4322043,5538349,4411,1641380,1963450
1990-07-04,1990,277,D,4,3+,13598,4335641,5538349,4279,1645659,1963450
1990-07-05,1990,278,D,4,3+,13107,4348748,5538349,4009,1649668,1963450
1990-07-06,1990,279,D,4,3+,12387,4361135,5538349,3040,1652708,1963450
1990-07-07,1990,280,D,4,3+,12379,4373514,5538349,2757,1655465,1963450
1990-07-08,1990,281,D,4,3+,12244,4385758,5538349,2327,1657792,1963450
1990-07-09,1990,282,D,4,3+,12452,4398210,5538349,2843,1660635,1963450
1990-07-10,1990,283,D,4,3+,13701,4411911,5538349,4509,1665144,1963450
1990-07-11,1990,284,D,4,3+,15230,4427141,5538349,4451,1669595,1963450
1990-07-12,1990,285,D,4,3+,15375,4442516,5538349,2674,1672269,1963450
1990-07-13,1990,286,D,4,3+,14428,4456944,5538349,2351,1674620,1963450
1990-07-14,1990,287,D,4,3+,13598,4470542,5538349,2258,1676878,1963450
1990-07-15,1990,288,D,4,3+,14364,4484906,5538349,3574,1680452,1963450
1990-07-16,1990,289,D,4,3+,15329,4500235,5538349,4469,1684921,1963450
1990-07-17,1990,290,D,4,3+,15797,4516032,5538349,4850,1689771,1963450
1990-07-18,1990,291,D,4,3+,15819,4531851,5538349,4972,1694743,1963450
1990-07-19,1990,292,D,4,3+,16097,4547948,5538349,5255,1699998,1963450
1990-07-20,1990,293,D,4,3+,16359,4564307,5538349,5329,1705327,1963450
1990-07-21,1990,294,D,4,3+,16358,4580665,5538349,5381,1710708,1963450
1990-07-22,1990,295,D,4,3+,16210,4596875,5538349,5296,1716004,1963450
1990-07-23,1990,296,D,4,3+,16484,4613359,5538349,4953,1720957,1963450
1990-07-24,1990,297,D,4,3+,16273,4629632,5538349,4527,1725484,1963450
1990-07-25,1990,298,D,4,3+,16037,4645669,5538349,3720,1729204,1963450
1990-07-26,1990,299,D,4,3+,15782,4661451,5538349,3796,1733000,1963450
1990-07-27,1990,300,D,4,3+,15049,4676500,5538349,3124,1736124,1963450
1990-07-28,1990,301,D,4,3+,15248,4691748,5538349,4291,1740415,1963450
1990-07-29,1990,302,D,4,3+,15280,4707028,5538349,3079,1743494,1963450
1990-07-30,1990,303,D,4,3+,15468,4722496,5538349,3558,1747052,1963450
1990-07-31,1990,304,D,4,3+,15408,4737904,5538349,4606,1751658,1963450
1990-08-01,1990,305,D,4,3+,15464,4753368,5538349,5405,1757063,1963450
1990-08-02,1990,306,D,4,3+,15419,4768787,5538349,5276,1762339,1963450
1990-08-03,1990,307,D,4,3+,15973,4784760,5538349,6464,1768803,1963450
1990-08-04,1990,308,D,4,3+,15780,4800540,5538349,5582,1774385,1963450
1990-08-05,1990,309,D,4,3+,16570,4817110,5538349,6675,1781060,1963450
1990-08-06,1990,310,D,4,3+,17228,4834338,5538349,6104,1787164,1963450
1990-08-07,1990,311,D,4,3+,16114,4850452,5538349,4246,1791410,1963450
1990-08-08,1990,312,D,4,3+,15484,4865936,5538349,4026,1795436,1963450
1990-08-09,1990,313,D,4,3+,15046,4880982,5538349,4317,1799753,1963450
1990-08-10,1990,314,D,4,3+,15300,4896282,5538349,4838,1804591,1963450
1990-08-11,1990,315,D,4,3+,15449,4911731,5538349,5767,1810358,1963450
1990-08-12,1990,316,D,4,3+,15236,4926967,5538349,5605,1815963,1963450
1990-08-13,1990,317,D,4,3+,14782,4941749,5538349,5476,1821439,1963450
1990-08-14,1990,318,D,4,3+,14381,4956130,5538349,4151,1825590,1963450
1990-08-15,1990,319,D,4,3+,15094,4971224,5538349,4926,1830516,1963450
1990-08-16,1990,320,D,4,3+,15625,4986849,5538349,5139,1835655,1963450
1990-08-17,1990,321,D,4,3+,15828,5002677,5538349,5037,1840692,1963450
1990-08-18,1990,322,D,4,3+,15801,5018478,5538349,4279,1844971,1963450
1990-08-19,1990,323,D,4,3+,16107,5034585,5538349,4624,1849595,1963450
1990-08-20,1990,324,D,4,3+,15559,5050144,5538349,4108,1853703,1963450
1990-08-21,1990,325,D,4,3+,15330,5065474,5538349,3888,1857591,1963450
1990-08-22,1990,326,D,4,3+,14659,5080133,5538349,2812,1860403,1963450
1990-08-23,1990,327,D,4,3+,14078,5094211,5538349,2722,1863125,1963450
1990-08-24,1990,328,D,4,3+,13824,5108035,5538349,3041,1866166,1963450
1990-08-25,1990,329,D,4,3+,14306,5122341,5538349,3602,1869768,1963450
1990-08-26,1990,330,D,4,3+,13937,5136278,5538349,3267,1873035,1963450
1990-08-27,1990,331,D,4,3+,13784,5150062,5538349,2670,1875705,1963450
1990-08-28,1990,332,D,4,3+,13995,5164057,5538349,3198,1878903,1963450
1990-08-29,1990,333,D,4,3+,13734,5177791,5538349,2945,1881848,1963450
1990-08-30,1990,334,D,4,3+,13705,5191496,5538349,3833,1885681,1963450
1990-08-31,1990,335,D,4,3+,13693,5205189,5538349,4264,1889945,1963450
1990-09-01,1990,336,D,4,3+,13442,5218631,5538349,3765,1893710,1963450
1990-09-02,1990,337,D,4,3+,13372,5232003,5538349,3788,1897498,1963450
1990-09-03,1990,338,D,4,3+,12649,5244652,5538349,2632,1900130,1963450
1990-09-04,1990,339,D,4,3+,13230,5257882,5538349,3968,1904098,1963450
1990-09-05,1990,340,D,4,3+,13215,5271097,5538349,3269,1907367,1963450
1990-09-06,1990,341,D,4,3+,12991,5284088,5538349,3381,1910748,1963450
1990-09-07,1990,342,D,4,3+,12947,5297035,5538349,3114,1913862,1963450
1990-09-08,1990,343,D,4,3+,13153,5310188,5538349,3217,1917079,1963450
1990-09-09,1990,344,D,4,3+,13172,5323360,5538349,3367,1920446,1963450
1990-09-10,1990,345,D,4,3+,12233,5335593,5538349,2688,1923134,1963450
1990-09-11,1990,346,D,4,3+,12387,5347980,5538349,4421,1927555,1963450
1990-09-12,1990,347,D,4,3+,12141,5360121,5538349,3947,1931502,1963450
1990-09-13,1990,348,D,4,3+,12058,5372179,5538349,4044,1935546,1963450
1990-09-14,1990,349,D,4,3+,11873,5384052,5538349,4168,1939714,1963450
1990-09-15,1990,350,D,4,3+,11292,5395344,5538349,3891,1943605,1963450
1990-09-16,1990,351,D,4,3+,10983,5406327,5538349,3207,1946812,1963450
1990-09-17,1990,352,D,4,3+,10514,5416841,5538349,2167,1948979,1963450
1990-09-18,1990,353,D,4,3+,9890,5426731,5538349,1630,1950609,1963450
1990-09-19,1990,354,D,4,3+,9714,5436445,5538349,1551,1952160,1963450
1990-09-20,1990,355,D,4,3+,9710,5446155,5538349,1405,1953565,1963450
1990-09-21,1990,356,D,4,3+,8954,5455109,5538349,100,1953665,1963450
1990-09-22,1990,357,D,4,3+,9355,5464464,5538349,1468,1955133,1963450
1990-09-23,1990,358,D,4,3+,9026,5473490,5538349,1180,1956313,1963450
1990-09-24,1990,359,D,4,3+,8950,5482440,5538349,720,1957033,1963450
1990-09-25,1990,360,D,4,3+,8658,5491098,5538349,694,1957727,1963450
1990-09-26,1990,361,D,4,3+,8912,5500010,5538349,1294,1959021,1963450
1990-09-27,1990,362,D,4,3+,9263,5509273,5538349,1357,1960378,1963450
1990-09-28,1990,363,D,4,3+,9838,5519111,5538349,1241,1961619,1963450
1990-09-29,1990,364,D,4,3+,9843,5528954,5538349,1514,1963133,1963450
1990-09-30,1990,365,D,4,3+,9395,5538349,5538349,317,1963450,1963450
1990-10-01,1991,1,D,5,3+,9015,9015,4299821,873,873,2175356
1990-10-02,1991,2,D,5,3+,8927,17942,4299821,2260,3133,2175356
1990-10-03,1991,3,D,5,3+,8580,26522,4299821,1466,4599,2175356
1990-10-04,1991,4,D,5,3+,7977,34499,4299821,615,5214,2175356
1990-10-05,1991,5,D,5,3+,7989,42488,4299821,2436,7650,2175356
1990-10-06,1991,6,D,5,3+,8354,50842,4299821,3329,10979,2175356
1990-10-07,1991,7,D,5,3+,8238,59080,4299821,2668,13647,2175356
1990-10-08,1991,8,D,5,3+,8280,67360,4299821,2759,16406,2175356
1990-10-09,1991,9,D,5,3+,8103,75463,4299821,2589,18995,2175356
1990-10-10,1991,10,D,5,3+,8450,83913,4299821,3652,22647,2175356
1990-10-11,1991,11,D,5,3+,8881,92794,4299821,4144,26791,2175356
1990-10-12,1991,12,D,5,3+,9019,101813,4299821,3655,30446,2175356
1990-10-13,1991,13,D,5,3+,8915,110728,4299821,3525,33971,2175356
1990-10-14,1991,14,D,5,3+,8779,119507,4299821,3569,37540,2175356
1990-10-15,1991,15,D,5,3+,8832,128339,4299821,3922,41462,2175356
1990-10-16,1991,16,D,5,3+,8888,137227,4299821,3686,45148,2175356
1990-10-17,1991,17,D,5,3+,8363,145590,4299821,2845,47993,2175356
1990-10-18,1991,18,D,5,3+,7960,153550,4299821,2842,50835,2175356
1990-10-19,1991,19,D,5,3+,8629,162179,4299821,4241,55076,2175356
1990-10-20,1991,20,D,5,3+,8617,170796,4299821,3529,58605,2175356
1990-10-21,1991,21,D,5,3+,8680,179476,4299821,3579,62184,2175356
1990-10-22,1991,22,D,5,3+,8203,187679,4299821,2880,65064,2175356
1990-10-23,1991,23,D,5,3+,8484,196163,4299821,4266,69330,2175356
1990-10-24,1991,24,D,5,3+,9235,205398,4299821,5362,74692,2175356
1990-10-25,1991,25,D,5,3+,9402,214800,4299821,5027,79719,2175356
1990-10-26,1991,26,D,5,3+,9836,224636,4299821,4753,84472,2175356
1990-10-27,1991,27,D,5,3+,10016,234652,4299821,4307,88779,2175356
1990-10-28,1991,28,D,5,3+,10150,244802,4299821,4231,93010,2175356
1990-10-29,1991,29,D,5,3+,10183,254985,4299821,4357,97367,2175356
1990-10-30,1991,30,D,5,3+,10077,265062,4299821,3765,101132,2175356
1990-10-31,1991,31,D,5,3+,9693,274755,4299821,4426,105558,2175356
1990-11-01,1991,32,D,5,3+,9936,284691,4299821,5214,110772,2175356
1990-11-02,1991,33,D,5,3+,9621,294312,4299821,4588,115360,2175356
1990-11-03,1991,34,D,5,3+,9586,303898,4299821,3793,119153,2175356
1990-11-04,1991,35,D,5,3+,9861,313759,4299821,5631,124784,2175356
1990-11-05,1991,36,D,5,3+,9904,323663,4299821,3847,128631,2175356
1990-11-06,1991,37,D,5,3+,10585,334248,4299821,5186,133817,2175356
1990-11-07,1991,38,D,5,3+,9220,343468,4299821,1785,135602,2175356
1990-11-08,1991,39,D,5,3+,9657,353125,4299821,3231,138833,2175356
1990-11-09,1991,40,D,5,3+,9856,362981,4299821,2420,141253,2175356
1990-11-10,1991,41,D,5,3+,9527,372508,4299821,3204,144457,2175356
1990-11-11,1991,42,D,5,3+,9072,381580,4299821,2251,146708,2175356
1990-11-12,1991,43,D,5,3+,8223,389803,4299821,1887,148595,2175356
1990-11-13,1991,44,D,5,3+,8365,398168,4299821,3210,151805,2175356
1990-11-14,1991,45,D,5,3+,8597,406765,4299821,5107,156912,2175356
1990-11-15,1991,46,D,5,3+,8689,415454,4299821,4021,160933,2175356
1990-11-16,1991,47,D,5,3+,8627,424081,4299821,3778,164711,2175356
1990-11-17,1991,48,D,5,3+,8515,432596,4299821,3816,168527,2175356
1990-11-18,1991,49,D,5,3+,8612,441208,4299821,4402,172929,2175356
1990-11-19,1991,50,D,5,3+,8333,449541,4299821,2975,175904,2175356
1990-11-20,1991,51,D,5,3+,8618,458159,4299821,5715,181619,2175356
1990-11-21,1991,52,D,5,3+,8809,466968,4299821,4342,185961,2175356
1990-11-22,1991,53,D,5,3+,8489,475457,4299821,3578,189539,2175356
1990-11-23,1991,54,D,5,3+,8530,483987,4299821,3483,193022,2175356
1990-11-24,1991,55,D,5,3+,8797,492784,4299821,3636,196658,2175356
1990-11-25,1991,56,D,5,3+,8626,501410,4299821,2854,199512,2175356
1990-11-26,1991,57,D,5,3+,9999,511409,4299821,8809,208321,2175356
1990-11-27,1991,58,D,5,3+,9393,520802,4299821,6136,214457,2175356
1990-11-28,1991,59,D,5,3+,9059,529861,4299821,5528,219985,2175356
1990-11-29,1991,60,D,5,3+,8622,538483,4299821,10240,230225,2175356
1990-11-30,1991,61,D,5,3+,8229,546712,4299821,10181,240406,2175356
1990-12-01,1991,62,D,5,3+,8216,554928,4299821,8000,248406,2175356
1990-12-02,1991,63,D,5,3+,8267,563195,4299821,9297,257703,2175356
1990-12-03,1991,64,D,5,3+,9924,573119,4299821,9940,267643,2175356
1990-12-04,1991,65,D,5,3+,11316,584435,4299821,5361,273004,2175356
1990-12-05,1991,66,D,5,3+,12113,596548,4299821,4854,277858,2175356
1990-12-06,1991,67,D,5,3+,12483,609031,4299821,4631,282489,2175356
1990-12-07,1991,68,D,5,3+,12247,621278,4299821,3167,285656,2175356
1990-12-08,1991,69,D,5,3+,12233,633511,4299821,3044,288700,2175356
1990-12-09,1991,70,D,5,3+,12328,645839,4299821,3964,292664,2175356
1990-12-10,1991,71,D,5,3+,12444,658283,4299821,4045,296709,2175356
1990-12-11,1991,72,D,5,3+,13399,671682,4299821,11820,308529,2175356
1990-12-12,1991,73,D,5,3+,13243,684925,4299821,10971,319500,2175356
1990-12-13,1991,74,D,5,3+,13150,698075,4299821,12227,331727,2175356
1990-12-14,1991,75,D,5,3+,12973,711048,4299821,11850,343577,2175356
1990-12-15,1991,76,D,5,3+,12570,723618,4299821,12656,356233,2175356
1990-12-16,1991,77,D,5,3+,13122,736740,4299821,8181,364414,2175356
1990-12-17,1991,78,D,5,3+,12912,749652,4299821,7404,371818,2175356
1990-12-18,1991,79,D,5,3+,12403,762055,4299821,7019,378837,2175356
1990-12-19,1991,80,D,5,3+,12300,774355,4299821,7894,386731,2175356
1990-12-20,1991,81,D,5,3+,13106,787461,4299821,7695,394426,2175356
1990-12-21,1991,82,D,5,3+,12308,799769,4299821,3689,398115,2175356
1990-12-22,1991,83,D,5,3+,11693,811462,4299821,3261,401376,2175356
1990-12-23,1991,84,D,5,3+,11890,823352,4299821,3658,405034,2175356
1990-12-24,1991,85,D,5,3+,11392,834744,4299821,2477,407511,2175356
1990-12-25,1991,86,D,5,3+,11485,846229,4299821,3153,410664,2175356
1990-12-26,1991,87,D,5,3+,11486,857715,4299821,4170,414834,2175356
1990-12-27,1991,88,D,5,3+,11287,869002,4299821,4712,419546,2175356
1990-12-28,1991,89,D,5,3+,10906,879908,4299821,4800,424346,2175356
1990-12-29,1991,90,D,5,3+,11297,891205,4299821,5757,430103,2175356
1990-12-30,1991,91,D,5,3+,11116,902321,4299821,4375,434478,2175356
1990-12-31,1991,92,D,5,3+,11007,913328,4299821,3815,438293,2175356
1991-01-01,1991,93,D,5,3+,11246,924574,4299821,3901,442194,2175356
1991-01-02,1991,94,D,5,3+,11341,935915,4299821,3262,445456,2175356
1991-01-03,1991,95,D,5,3+,11328,947243,4299821,2607,448063,2175356
1991-01-04,1991,96,D,5,3+,11312,958555,4299821,3724,451787,2175356
1991-01-05,1991,97,D,5,3+,11611,970166,4299821,3894,455681,2175356
1991-01-06,1991,98,D,5,3+,11407,981573,4299821,3658,459339,2175356
1991-01-07,1991,99,D,5,3+,11306,992879,4299821,3548,462887,2175356
1991-01-08,1991,100,D,5,3+,11411,1004290,4299821,4129,467016,2175356
1991-01-09,1991,101,D,5,3+,11027,1015317,4299821,4927,471943,2175356
1991-01-10,1991,102,D,5,3+,11224,1026541,4299821,6286,478229,2175356
1991-01-11,1991,103,D,5,3+,11005,1037546,4299821,5580,483809,2175356
1991-01-12,1991,104,D,5,3+,10721,1048267,4299821,4729,488538,2175356
1991-01-13,1991,105,D,5,3+,10466,1058733,4299821,5001,493539,2175356
1991-01-14,1991,106,D,5,3+,10222,1068955,4299821,4152,497691,2175356
1991-01-15,1991,107,D,5,3+,10030,1078985,4299821,3134,500825,2175356
1991-01-16,1991,108,D,5,3+,10026,1089011,4299821,3701,504526,2175356
1991-01-17,1991,109,D,5,3+,10140,1099151,4299821,4567,509093,2175356
1991-01-18,1991,110,D,5,3+,9809,1108960,4299821,4333,513426,2175356
1991-01-19,1991,111,D,5,3+,9894,1118854,4299821,4531,517957,2175356
1991-01-20,1991,112,D,5,3+,10032,1128886,4299821,4445,522402,2175356
1991-01-21,1991,113,D,5,3+,9360,1138246,4299821,3947,526349,2175356
1991-01-22,1991,114,D,5,3+,9168,1147414,4299821,2941,529290,2175356
1991-01-23,1991,115,D,5,3+,9275,1156689,4299821,3703,532993,2175356
1991-01-24,1991,116,D,5,3+,8824,1165513,4299821,3746,536739,2175356
1991-01-25,1991,117,D,5,3+,8380,1173893,4299821,4569,541308,2175356
1991-01-26,1991,118,D,5,3+,7936,1181829,4299821,4206,545514,2175356
1991-01-27,1991,119,D,5,3+,7842,1189671,4299821,4171,549685,2175356
1991-01-28,1991,120,D,5,3+,7859,1197530,4299821,4351,554036,2175356
1991-01-29,1991,121,D,5,3+,7546,1205076,4299821,2886,556922,2175356
1991-01-30,1991,122,D,5,3+,7692,1212768,4299821,2733,559655,2175356
1991-01-31,1991,123,D,5,3+,7284,1220052,4299821,1799,561454,2175356
1991-02-01,1991,124,D,5,3+,7246,1227298,4299821,1682,563136,2175356
1991-02-02,1991,125,D,5,3+,8806,1236104,4299821,4246,567382,2175356
1991-02-03,1991,126,D,5,3+,9963,1246067,4299821,7028,574410,2175356
1991-02-04,1991,127,D,5,3+,10198,1256265,4299821,6111,580521,2175356
1991-02-05,1991,128,D,5,3+,13639,1269904,4299821,15606,596127,2175356
1991-02-06,1991,129,D,5,3+,14109,1284013,4299821,24622,620749,2175356
1991-02-07,1991,130,D,5,3+,13605,1297618,4299821,23606,644355,2175356
1991-02-08,1991,131,D,5,3+,12643,1310261,4299821,21456,665811,2175356
1991-02-09,1991,132,D,5,3+,11116,1321377,4299821,22297,688108,2175356
1991-02-10,1991,133,D,5,3+,9946,1331323,4299821,15814,703922,2175356
1991-02-11,1991,134,D,5,3+,9123,1340446,4299821,3813,707735,2175356
1991-02-12,1991,135,D,5,3+,8555,1349001,4299821,5054,712789,2175356
1991-02-13,1991,136,D,5,3+,8236,1357237,4299821,4274,717063,2175356
1991-02-14,1991,137,D,5,3+,7963,1365200,4299821,3969,721032,2175356
1991-02-15,1991,138,D,5,3+,8135,1373335,4299821,4321,725353,2175356
1991-02-16,1991,139,D,5,3+,7883,1381218,4299821,4374,729727,2175356
1991-02-17,1991,140,D,5,3+,8398,1389616,4299821,4381,734108,2175356
1991-02-18,1991,141,D,5,3+,8300,1397916,4299821,3171,737279,2175356
1991-02-19,1991,142,D,5,3+,8118,1406034,4299821,2495,739774,2175356
1991-02-20,1991,143,D,5,3+,7728,1413762,4299821,1905,741679,2175356
1991-02-21,1991,144,D,5,3+,7426,1421188,4299821,2712,744391,2175356
1991-02-22,1991,145,D,5,3+,7352,1428540,4299821,3568,747959,2175356
1991-02-23,1991,146,D,5,3+,7602,1436142,4299821,4008,751967,2175356
1991-02-24,1991,147,D,5,3+,7136,1443278,4299821,2861,754828,2175356
1991-02-25,1991,148,D,5,3+,6950,1450228,4299821,2641,757469,2175356
1991-02-26,1991,149,D,5,3+,6677,1456905,4299821,2432,759901,2175356
1991-02-27,1991,150,D,5,3+,7273,1464178,4299821,3677,763578,2175356
1991-02-28,1991,151,D,5,3+,7684,1471862,4299821,3997,767575,2175356
1991-03-01,1991,152,D,5,3+,9540,1481402,4299821,12405,779980,2175356
1991-03-02,1991,153,D,5,3+,11988,1493390,4299821,16263,796243,2175356
1991-03-03,1991,154,D,5,3+,12927,1506317,4299821,16803,813046,2175356
1991-03-04,1991,155,D,5,3+,18163,1524480,4299821,22048,835094,2175356
1991-03-05,1991,156,D,5,3+,36866,1561346,4299821,40026,875120,2175356
1991-03-06,1991,157,D,5,3+,42538,1603884,4299821,39989,915109,2175356
1991-03-07,1991,158,D,5,3+,38725,1642609,4299821,34758,949867,2175356
1991-03-08,1991,159,D,5,3+,30326,1672935,4299821,22682,972549,2175356
1991-03-09,1991,160,D,5,3+,22722,1695657,4299821,11745,984294,2175356
1991-03-10,1991,161,D,5,3+,18037,1713694,4299821,6174,990468,2175356
1991-03-11,1991,162,D,5,3+,16324,1730018,4299821,6210,996678,2175356
1991-03-12,1991,163,D,5,3+,14371,1744389,4299821,4363,1001041,2175356
1991-03-13,1991,164,D,5,3+,17330,1761719,4299821,9825,1010866,2175356
1991-03-14,1991,165,D,5,3+,27120,1788839,4299821,19874,1030740,2175356
1991-03-15,1991,166,D,5,3+,33508,1822347,4299821,27689,1058429,2175356
1991-03-16,1991,167,D,5,3+,30809,1853156,4299821,23239,1081668,2175356
1991-03-17,1991,168,D,5,3+,26950,1880106,4299821,18993,1100661,2175356
1991-03-18,1991,169,D,5,3+,24169,1904275,4299821,15361,1116022,2175356
1991-03-19,1991,170,D,5,3+,22048,1926323,4299821,14911,1130933,2175356
1991-03-20,1991,171,D,5,3+,26506,1952829,4299821,18089,1149022,2175356
1991-03-21,1991,172,D,5,3+,29907,1982736,4299821,22286,1171308,2175356
1991-03-22,1991,173,D,5,3+,31284,2014020,4299821,23167,1194475,2175356
1991-03-23,1991,174,D,5,3+,26955,2040975,4299821,16793,1211268,2175356
1991-03-24,1991,175,D,5,3+,28195,2069170,4299821,19178,1230446,2175356
1991-03-25,1991,176,D,5,3+,39494,2108664,4299821,36847,1267293,2175356
1991-03-26,1991,177,D,5,3+,49259,2157923,4299821,48546,1315839,2175356
1991-03-27,1991,178,D,5,3+,56926,2214849,4299821,58341,1374180,2175356
1991-03-28,1991,179,D,5,3+,55320,2270169,4299821,56168,1430348,2175356
1991-03-29,1991,180,D,5,3+,48298,2318467,4299821,46480,1476828,2175356
1991-03-30,1991,181,D,5,3+,39826,2358293,4299821,30885,1507713,2175356
1991-03-31,1991,182,D,5,3+,32778,2391071,4299821,21823,1529536,2175356
1991-04-01,1991,183,D,5,3+,27514,2418585,4299821,15606,1545142,2175356
1991-04-02,1991,184,D,5,3+,24247,2442832,4299821,12476,1557618,2175356
1991-04-03,1991,185,D,5,3+,20699,2463531,4299821,8984,1566602,2175356
1991-04-04,1991,186,D,5,3+,18853,2482384,4299821,6922,1573524,2175356
1991-04-05,1991,187,D,5,3+,17373,2499757,4299821,5036,1578560,2175356
1991-04-06,1991,188,D,5,3+,16281,2516038,4299821,4155,1582715,2175356
1991-04-07,1991,189,D,5,3+,15715,2531753,4299821,4477,1587192,2175356
1991-04-08,1991,190,D,5,3+,15523,2547276,4299821,3390,1590582,2175356
1991-04-09,1991,191,D,5,3+,15304,2562580,4299821,3034,1593616,2175356
1991-04-10,1991,192,D,5,3+,15091,2577671,4299821,2660,1596276,2175356
1991-04-11,1991,193,D,5,3+,13461,2591132,4299821,2316,1598592,2175356
1991-04-12,1991,194,D,5,3+,12079,2603211,4299821,-104,1598488,2175356
1991-04-13,1991,195,D,5,3+,12136,2615347,4299821,-492,1597996,2175356
1991-04-14,1991,196,D,5,3+,11065,2626412,4299821,-1275,1596721,2175356
1991-04-15,1991,197,D,5,3+,10567,2636979,4299821,658,1597379,2175356
1991-04-16,1991,198,D,5,3+,10108,2647087,4299821,785,1598164,2175356
1991-04-17,1991,199,D,5,3+,9883,2656970,4299821,569,1598733,2175356
1991-04-18,1991,200,D,5,3+,9699,2666669,4299821,1198,1599931,2175356
1991-04-19,1991,201,D,5,3+,9320,2675989,4299821,1691,1601622,2175356
1991-04-20,1991,202,D,5,3+,8578,2684567,4299821,3609,1605231,2175356
1991-04-21,1991,203,D,5,3+,8724,2693291,4299821,5489,1610720,2175356
1991-04-22,1991,204,D,5,3+,9130,2702421,4299821,5735,1616455,2175356
1991-04-23,1991,205,D,5,3+,8794,2711215,4299821,6397,1622852,2175356
1991-04-24,1991,206,D,5,3+,9151,2720366,4299821,5985,1628837,2175356
1991-04-25,1991,207,D,5,3+,8910,2729276,4299821,4029,1632866,2175356
1991-04-26,1991,208,D,5,3+,8598,2737874,4299821,1829,1634695,2175356
1991-04-27,1991,209,D,5,3+,8207,2746081,4299821,1834,1636529,2175356
1991-04-28,1991,210,D,5,3+,8050,2754131,4299821,1556,1638085,2175356
1991-04-29,1991,211,D,5,3+,7915,2762046,4299821,977,1639062,2175356
1991-04-30,1991,212,D,5,3+,7093,2769139,4299821,1516,1640578,2175356
1991-05-01,1991,213,D,5,3+,7879,2777018,4299821,4324,1644902,2175356
1991-05-02,1991,214,D,5,3+,7625,2784643,4299821,2142,1647044,2175356
1991-05-03,1991,215,D,5,3+,8446,2793089,4299821,3524,1650568,2175356
1991-05-04,1991,216,D,5,3+,8664,2801753,4299821,4398,1654966,2175356
1991-05-05,1991,217,D,5,3+,8969,2810722,4299821,3520,1658486,2175356
1991-05-06,1991,218,D,5,3+,8389,2819111,4299821,2352,1660838,2175356
1991-05-07,1991,219,D,5,3+,8460,2827571,4299821,2250,1663088,2175356
1991-05-08,1991,220,D,5,3+,8061,2835632,4299821,1846,1664934,2175356
1991-05-09,1991,221,D,5,3+,8905,2844537,4299821,3450,1668384,2175356
1991-05-10,1991,222,D,5,3+,8181,2852718,4299821,1431,1669815,2175356
1991-05-11,1991,223,D,5,3+,7227,2859945,4299821,1088,1670903,2175356
1991-05-12,1991,224,D,5,3+,7628,2867573,4299821,1889,1672792,2175356
1991-05-13,1991,225,D,5,3+,6647,2874220,4299821,1562,1674354,2175356
1991-05-14,1991,226,D,5,3+,7505,2881725,4299821,4657,1679011,2175356
1991-05-15,1991,227,D,5,3+,8092,2889817,4299821,5354,1684365,2175356
1991-05-16,1991,228,D,5,3+,8312,2898129,4299821,5169,1689534,2175356
1991-05-17,1991,229,D,5,3+,9708,2907837,4299821,7418,1696952,2175356
1991-05-18,1991,230,D,5,3+,10750,2918587,4299821,7173,1704125,2175356
1991-05-19,1991,231,D,5,3+,10424,2929011,4299821,4418,1708543,2175356
1991-05-20,1991,232,D,5,3+,10417,2939428,4299821,3846,1712389,2175356
1991-05-21,1991,233,D,5,3+,10515,2949943,4299821,4291,1716680,2175356
1991-05-22,1991,234,D,5,3+,10083,2960026,4299821,3987,1720667,2175356
1991-05-23,1991,235,D,5,3+,9125,2969151,4299821,4055,1724722,2175356
1991-05-24,1991,236,D,5,3+,8959,2978110,4299821,4552,1729274,2175356
1991-05-25,1991,237,D,5,3+,8977,2987087,4299821,3505,1732779,2175356
1991-05-26,1991,238,D,5,3+,9428,2996515,4299821,3164,1735943,2175356
1991-05-27,1991,239,D,5,3+,9694,3006209,4299821,4184,1740127,2175356
1991-05-28,1991,240,D,5,3+,9745,3015954,4299821,5014,1745141,2175356
1991-05-29,1991,241,D,5,3+,9562,3025516,4299821,4723,1749864,2175356
1991-05-30,1991,242,D,5,3+,9556,3035072,4299821,4994,1754858,2175356
1991-05-31,1991,243,D,5,3+,9797,3044869,4299821,5443,1760301,2175356
1991-06-01,1991,244,D,5,3+,10694,3055563,4299821,5106,1765407,2175356
1991-06-02,1991,245,D,5,3+,10426,3065989,4299821,4986,1770393,2175356
1991-06-03,1991,246,D,5,3+,10665,3076654,4299821,5469,1775862,2175356
1991-06-04,1991,247,D,5,3+,10217,3086871,4299821,4520,1780382,2175356
1991-06-05,1991,248,D,5,3+,9308,3096179,4299821,3177,1783559,2175356
1991-06-06,1991,249,D,5,3+,9178,3105357,4299821,4120,1787679,2175356
1991-06-07,1991,250,D,5,3+,9270,3114627,4299821,3604,1791283,2175356
1991-06-08,1991,251,D,5,3+,8451,3123078,4299821,2336,1793619,2175356
1991-06-09,1991,252,D,5,3+,8377,3131455,4299821,3163,1796782,2175356
1991-06-10,1991,253,D,5,3+,8650,3140105,4299821,3778,1800560,2175356
1991-06-11,1991,254,D,5,3+,9085,3149190,4299821,4645,1805205,2175356
1991-06-12,1991,255,D,5,3+,9853,3159043,4299821,5486,1810691,2175356
1991-06-13,1991,256,D,5,3+,11261,3170304,4299821,6633,1817324,2175356
1991-06-14,1991,257,D,5,3+,11208,3181512,4299821,4708,1822032,2175356
1991-06-15,1991,258,D,5,3+,10790,3192302,4299821,4313,1826345,2175356
1991-06-16,1991,259,D,5,3+,10347,3202649,4299821,4020,1830365,2175356
1991-06-17,1991,260,D,5,3+,10423,3213072,4299821,4489,1834854,2175356
1991-06-18,1991,261,D,5,3+,9701,3222773,4299821,2975,1837829,2175356
1991-06-19,1991,262,D,5,3+,9624,3232397,4299821,3137,1840966,2175356
1991-06-20,1991,263,D,5,3+,9276,3241673,4299821,2317,1843283,2175356
1991-06-21,1991,264,D,5,3+,8537,3250210,4299821,1400,1844683,2175356
1991-06-22,1991,265,D,5,3+,8336,3258546,4299821,2216,1846899,2175356
1991-06-23,1991,266,D,5,3+,8401,3266947,4299821,2291,1849190,2175356
1991-06-24,1991,267,D,5,3+,9234,3276181,4299821,3119,1852309,2175356
1991-06-25,1991,268,D,5,3+,9951,3286132,4299821,4211,1856520,2175356
1991-06-26,1991,269,D,5,3+,9760,3295892,4299821,3353,1859873,2175356
1991-06-27,1991,270,D,5,3+,10243,3306135,4299821,4576,1864449,2175356
1991-06-28,1991,271,D,5,3+,10196,3316331,4299821,4185,1868634,2175356
1991-06-29,1991,272,D,5,3+,11187,3327518,4299821,6312,1874946,2175356
1991-06-30,1991,273,D,5,3+,11645,3339163,4299821,5422,1880368,2175356
1991-07-01,1991,274,D,5,3+,11800,3350963,4299821,4580,1884948,2175356
1991-07-02,1991,275,D,5,3+,11719,3362682,4299821,3829,1888777,2175356
1991-07-03,1991,276,D,5,3+,11254,3373936,4299821,3477,1892254,2175356
1991-07-04,1991,277,D,5,3+,10736,3384672,4299821,2186,1894440,2175356
1991-07-05,1991,278,D,5,3+,10158,3394830,4299821,2403,1896843,2175356
1991-07-06,1991,279,D,5,3+,9859,3404689,4299821,3103,1899946,2175356
1991-07-07,1991,280,D,5,3+,10007,3414696,4299821,4194,1904140,2175356
1991-07-08,1991,281,D,5,3+,10217,3424913,4299821,4401,1908541,2175356
1991-07-09,1991,282,D,5,3+,10948,3435861,4299821,5432,1913973,2175356
1991-07-10,1991,283,D,5,3+,11240,3447101,4299821,4595,1918568,2175356
1991-07-11,1991,284,D,5,3+,11699,3458800,4299821,4603,1923171,2175356
1991-07-12,1991,285,D,5,3+,11731,3470531,4299821,4235,1927406,2175356
1991-07-13,1991,286,D,5,3+,11303,3481834,4299821,3299,1930705,2175356
1991-07-14,1991,287,D,5,3+,10687,3492521,4299821,2855,1933560,2175356
1991-07-15,1991,288,D,5,3+,9924,3502445,4299821,2256,1935816,2175356
1991-07-16,1991,289,D,5,3+,9714,3512159,4299821,2707,1938523,2175356
1991-07-17,1991,290,D,5,3+,9415,3521574,4299821,2195,1940718,2175356
1991-07-18,1991,291,D,5,3+,9501,3531075,4299821,2354,1943072,2175356
1991-07-19,1991,292,D,5,3+,8906,3539981,4299821,1838,1944910,2175356
1991-07-20,1991,293,D,5,3+,9711,3549692,4299821,3215,1948125,2175356
1991-07-21,1991,294,D,5,3+,10061,3559753,4299821,3926,1952051,2175356
1991-07-22,1991,295,D,5,3+,10372,3570125,4299821,3365,1955416,2175356
1991-07-23,1991,296,D,5,3+,10541,3580666,4299821,4041,1959457,2175356
1991-07-24,1991,297,D,5,3+,10647,3591313,4299821,4236,1963693,2175356
1991-07-25,1991,298,D,5,3+,10836,3602149,4299821,4012,1967705,2175356
1991-07-26,1991,299,D,5,3+,10047,3612196,4299821,2416,1970121,2175356
1991-07-27,1991,300,D,5,3+,9356,3621552,4299821,2831,1972952,2175356
1991-07-28,1991,301,D,5,3+,9574,3631126,4299821,3413,1976365,2175356
1991-07-29,1991,302,D,5,3+,9798,3640924,4299821,2803,1979168,2175356
1991-07-30,1991,303,D,5,3+,9702,3650626,4299821,2347,1981515,2175356
1991-07-31,1991,304,D,5,3+,8842,3659468,4299821,1726,1983241,2175356
1991-08-01,1991,305,D,5,3+,9602,3669070,4299821,3476,1986717,2175356
1991-08-02,1991,306,D,5,3+,9732,3678802,4299821,2623,1989340,2175356
1991-08-03,1991,307,D,5,3+,9962,3688764,4299821,2489,1991829,2175356
1991-08-04,1991,308,D,5,3+,10064,3698828,4299821,2499,1994328,2175356
1991-08-05,1991,309,D,5,3+,10177,3709005,4299821,3297,1997625,2175356
1991-08-06,1991,310,D,5,3+,10482,3719487,4299821,4434,2002059,2175356
1991-08-07,1991,311,D,5,3+,11026,3730513,4299821,5476,2007535,2175356
1991-08-08,1991,312,D,5,3+,11064,3741577,4299821,4172,2011707,2175356
1991-08-09,1991,313,D,5,3+,10862,3752439,4299821,4129,2015836,2175356
1991-08-10,1991,314,D,5,3+,10833,3763272,4299821,4267,2020103,2175356
1991-08-11,1991,315,D,5,3+,10957,3774229,4299821,3394,2023497,2175356
1991-08-12,1991,316,D,5,3+,11289,3785518,4299821,3362,2026859,2175356
1991-08-13,1991,317,D,5,3+,11232,3796750,4299821,2659,2029518,2175356
1991-08-14,1991,318,D,5,3+,9586,3806336,4299821,825,2030343,2175356
1991-08-15,1991,319,D,5,3+,10313,3816649,4299821,3648,2033991,2175356
1991-08-16,1991,320,D,5,3+,9977,3826626,4299821,2200,2036191,2175356
1991-08-17,1991,321,D,5,3+,9901,3836527,4299821,2439,2038630,2175356
1991-08-18,1991,322,D,5,3+,10198,3846725,4299821,2545,2041175,2175356
1991-08-19,1991,323,D,5,3+,10378,3857103,4299821,2564,2043739,2175356
1991-08-20,1991,324,D,5,3+,10154,3867257,4299821,2570,2046309,2175356
1991-08-21,1991,325,D,5,3+,10184,3877441,4299821,2634,2048943,2175356
1991-08-22,1991,326,D,5,3+,10049,3887490,4299821,2093,2051036,2175356
1991-08-23,1991,327,D,5,3+,10293,3897783,4299821,2104,2053140,2175356
1991-08-24,1991,328,D,5,3+,9835,3907618,4299821,1171,2054311,2175356
1991-08-25,1991,329,D,5,3+,9935,3917553,4299821,1650,2055961,2175356
1991-08-26,1991,330,D,5,3+,9969,3927522,4299821,1474,2057435,2175356
1991-08-27,1991,331,D,5,3+,10016,3937538,4299821,1810,2059245,2175356
1991-08-28,1991,332,D,5,3+,10029,3947567,4299821,1258,2060503,2175356
1991-08-29,1991,333,D,5,3+,10250,3957817,4299821,1232,2061735,2175356
1991-08-30,1991,334,D,5,3+,9482,3967299,4299821,-165,2061570,2175356
1991-08-31,1991,335,D,5,3+,10000,3977299,4299821,958,2062528,2175356
1991-09-01,1991,336,D,5,3+,10076,3987375,4299821,1245,2063773,2175356
1991-09-02,1991,337,D,5,3+,9951,3997326,4299821,1593,2065366,2175356
1991-09-03,1991,338,D,5,3+,9896,4007222,4299821,1935,2067301,2175356
1991-09-04,1991,339,D,5,3+,10188,4017410,4299821,3695,2070996,2175356
1991-09-05,1991,340,D,5,3+,10243,4027653,4299821,4235,2075231,2175356
1991-09-06,1991,341,D,5,3+,9767,4037420,4299821,3627,2078858,2175356
1991-09-07,1991,342,D,5,3+,10378,4047798,4299821,4038,2082896,2175356
1991-09-08,1991,343,D,5,3+,10500,4058298,4299821,3555,2086451,2175356
1991-09-09,1991,344,D,5,3+,10603,4068901,4299821,2945,2089396,2175356
1991-09-10,1991,345,D,5,3+,11284,4080185,4299821,2974,2092370,2175356
1991-09-11,1991,346,D,5,3+,10904,4091089,4299821,1477,2093847,2175356
1991-09-12,1991,347,D,5,3+,10797,4101886,4299821,1425,2095272,2175356
1991-09-13,1991,348,D,5,3+,10938,4112824,4299821,2416,2097688,2175356
1991-09-14,1991,349,D,5,3+,11233,4124057,4299821,3706,2101394,2175356
1991-09-15,1991,350,D,5,3+,11333,4135390,4299821,3648,2105042,2175356
1991-09-16,1991,351,D,5,3+,11494,4146884,4299821,3503,2108545,2175356
1991-09-17,1991,352,D,5,3+,11157,4158041,4299821,3275,2111820,2175356
1991-09-18,1991,353,D,5,3+,11147,4169188,4299821,4002,2115822,2175356
1991-09-19,1991,354,D,5,3+,10598,4179786,4299821,4490,2120312,2175356
1991-09-20,1991,355,D,5,3+,10365,4190151,4299821,5239,2125551,2175356
1991-09-21,1991,356,D,5,3+,10121,4200272,4299821,5879,2131430,2175356
1991-09-22,1991,357,D,5,3+,10374,4210646,4299821,5941,2137371,2175356
1991-09-23,1991,358,D,5,3+,11069,4221715,4299821,5695,2143066,2175356
1991-09-24,1991,359,D,5,3+,11584,4233299,4299821,5330,2148396,2175356
1991-09-25,1991,360,D,5,3+,10887,4244186,4299821,3662,2152058,2175356
1991-09-26,1991,361,D,5,3+,10321,4254507,4299821,3102,2155160,2175356
1991-09-27,1991,362,D,5,3+,11035,4265542,4299821,5096,2160256,2175356
1991-09-28,1991,363,D,5,3+,11388,4276930,4299821,5816,2166072,2175356
1991-09-29,1991,364,D,5,3+,11449,4288379,4299821,4821,2170893,2175356
1991-09-30,1991,365,D,5,3+,11442,4299821,4299821,4463,2175356,2175356
1991-10-01,1992,1,D,6,3+,12377,12377,4590965,5890,5890,2591774
1991-10-02,1992,2,D,6,3+,12579,24956,4590965,5071,10961,2591774
1991-10-03,1992,3,D,6,3+,12235,37191,4590965,4046,15007,2591774
1991-10-04,1992,4,D,6,3+,11700,48891,4590965,3923,18930,2591774
1991-10-05,1992,5,D,6,3+,11466,60357,4590965,5095,24025,2591774
1991-10-06,1992,6,D,6,3+,12107,72464,4590965,5556,29581,2591774
1991-10-07,1992,7,D,6,3+,12162,84626,4590965,4427,34008,2591774
1991-10-08,1992,8,D,6,3+,12198,96824,4590965,3545,37553,2591774
1991-10-09,1992,9,D,6,3+,12222,109046,4590965,3109,40662,2591774
1991-10-10,1992,10,D,6,3+,11666,120712,4590965,2208,42870,2591774
1991-10-11,1992,11,D,6,3+,11156,131868,4590965,2539,45409,2591774
1991-10-12,1992,12,D,6,3+,10976,142844,4590965,2795,48204,2591774
1991-10-13,1992,13,D,6,3+,10921,153765,4590965,2730,50934,2591774
1991-10-14,1992,14,D,6,3+,10606,164371,4590965,1690,52624,2591774
1991-10-15,1992,15,D,6,3+,10398,174769,4590965,1457,54081,2591774
1991-10-16,1992,16,D,6,3+,9827,184596,4590965,1180,55261,2591774
1991-10-17,1992,17,D,6,3+,9250,193846,4590965,721,55982,2591774
1991-10-18,1992,18,D,6,3+,8933,202779,4590965,1067,57049,2591774
1991-10-19,1992,19,D,6,3+,8071,210850,4590965,259,57308,2591774
1991-10-20,1992,20,D,6,3+,7786,218636,4590965,1477,58785,2591774
1991-10-21,1992,21,D,6,3+,7225,225861,4590965,1922,60707,2591774
1991-10-22,1992,22,D,6,3+,7736,233597,4590965,4300,65007,2591774
1991-10-23,1992,23,D,6,3+,8858,242455,4590965,5024,70031,2591774
1991-10-24,1992,24,D,6,3+,8713,251168,4590965,2662,72693,2591774
1991-10-25,1992,25,D,6,3+,8747,259915,4590965,4108,76801,2591774
1991-10-26,1992,26,D,6,3+,9354,269269,4590965,6137,82938,2591774
1991-10-27,1992,27,D,6,3+,11286,280555,4590965,11047,93985,2591774
1991-10-28,1992,28,D,6,3+,10351,290906,4590965,7888,101873,2591774
1991-10-29,1992,29,D,6,3+,10460,301366,4590965,7861,109734,2591774
1991-10-30,1992,30,D,6,3+,10253,311619,4590965,6832,116566,2591774
1991-10-31,1992,31,D,6,3+,9553,321172,4590965,4616,121182,2591774
1991-11-01,1992,32,D,6,3+,8809,329981,4590965,1070,122252,2591774
1991-11-02,1992,33,D,6,3+,7965,337946,4590965,1427,123679,2591774
1991-11-03,1992,34,D,6,3+,8076,346022,4590965,1375,125054,2591774
1991-11-04,1992,35,D,6,3+,7973,353995,4590965,1845,126899,2591774
1991-11-05,1992,36,D,6,3+,7904,361899,4590965,2529,129428,2591774
1991-11-06,1992,37,D,6,3+,7866,369765,4590965,3435,132863,2591774
1991-11-07,1992,38,D,6,3+,7855,377620,4590965,4249,137112,2591774
1991-11-08,1992,39,D,6,3+,7534,385154,4590965,4511,141623,2591774
1991-11-09,1992,40,D,6,3+,8408,393562,4590965,5759,147382,2591774
1991-11-10,1992,41,D,6,3+,8962,402524,4590965,6426,153808,2591774
1991-11-11,1992,42,D,6,3+,9800,412324,4590965,6339,160147,2591774
1991-11-12,1992,43,D,6,3+,9953,422277,4590965,4562,164709,2591774
1991-11-13,1992,44,D,6,3+,8581,430858,4590965,2479,167188,2591774
1991-11-14,1992,45,D,6,3+,8977,439835,4590965,4841,172029,2591774
1991-11-15,1992,46,D,6,3+,8208,448043,4590965,2650,174679,2591774
1991-11-16,1992,47,D,6,3+,7848,455891,4590965,2161,176840,2591774
1991-11-17,1992,48,D,6,3+,7284,463175,4590965,1722,178562,2591774
1991-11-18,1992,49,D,6,3+,8476,471651,4590965,6858,185420,2591774
1991-11-19,1992,50,D,6,3+,8258,479909,4590965,4766,190186,2591774
1991-11-20,1992,51,D,6,3+,8039,487948,4590965,4708,194894,2591774
1991-11-21,1992,52,D,6,3+,8094,496042,4590965,5340,200234,2591774
1991-11-22,1992,53,D,6,3+,8005,504047,4590965,5186,205420,2591774
1991-11-23,1992,54,D,6,3+,8214,512261,4590965,3303,208723,2591774
1991-11-24,1992,55,D,6,3+,8056,520317,4590965,3081,211804,2591774
1991-11-25,1992,56,D,6,3+,8253,528570,4590965,4229,216033,2591774
1991-11-26,1992,57,D,6,3+,8621,537191,4590965,4695,220728,2591774
1991-11-27,1992,58,D,6,3+,8989,546180,4590965,4833,225561,2591774
1991-11-28,1992,59,D,6,3+,8938,555118,4590965,4463,230024,2591774
1991-11-29,1992,60,D,6,3+,8881,563999,4590965,4807,234831,2591774
1991-11-30,1992,61,D,6,3+,8791,572790,4590965,3631,238462,2591774
1991-12-01,1992,62,D,6,3+,8561,581351,4590965,2856,241318,2591774
1991-12-02,1992,63,D,6,3+,8610,589961,4590965,2522,243840,2591774
1991-12-03,1992,64,D,6,3+,8538,598499,4590965,1951,245791,2591774
1991-12-04,1992,65,D,6,3+,8241,606740,4590965,2026,247817,2591774
1991-12-05,1992,66,D,6,3+,8388,615128,4590965,2446,250263,2591774
1991-12-06,1992,67,D,6,3+,8141,623269,4590965,3806,254069,2591774
1991-12-07,1992,68,D,6,3+,8977,632246,4590965,7143,261212,2591774
1991-12-08,1992,69,D,6,3+,8927,641173,4590965,7091,268303,2591774
1991-12-09,1992,70,D,6,3+,8941,650114,4590965,7586,275889,2591774
1991-12-10,1992,71,D,6,3+,8505,658619,4590965,7444,283333,2591774
1991-12-11,1992,72,D,6,3+,9002,667621,4590965,7948,291281,2591774
1991-12-12,1992,73,D,6,3+,9205,676826,4590965,5574,296855,2591774
1991-12-13,1992,74,D,6,3+,9778,686604,4590965,8208,305063,2591774
1991-12-14,1992,75,D,6,3+,10246,696850,4590965,8330,313393,2591774
1991-12-15,1992,76,D,6,3+,10447,707297,4590965,8147,321540,2591774
1991-12-16,1992,77,D,6,3+,10227,717524,4590965,7456,328996,2591774
1991-12-17,1992,78,D,6,3+,9955,727479,4590965,8208,337204,2591774
1991-12-18,1992,79,D,6,3+,10279,737758,4590965,9200,346404,2591774
1991-12-19,1992,80,D,6,3+,12138,749896,4590965,10962,357366,2591774
1991-12-20,1992,81,D,6,3+,11892,761788,4590965,8348,365714,2591774
1991-12-21,1992,82,D,6,3+,12198,773986,4590965,8363,374077,2591774
1991-12-22,1992,83,D,6,3+,12287,786273,4590965,8227,382304,2591774
1991-12-23,1992,84,D,6,3+,12179,798452,4590965,6223,388527,2591774
1991-12-24,1992,85,D,6,3+,12083,810535,4590965,5699,394226,2591774
1991-12-25,1992,86,D,6,3+,11788,822323,4590965,4810,399036,2591774
1991-12-26,1992,87,D,6,3+,11488,833811,4590965,4944,403980,2591774
1991-12-27,1992,88,D,6,3+,11293,845104,4590965,4681,408661,2591774
1991-12-28,1992,89,D,6,3+,11424,856528,4590965,11210,419871,2591774
1991-12-29,1992,90,D,6,3+,12046,868574,4590965,18853,438724,2591774
1991-12-30,1992,91,D,6,3+,12275,880849,4590965,17680,456404,2591774
1991-12-31,1992,92,D,6,3+,13869,894718,4590965,18356,474760,2591774
1992-01-01,1992,93,D,6,3+,15543,910261,4590965,18725,493485,2591774
1992-01-02,1992,94,D,6,3+,13723,923984,4590965,9282,502767,2591774
1992-01-03,1992,95,D,6,3+,11214,935198,4590965,1553,504320,2591774
1992-01-04,1992,96,D,6,3+,10211,945409,4590965,2173,506493,2591774
1992-01-05,1992,97,D,6,3+,11183,956592,4590965,10431,516924,2591774
1992-01-06,1992,98,D,6,3+,11930,968522,4590965,11907,528831,2591774
1992-01-07,1992,99,D,6,3+,15102,983624,4590965,15546,544377,2591774
1992-01-08,1992,100,D,6,3+,17406,1001030,4590965,13541,557918,2591774
1992-01-09,1992,101,D,6,3+,18694,1019724,4590965,14902,572820,2591774
1992-01-10,1992,102,D,6,3+,18686,1038410,4590965,9882,582702,2591774
1992-01-11,1992,103,D,6,3+,16069,1054479,4590965,5980,588682,2591774
1992-01-12,1992,104,D,6,3+,13753,1068232,4590965,3420,592102,2591774
1992-01-13,1992,105,D,6,3+,12340,1080572,4590965,785,592887,2591774
1992-01-14,1992,106,D,6,3+,11296,1091868,4590965,2094,594981,2591774
1992-01-15,1992,107,D,6,3+,10849,1102717,4590965,2668,597649,2591774
1992-01-16,1992,108,D,6,3+,10245,1112962,4590965,2466,600115,2591774
1992-01-17,1992,109,D,6,3+,10052,1123014,4590965,3084,603199,2591774
1992-01-18,1992,110,D,6,3+,10145,1133159,4590965,4329,607528,2591774
1992-01-19,1992,111,D,6,3+,10268,1143427,4590965,4486,612014,2591774
1992-01-20,1992,112,D,6,3+,9998,1153425,4590965,3468,615482,2591774
1992-01-21,1992,113,D,6,3+,9746,1163171,4590965,3044,618526,2591774
1992-01-22,1992,114,D,6,3+,9906,1173077,4590965,3450,621976,2591774
1992-01-23,1992,115,D,6,3+,9689,1182766,4590965,2309,624285,2591774
1992-01-24,1992,116,D,6,3+,9512,1192278,4590965,2406,626691,2591774
1992-01-25,1992,117,D,6,3+,9209,1201487,4590965,2945,629636,2591774
1992-01-26,1992,118,D,6,3+,9381,1210868,4590965,4270,633906,2591774
1992-01-27,1992,119,D,6,3+,9407,1220275,4590965,7587,641493,2591774
1992-01-28,1992,120,D,6,3+,9025,1229300,4590965,7038,648531,2591774
1992-01-29,1992,121,D,6,3+,8903,1238203,4590965,7946,656477,2591774
1992-01-30,1992,122,D,6,3+,8828,1247031,4590965,8565,665042,2591774
1992-01-31,1992,123,D,6,3+,8529,1255560,4590965,8533,673575,2591774
1992-02-01,1992,124,D,6,3+,8977,1264537,4590965,7915,681490,2591774
1992-02-02,1992,125,D,6,3+,9285,1273822,4590965,8215,689705,2591774
1992-02-03,1992,126,D,6,3+,9281,1283103,4590965,7965,697670,2591774
1992-02-04,1992,127,D,6,3+,9913,1293016,4590965,8446,706116,2591774
1992-02-05,1992,128,D,6,3+,9584,1302600,4590965,8018,714134,2591774
1992-02-06,1992,129,D,6,3+,9034,1311634,4590965,7796,721930,2591774
1992-02-07,1992,130,D,6,3+,9014,1320648,4590965,9723,731653,2591774
1992-02-08,1992,131,D,6,3+,9140,1329788,4590965,9853,741506,2591774
1992-02-09,1992,132,D,6,3+,8632,1338420,4590965,9348,750854,2591774
1992-02-10,1992,133,D,6,3+,9219,1347639,4590965,12329,763183,2591774
1992-02-11,1992,134,D,6,3+,11541,1359180,4590965,19403,782586,2591774
1992-02-12,1992,135,D,6,3+,18755,1377935,4590965,28060,810646,2591774
1992-02-13,1992,136,D,6,3+,35525,1413460,4590965,45576,856222,2591774
1992-02-14,1992,137,D,6,3+,45588,1459048,4590965,50142,906364,2591774
1992-02-15,1992,138,D,6,3+,54225,1513273,4590965,61151,967515,2591774
1992-02-16,1992,139,D,6,3+,57341,1570614,4590965,61442,1028957,2591774
1992-02-17,1992,140,D,6,3+,57349,1627963,4590965,58599,1087556,2591774
1992-02-18,1992,141,D,6,3+,53103,1681066,4590965,53686,1141242,2591774
1992-02-19,1992,142,D,6,3+,47698,1728764,4590965,48637,1189879,2591774
1992-02-20,1992,143,D,6,3+,47615,1776379,4590965,42567,1232446,2591774
1992-02-21,1992,144,D,6,3+,49668,1826047,4590965,43084,1275530,2591774
1992-02-22,1992,145,D,6,3+,51221,1877268,4590965,43248,1318778,2591774
1992-02-23,1992,146,D,6,3+,50461,1927729,4590965,42825,1361603,2591774
1992-02-24,1992,147,D,6,3+,47280,1975009,4590965,39091,1400694,2591774
1992-02-25,1992,148,D,6,3+,41994,2017003,4590965,30957,1431651,2591774
1992-02-26,1992,149,D,6,3+,36656,2053659,4590965,25220,1456871,2591774
1992-02-27,1992,150,D,6,3+,31578,2085237,4590965,19963,1476834,2591774
1992-02-28,1992,151,D,6,3+,28654,2113891,4590965,16961,1493795,2591774
1992-02-29,1992,152,D,6,3+,25565,2139456,4590965,13786,1507581,2591774
1992-03-01,1992,153,D,6,3+,22686,2162142,4590965,11614,1519195,2591774
1992-03-02,1992,154,D,6,3+,20106,2182248,4590965,9758,1528953,2591774
1992-03-03,1992,155,D,6,3+,18246,2200494,4590965,7968,1536921,2591774
1992-03-04,1992,156,D,6,3+,17217,2217711,4590965,7068,1543989,2591774
1992-03-05,1992,157,D,6,3+,16659,2234370,4590965,7318,1551307,2591774
1992-03-06,1992,158,D,6,3+,20607,2254977,4590965,16621,1567928,2591774
1992-03-07,1992,159,D,6,3+,25477,2280454,4590965,20959,1588887,2591774
1992-03-08,1992,160,D,6,3+,30322,2310776,4590965,25762,1614649,2591774
1992-03-09,1992,161,D,6,3+,30025,2340801,4590965,26028,1640677,2591774
1992-03-10,1992,162,D,6,3+,26218,2367019,4590965,21632,1662309,2591774
1992-03-11,1992,163,D,6,3+,22799,2389818,4590965,11498,1673807,2591774
1992-03-12,1992,164,D,6,3+,20455,2410273,4590965,9128,1682935,2591774
1992-03-13,1992,165,D,6,3+,18356,2428629,4590965,6110,1689045,2591774
1992-03-14,1992,166,D,6,3+,17699,2446328,4590965,5652,1694697,2591774
1992-03-15,1992,167,D,6,3+,17337,2463665,4590965,6464,1701161,2591774
1992-03-16,1992,168,D,6,3+,18235,2481900,4590965,9120,1710281,2591774
1992-03-17,1992,169,D,6,3+,26835,2508735,4590965,19403,1729684,2591774
1992-03-18,1992,170,D,6,3+,34621,2543356,4590965,27042,1756726,2591774
1992-03-19,1992,171,D,6,3+,36683,2580039,4590965,28844,1785570,2591774
1992-03-20,1992,172,D,6,3+,36207,2616246,4590965,27180,1812750,2591774
1992-03-21,1992,173,D,6,3+,32247,2648493,4590965,21740,1834490,2591774
1992-03-22,1992,174,D,6,3+,27419,2675912,4590965,15758,1850248,2591774
1992-03-23,1992,175,D,6,3+,24735,2700647,4590965,13859,1864107,2591774
1992-03-24,1992,176,D,6,3+,22239,2722886,4590965,11434,1875541,2591774
1992-03-25,1992,177,D,6,3+,20934,2743820,4590965,9737,1885278,2591774
1992-03-26,1992,178,D,6,3+,20257,2764077,4590965,9114,1894392,2591774
1992-03-27,1992,179,D,6,3+,19035,2783112,4590965,7570,1901962,2591774
1992-03-28,1992,180,D,6,3+,18048,2801160,4590965,6037,1907999,2591774
1992-03-29,1992,181,D,6,3+,16995,2818155,4590965,4832,1912831,2591774
1992-03-30,1992,182,D,6,3+,15955,2834110,4590965,3670,1916501,2591774
1992-03-31,1992,183,D,6,3+,14953,2849063,4590965,2843,1919344,2591774
1992-04-01,1992,184,D,6,3+,14094,2863157,4590965,1773,1921117,2591774
1992-04-02,1992,185,D,6,3+,13730,2876887,4590965,1076,1922193,2591774
1992-04-03,1992,186,D,6,3+,13308,2890195,4590965,3984,1926177,2591774
1992-04-04,1992,187,D,6,3+,13198,2903393,4590965,4985,1931162,2591774
1992-04-05,1992,188,D,6,3+,13011,2916404,4590965,5387,1936549,2591774
1992-04-06,1992,189,D,6,3+,12674,2929078,4590965,4694,1941243,2591774
1992-04-07,1992,190,D,6,3+,12070,2941148,4590965,4418,1945661,2591774
1992-04-08,1992,191,D,6,3+,11768,2952916,4590965,4352,1950013,2591774
1992-04-09,1992,192,D,6,3+,11623,2964539,4590965,4827,1954840,2591774
1992-04-10,1992,193,D,6,3+,11463,2976002,4590965,6238,1961078,2591774
1992-04-11,1992,194,D,6,3+,11006,2987008,4590965,7729,1968807,2591774
1992-04-12,1992,195,D,6,3+,11608,2998616,4590965,8301,1977108,2591774
1992-04-13,1992,196,D,6,3+,12496,3011112,4590965,9167,1986275,2591774
1992-04-14,1992,197,D,6,3+,12323,3023435,4590965,8992,1995267,2591774
1992-04-15,1992,198,D,6,3+,13596,3037031,4590965,10733,2006000,2591774
1992-04-16,1992,199,D,6,3+,13870,3050901,4590965,10666,2016666,2591774
1992-04-17,1992,200,D,6,3+,12808,3063709,4590965,9517,2026183,2591774
1992-04-18,1992,201,D,6,3+,12328,3076037,4590965,9066,2035249,2591774
1992-04-19,1992,202,D,6,3+,11524,3087561,4590965,8277,2043526,2591774
1992-04-20,1992,203,D,6,3+,12332,3099893,4590965,9090,2052616,2591774
1992-04-21,1992,204,D,6,3+,12025,3111918,4590965,8772,2061388,2591774
1992-04-22,1992,205,D,6,3+,11516,3123434,4590965,8319,2069707,2591774
1992-04-23,1992,206,D,6,3+,10562,3133996,4590965,7311,2077018,2591774
1992-04-24,1992,207,D,6,3+,9646,3143642,4590965,6321,2083339,2591774
1992-04-25,1992,208,D,6,3+,8973,3152615,4590965,5657,2088996,2591774
1992-04-26,1992,209,D,6,3+,8198,3160813,4590965,4905,2093901,2591774
1992-04-27,1992,210,D,6,3+,7682,3168495,4590965,4309,2098210,2591774
1992-04-28,1992,211,D,6,3+,7141,3175636,4590965,3586,2101796,2591774
1992-04-29,1992,212,D,6,3+,6272,3181908,4590965,2701,2104497,2591774
1992-04-30,1992,213,D,6,3+,6248,3188156,4590965,2600,2107097,2591774
1992-05-01,1992,214,D,6,3+,6659,3194815,4590965,2864,2109961,2591774
1992-05-02,1992,215,D,6,3+,6591,3201406,4590965,1584,2111545,2591774
1992-05-03,1992,216,D,6,3+,6653,3208059,4590965,1605,2113150,2591774
1992-05-04,1992,217,D,6,3+,6820,3214879,4590965,1569,2114719,2591774
1992-05-05,1992,218,D,6,3+,6874,3221753,4590965,1878,2116597,2591774
1992-05-06,1992,219,D,6,3+,6766,3228519,4590965,3434,2120031,2591774
1992-05-07,1992,220,D,6,3+,7047,3235566,4590965,3391,2123422,2591774
1992-05-08,1992,221,D,6,3+,6879,3242445,4590965,2583,2126005,2591774
1992-05-09,1992,222,D,6,3+,7399,3249844,4590965,3116,2129121,2591774
1992-05-10,1992,223,D,6,3+,7467,3257311,4590965,2794,2131915,2591774
1992-05-11,1992,224,D,6,3+,7854,3265165,4590965,3239,2135154,2591774
1992-05-12,1992,225,D,6,3+,7479,3272644,4590965,3062,2138216,2591774
1992-05-13,1992,226,D,6,3+,7137,3279781,4590965,3111,2141327,2591774
1992-05-14,1992,227,D,6,3+,6861,3286642,4590965,3036,2144363,2591774
1992-05-15,1992,228,D,6,3+,7143,3293785,4590965,3738,2148101,2591774
1992-05-16,1992,229,D,6,3+,7433,3301218,4590965,3981,2152082,2591774
1992-05-17,1992,230,D,6,3+,7628,3308846,4590965,4111,2156193,2591774
1992-05-18,1992,231,D,6,3+,7859,3316705,4590965,3425,2159618,2591774
1992-05-19,1992,232,D,6,3+,7608,3324313,4590965,3495,2163113,2591774
1992-05-20,1992,233,D,6,3+,7812,3332125,4590965,4001,2167114,2591774
1992-05-21,1992,234,D,6,3+,7805,3339930,4590965,3604,2170718,2591774
1992-05-22,1992,235,D,6,3+,8294,3348224,4590965,3698,2174416,2591774
1992-05-23,1992,236,D,6,3+,7927,3356151,4590965,2621,2177037,2591774
1992-05-24,1992,237,D,6,3+,7433,3363584,4590965,2434,2179471,2591774
1992-05-25,1992,238,D,6,3+,8144,3371728,4590965,4266,2183737,2591774
1992-05-26,1992,239,D,6,3+,8178,3379906,4590965,3707,2187444,2591774
1992-05-27,1992,240,D,6,3+,8475,3388381,4590965,4001,2191445,2591774
1992-05-28,1992,241,D,6,3+,8009,3396390,4590965,4025,2195470,2591774
1992-05-29,1992,242,D,6,3+,8921,3405311,4590965,4694,2200164,2591774
1992-05-30,1992,243,D,6,3+,9171,3414482,4590965,3595,2203759,2591774
1992-05-31,1992,244,D,6,3+,9566,3424048,4590965,4230,2207989,2591774
1992-06-01,1992,245,D,6,3+,9830,3433878,4590965,5188,2213177,2591774
1992-06-02,1992,246,D,6,3+,9955,3443833,4590965,5392,2218569,2591774
1992-06-03,1992,247,D,6,3+,9895,3453728,4590965,5666,2224235,2591774
1992-06-04,1992,248,D,6,3+,9958,3463686,4590965,4873,2229108,2591774
1992-06-05,1992,249,D,6,3+,9506,3473192,4590965,4691,2233799,2591774
1992-06-06,1992,250,D,6,3+,10803,3483995,4590965,6454,2240253,2591774
1992-06-07,1992,251,D,6,3+,11385,3495380,4590965,4806,2245059,2591774
1992-06-08,1992,252,D,6,3+,11644,3507024,4590965,4335,2249394,2591774
1992-06-09,1992,253,D,6,3+,11014,3518038,4590965,3081,2252475,2591774
1992-06-10,1992,254,D,6,3+,9716,3527754,4590965,2035,2254510,2591774
1992-06-11,1992,255,D,6,3+,8358,3536112,4590965,2245,2256755,2591774
1992-06-12,1992,256,D,6,3+,8616,3544728,4590965,3253,2260008,2591774
1992-06-13,1992,257,D,6,3+,8061,3552789,4590965,3001,2263009,2591774
1992-06-14,1992,258,D,6,3+,8500,3561289,4590965,2793,2265802,2591774
1992-06-15,1992,259,D,6,3+,9089,3570378,4590965,2954,2268756,2591774
1992-06-16,1992,260,D,6,3+,8961,3579339,4590965,2430,2271186,2591774
1992-06-17,1992,261,D,6,3+,9060,3588399,4590965,2659,2273845,2591774
1992-06-18,1992,262,D,6,3+,9170,3597569,4590965,3126,2276971,2591774
1992-06-19,1992,263,D,6,3+,9228,3606797,4590965,2602,2279573,2591774
1992-06-20,1992,264,D,6,3+,8887,3615684,4590965,2434,2282007,2591774
1992-06-21,1992,265,D,6,3+,8145,3623829,4590965,1781,2283788,2591774
1992-06-22,1992,266,D,6,3+,8549,3632378,4590965,2899,2286687,2591774
1992-06-23,1992,267,D,6,3+,8227,3640605,4590965,2584,2289271,2591774
1992-06-24,1992,268,D,6,3+,7956,3648561,4590965,2409,2291680,2591774
1992-06-25,1992,269,D,6,3+,7948,3656509,4590965,2337,2294017,2591774
1992-06-26,1992,270,D,6,3+,8747,3665256,4590965,3140,2297157,2591774
1992-06-27,1992,271,D,6,3+,8768,3674024,4590965,3121,2300278,2591774
1992-06-28,1992,272,D,6,3+,8890,3682914,4590965,3236,2303514,2591774
1992-06-29,1992,273,D,6,3+,9240,3692154,4590965,3546,2307060,2591774
1992-06-30,1992,274,D,6,3+,9697,3701851,4590965,3709,2310769,2591774
1992-07-01,1992,275,D,6,3+,10073,3711924,4590965,4062,2314831,2591774
1992-07-02,1992,276,D,6,3+,10281,3722205,4590965,3583,2318414,2591774
1992-07-03,1992,277,D,6,3+,9854,3732059,4590965,2562,2320976,2591774
1992-07-04,1992,278,D,6,3+,9564,3741623,4590965,3092,2324068,2591774
1992-07-05,1992,279,D,6,3+,9708,3751331,4590965,2937,2327005,2591774
1992-07-06,1992,280,D,6,3+,9709,3761040,4590965,2708,2329713,2591774
1992-07-07,1992,281,D,6,3+,9040,3770080,4590965,1864,2331577,2591774
1992-07-08,1992,282,D,6,3+,8314,3778394,4590965,1736,2333313,2591774
1992-07-09,1992,283,D,6,3+,7934,3786328,4590965,2351,2335664,2591774
1992-07-10,1992,284,D,6,3+,7816,3794144,4590965,2246,2337910,2591774
1992-07-11,1992,285,D,6,3+,8014,3802158,4590965,2436,2340346,2591774
1992-07-12,1992,286,D,6,3+,8926,3811084,4590965,3348,2343694,2591774
1992-07-13,1992,287,D,6,3+,9043,3820127,4590965,3059,2346753,2591774
1992-07-14,1992,288,D,6,3+,9184,3829311,4590965,2732,2349485,2591774
1992-07-15,1992,289,D,6,3+,8982,3838293,4590965,2531,2352016,2591774
1992-07-16,1992,290,D,6,3+,8815,3847108,4590965,2988,2355004,2591774
1992-07-17,1992,291,D,6,3+,8030,3855138,4590965,2139,2357143,2591774
1992-07-18,1992,292,D,6,3+,8330,3863468,4590965,2443,2359586,2591774
1992-07-19,1992,293,D,6,3+,7968,3871436,4590965,1991,2361577,2591774
1992-07-20,1992,294,D,6,3+,8428,3879864,4590965,2604,2364181,2591774
1992-07-21,1992,295,D,6,3+,8262,3888126,4590965,2218,2366399,2591774
1992-07-22,1992,296,D,6,3+,8486,3896612,4590965,2498,2368897,2591774
1992-07-23,1992,297,D,6,3+,8479,3905091,4590965,2930,2371827,2591774
1992-07-24,1992,298,D,6,3+,8808,3913899,4590965,3388,2375215,2591774
1992-07-25,1992,299,D,6,3+,9574,3923473,4590965,4258,2379473,2591774
1992-07-26,1992,300,D,6,3+,9850,3933323,4590965,4529,2384002,2591774
1992-07-27,1992,301,D,6,3+,9811,3943134,4590965,4489,2388491,2591774
1992-07-28,1992,302,D,6,3+,9486,3952620,4590965,4018,2392509,2591774
1992-07-29,1992,303,D,6,3+,9430,3962050,4590965,4153,2396662,2591774
1992-07-30,1992,304,D,6,3+,8868,3970918,4590965,2949,2399611,2591774
1992-07-31,1992,305,D,6,3+,9933,3980851,4590965,3623,2403234,2591774
1992-08-01,1992,306,D,6,3+,9844,3990695,4590965,2943,2406177,2591774
1992-08-02,1992,307,D,6,3+,9366,4000061,4590965,2892,2409069,2591774
1992-08-03,1992,308,D,6,3+,9320,4009381,4590965,2685,2411754,2591774
1992-08-04,1992,309,D,6,3+,9028,4018409,4590965,2417,2414171,2591774
1992-08-05,1992,310,D,6,3+,8647,4027056,4590965,2874,2417045,2591774
1992-08-06,1992,311,D,6,3+,8553,4035609,4590965,2725,2419770,2591774
1992-08-07,1992,312,D,6,3+,8103,4043712,4590965,2523,2422293,2591774
1992-08-08,1992,313,D,6,3+,8856,4052568,4590965,3324,2425617,2591774
1992-08-09,1992,314,D,6,3+,9218,4061786,4590965,3403,2429020,2591774
1992-08-10,1992,315,D,6,3+,9206,4070992,4590965,2796,2431816,2591774
1992-08-11,1992,316,D,6,3+,8705,4079697,4590965,2082,2433898,2591774
1992-08-12,1992,317,D,6,3+,8509,4088206,4590965,2568,2436466,2591774
1992-08-13,1992,318,D,6,3+,8859,4097065,4590965,3786,2440252,2591774
1992-08-14,1992,319,D,6,3+,9079,4106144,4590965,2824,2443076,2591774
1992-08-15,1992,320,D,6,3+,9327,4115471,4590965,2513,2445589,2591774
1992-08-16,1992,321,D,6,3+,9389,4124860,4590965,2512,2448101,2591774
1992-08-17,1992,322,D,6,3+,9692,4134552,4590965,2836,2450937,2591774
1992-08-18,1992,323,D,6,3+,9429,4143981,4590965,2078,2453015,2591774
1992-08-19,1992,324,D,6,3+,9088,4153069,4590965,1682,2454697,2591774
1992-08-20,1992,325,D,6,3+,8975,4162044,4590965,2297,2456994,2591774
1992-08-21,1992,326,D,6,3+,9168,4171212,4590965,2866,2459860,2591774
1992-08-22,1992,327,D,6,3+,10294,4181506,4590965,3991,2463851,2591774
1992-08-23,1992,328,D,6,3+,10295,4191801,4590965,2658,2466509,2591774
1992-08-24,1992,329,D,6,3+,10296,4202097,4590965,2924,2469433,2591774
1992-08-25,1992,330,D,6,3+,9950,4212047,4590965,3859,2473292,2591774
1992-08-26,1992,331,D,6,3+,9985,4222032,4590965,3586,2476878,2591774
1992-08-27,1992,332,D,6,3+,9703,4231735,4590965,2357,2479235,2591774
1992-08-28,1992,333,D,6,3+,9599,4241334,4590965,2307,2481542,2591774
1992-08-29,1992,334,D,6,3+,10028,4251362,4590965,3342,2484884,2591774
1992-08-30,1992,335,D,6,3+,10592,4261954,4590965,3011,2487895,2591774
1992-08-31,1992,336,D,6,3+,11016,4272970,4590965,2897,2490792,2591774
1992-09-01,1992,337,D,6,3+,11075,4284045,4590965,2513,2493305,2591774
1992-09-02,1992,338,D,6,3+,11453,4295498,4590965,3492,2496797,2591774
1992-09-03,1992,339,D,6,3+,11655,4307153,4590965,3051,2499848,2591774
1992-09-04,1992,340,D,6,3+,11760,4318913,4590965,5000,2504848,2591774
1992-09-05,1992,341,D,6,3+,11476,4330389,4590965,2822,2507670,2591774
1992-09-06,1992,342,D,6,3+,11224,4341613,4590965,2647,2510317,2591774
1992-09-07,1992,343,D,6,3+,10718,4352331,4590965,1880,2512197,2591774
1992-09-08,1992,344,D,6,3+,10603,4362934,4590965,2833,2515030,2591774
1992-09-09,1992,345,D,6,3+,10316,4373250,4590965,2736,2517766,2591774
1992-09-10,1992,346,D,6,3+,10485,4383735,4590965,3352,2521118,2591774
1992-09-11,1992,347,D,6,3+,11024,4394759,4590965,3870,2524988,2591774
1992-09-12,1992,348,D,6,3+,11102,4405861,4590965,3168,2528156,2591774
1992-09-13,1992,349,D,6,3+,10695,4416556,4590965,2036,2530192,2591774
1992-09-14,1992,350,D,6,3+,10135,4426691,4590965,2309,2532501,2591774
1992-09-15,1992,351,D,6,3+,10987,4437678,4590965,3458,2535959,2591774
1992-09-16,1992,352,D,6,3+,10626,4448304,4590965,3242,2539201,2591774
1992-09-17,1992,353,D,6,3+,10930,4459234,4590965,4083,2543284,2591774
1992-09-18,1992,354,D,6,3+,10666,4469900,4590965,3909,2547193,2591774
1992-09-19,1992,355,D,6,3+,10703,4480603,4590965,4779,2551972,2591774
1992-09-20,1992,356,D,6,3+,11094,4491697,4590965,5201,2557173,2591774
1992-09-21,1992,357,D,6,3+,11111,4502808,4590965,4137,2561310,2591774
1992-09-22,1992,358,D,6,3+,10528,4513336,4590965,4140,2565450,2591774
1992-09-23,1992,359,D,6,3+,10362,4523698,4590965,3597,2569047,2591774
1992-09-24,1992,360,D,6,3+,9897,4533595,4590965,3723,2572770,2591774
1992-09-25,1992,361,D,6,3+,9675,4543270,4590965,2449,2575219,2591774
1992-09-26,1992,362,D,6,3+,9594,4552864,4590965,2374,2577593,2591774
1992-09-27,1992,363,D,6,3+,9606,4562470,4590965,2534,2580127,2591774
1992-09-28,1992,364,D,6,3+,9771,4572241,4590965,4075,2584202,2591774
1992-09-29,1992,365,D,6,3+,9220,4581461,4590965,3325,2587527,2591774
1992-09-30,1992,366,D,6,3+,9504,4590965,4590965,4247,2591774,2591774
1992-10-01,1993,1,N,1,1,9702,9702,12234050,4431,4431,9602672
1992-10-02,1993,2,N,1,1,10136,19838,12234050,4195,8626,9602672
1992-10-03,1993,3,N,1,1,10069,29907,12234050,3758,12384,9602672
1992-10-04,1993,4,N,1,1,10043,39950,12234050,3430,15814,9602672
1992-10-05,1993,5,N,1,1,9704,49654,12234050,3183,18997,9602672
1992-10-06,1993,6,N,1,1,9094,58748,12234050,3577,22574,9602672
1992-10-07,1993,7,N,1,1,8449,67197,12234050,2145,24719,9602672
1992-10-08,1993,8,N,1,1,8069,75266,12234050,2651,27370,9602672
1992-10-09,1993,9,N,1,1,7757,83023,12234050,2503,29873,9602672
1992-10-10,1993,10,N,1,1,7643,90666,12234050,3010,32883,9602672
1992-10-11,1993,11,N,1,1,7338,98004,12234050,3023,35906,9602672
1992-10-12,1993,12,N,1,1,6727,104731,12234050,2800,38706,9602672
1992-10-13,1993,13,N,1,1,6245,110976,12234050,3674,42380,9602672
1992-10-14,1993,14,N,1,1,6004,116980,12234050,3983,46363,9602672
1992-10-15,1993,15,N,1,1,6356,123336,12234050,4176,50539,9602672
1992-10-16,1993,16,N,1,1,6003,129339,12234050,3387,53926,9602672
1992-10-17,1993,17,N,1,1,5977,135316,12234050,3214,57140,9602672
1992-10-18,1993,18,N,1,1,6348,141664,12234050,3917,61057,9602672
1992-10-19,1993,19,N,1,1,7140,148804,12234050,4741,65798,9602672
1992-10-20,1993,20,N,1,1,7228,156032,12234050,4185,69983,9602672
1992-10-21,1993,21,N,1,1,7139,163171,12234050,4455,74438,9602672
1992-10-22,1993,22,N,1,1,7118,170289,12234050,4248,78686,9602672
1992-10-23,1993,23,N,1,1,6788,177077,12234050,3647,82333,9602672
1992-10-24,1993,24,N,1,1,6396,183473,12234050,2901,85234,9602672
1992-10-25,1993,25,N,1,1,6399,189872,12234050,4020,89254,9602672
1992-10-26,1993,26,N,1,1,7405,197277,12234050,5239,94493,9602672
1992-10-27,1993,27,N,1,1,6847,204124,12234050,4506,98999,9602672
1992-10-28,1993,28,N,1,1,7406,211530,12234050,5224,104223,9602672
1992-10-29,1993,29,N,1,1,8036,219566,12234050,7157,111380,9602672
1992-10-30,1993,30,N,1,1,9961,229527,12234050,12412,123792,9602672
1992-10-31,1993,31,N,1,1,9557,239084,12234050,11073,134865,9602672
1992-11-01,1993,32,N,1,1,9910,248994,12234050,11503,146368,9602672
1992-11-02,1993,33,N,1,1,10366,259360,12234050,10623,156991,9602672
1992-11-03,1993,34,N,1,1,9484,268844,12234050,6250,163241,9602672
1992-11-04,1993,35,N,1,1,8972,277816,12234050,1933,165174,9602672
1992-11-05,1993,36,N,1,1,8427,286243,12234050,1734,166908,9602672
1992-11-06,1993,37,N,1,1,8156,294399,12234050,2173,169081,9602672
1992-11-07,1993,38,N,1,1,7583,301982,12234050,2283,171364,9602672
1992-11-08,1993,39,N,1,1,7335,309317,12234050,1978,173342,9602672
1992-11-09,1993,40,N,1,1,7149,316466,12234050,1942,175284,9602672
1992-11-10,1993,41,N,1,1,7101,323567,12234050,2252,177536,9602672
1992-11-11,1993,42,N,1,1,7013,330580,12234050,2407,179943,9602672
1992-11-12,1993,43,N,1,1,6896,337476,12234050,2289,182232,9602672
1992-11-13,1993,44,N,1,1,6976,344452,12234050,3944,186176,9602672
1992-11-14,1993,45,N,1,1,7039,351491,12234050,3856,190032,9602672
1992-11-15,1993,46,N,1,1,7085,358576,12234050,3978,194010,9602672
1992-11-16,1993,47,N,1,1,7327,365903,12234050,3714,197724,9602672
1992-11-17,1993,48,N,1,1,7718,373621,12234050,4123,201847,9602672
1992-11-18,1993,49,N,1,1,7418,381039,12234050,3716,205563,9602672
1992-11-19,1993,50,N,1,1,7314,388353,12234050,3572,209135,9602672
1992-11-20,1993,51,N,1,1,7212,395565,12234050,3623,212758,9602672
1992-11-21,1993,52,N,1,1,6717,402282,12234050,3036,215794,9602672
1992-11-22,1993,53,N,1,1,6693,408975,12234050,5300,221094,9602672
1992-11-23,1993,54,N,1,1,6834,415809,12234050,5580,226674,9602672
1992-11-24,1993,55,N,1,1,7065,422874,12234050,6305,232979,9602672
1992-11-25,1993,56,N,1,1,7033,429907,12234050,5440,238419,9602672
1992-11-26,1993,57,N,1,1,7206,437113,12234050,5636,244055,9602672
1992-11-27,1993,58,N,1,1,7090,444203,12234050,3377,247432,9602672
1992-11-28,1993,59,N,1,1,7451,451654,12234050,3990,251422,9602672
1992-11-29,1993,60,N,1,1,7578,459232,12234050,4024,255446,9602672
1992-11-30,1993,61,N,1,1,7641,466873,12234050,3194,258640,9602672
1992-12-01,1993,62,N,1,1,7364,474237,12234050,2278,260918,9602672
1992-12-02,1993,63,N,1,1,7425,481662,12234050,2819,263737,9602672
1992-12-03,1993,64,N,1,1,8339,490001,12234050,7809,271546,9602672
1992-12-04,1993,65,N,1,1,7549,497550,12234050,5544,277090,9602672
1992-12-05,1993,66,N,1,1,7791,505341,12234050,6637,283727,9602672
1992-12-06,1993,67,N,1,1,7453,512794,12234050,9938,293665,9602672
1992-12-07,1993,68,N,1,1,8906,521700,12234050,15275,308940,9602672
1992-12-08,1993,69,N,1,1,8850,530550,12234050,12641,321581,9602672
1992-12-09,1993,70,N,1,1,12755,543305,12234050,21025,342606,9602672
1992-12-10,1993,71,N,1,1,16253,559558,12234050,24612,367218,9602672
1992-12-11,1993,72,N,1,1,25268,584826,12234050,35981,403199,9602672
1992-12-12,1993,73,N,1,1,31309,616135,12234050,38584,441783,9602672
1992-12-13,1993,74,N,1,1,33051,649186,12234050,36609,478392,9602672
1992-12-14,1993,75,N,1,1,28348,677534,12234050,25033,503425,9602672
1992-12-15,1993,76,N,1,1,22714,700248,12234050,20649,524074,9602672
1992-12-16,1993,77,N,1,1,18866,719114,12234050,11276,535350,9602672
1992-12-17,1993,78,N,1,1,15921,735035,12234050,9687,545037,9602672
1992-12-18,1993,79,N,1,1,14810,749845,12234050,8989,554026,9602672
1992-12-19,1993,80,N,1,1,12995,762840,12234050,6800,560826,9602672
1992-12-20,1993,81,N,1,1,11220,774060,12234050,4495,565321,9602672
1992-12-21,1993,82,N,1,1,10261,784321,12234050,3019,568340,9602672
1992-12-22,1993,83,N,1,1,9662,793983,12234050,1565,569905,9602672
1992-12-23,1993,84,N,1,1,9729,803712,12234050,2223,572128,9602672
1992-12-24,1993,85,N,1,1,9522,813234,12234050,1472,573600,9602672
1992-12-25,1993,86,N,1,1,9494,822728,12234050,1803,575403,9602672
1992-12-26,1993,87,N,1,1,9153,831881,12234050,1167,576570,9602672
1992-12-27,1993,88,N,1,1,8858,840739,12234050,1220,577790,9602672
1992-12-28,1993,89,N,1,1,9165,849904,12234050,1021,578811,9602672
1992-12-29,1993,90,N,1,1,13027,862931,12234050,11809,590620,9602672
1992-12-30,1993,91,N,1,1,16557,879488,12234050,14531,605151,9602672
1992-12-31,1993,92,N,1,1,16311,895799,12234050,13174,618325,9602672
1993-01-01,1993,93,N,1,1,16853,912652,12234050,14261,632586,9602672
1993-01-02,1993,94,N,1,1,24340,936992,12234050,24313,656899,9602672
1993-01-03,1993,95,N,1,1,37865,974857,12234050,33072,689971,9602672
1993-01-04,1993,96,N,1,1,37676,1012533,12234050,30559,720530,9602672
1993-01-05,1993,97,N,1,1,31932,1044465,12234050,24568,745098,9602672
1993-01-06,1993,98,N,1,1,25166,1069631,12234050,15909,761007,9602672
1993-01-07,1993,99,N,1,1,31204,1100835,12234050,23198,784205,9602672
1993-01-08,1993,100,N,1,1,37944,1138779,12234050,33470,817675,9602672
1993-01-09,1993,101,N,1,1,45903,1184682,12234050,41463,859138,9602672
1993-01-10,1993,102,N,1,1,47390,1232072,12234050,43755,902893,9602672
1993-01-11,1993,103,N,1,1,45131,1277203,12234050,40640,943533,9602672
1993-01-12,1993,104,N,1,1,43244,1320447,12234050,33727,977260,9602672
1993-01-13,1993,105,N,1,1,48103,1368550,12234050,44929,1022189,9602672
1993-01-14,1993,106,N,1,1,56686,1425236,12234050,54444,1076633,9602672
1993-01-15,1993,107,N,1,1,61613,1486849,12234050,59834,1136467,9602672
1993-01-16,1993,108,N,1,1,66260,1553109,12234050,64201,1200668,9602672
1993-01-17,1993,109,N,1,1,72946,1626055,12234050,70382,1271050,9602672
1993-01-18,1993,110,N,1,1,80994,1707049,12234050,77235,1348285,9602672
1993-01-19,1993,111,N,1,1,79344,1786393,12234050,74232,1422517,9602672
1993-01-20,1993,112,N,1,1,77675,1864068,12234050,72230,1494747,9602672
1993-01-21,1993,113,N,1,1,92151,1956219,12234050,90446,1585193,9602672
1993-01-22,1993,114,N,1,1,109812,2066031,12234050,108616,1693809,9602672
1993-01-23,1993,115,N,1,1,138271,2204302,12234050,131316,1825125,9602672
1993-01-24,1993,116,N,1,1,135884,2340186,12234050,129015,1954140,9602672
1993-01-25,1993,117,N,1,1,119596,2459782,12234050,111333,2065473,9602672
1993-01-26,1993,118,N,1,1,98576,2558358,12234050,86289,2151762,9602672
1993-01-27,1993,119,N,1,1,85028,2643386,12234050,71885,2223647,9602672
1993-01-28,1993,120,N,1,1,75066,2718452,12234050,62078,2285725,9602672
1993-01-29,1993,121,N,1,1,62787,2781239,12234050,49932,2335657,9602672
1993-01-30,1993,122,N,1,1,52067,2833306,12234050,39322,2374979,9602672
1993-01-31,1993,123,N,1,1,49125,2882431,12234050,37808,2412787,9602672
1993-02-01,1993,124,N,1,1,45143,2927574,12234050,34991,2447778,9602672
1993-02-02,1993,125,N,1,1,42680,2970254,12234050,33892,2481670,9602672
1993-02-03,1993,126,N,1,1,37688,3007942,12234050,28648,2510318,9602672
1993-02-04,1993,127,N,1,1,33614,3041556,12234050,25215,2535533,9602672
1993-02-05,1993,128,N,1,1,31200,3072756,12234050,23767,2559300,9602672
1993-02-06,1993,129,N,1,1,29806,3102562,12234050,22782,2582082,9602672
1993-02-07,1993,130,N,1,1,27899,3130461,12234050,20373,2602455,9602672
1993-02-08,1993,131,N,1,1,30145,3160606,12234050,23264,2625719,9602672
1993-02-09,1993,132,N,1,1,40790,3201396,12234050,36684,2662403,9602672
1993-02-10,1993,133,N,1,1,53307,3254703,12234050,49226,2711629,9602672
1993-02-11,1993,134,N,1,1,58926,3313629,12234050,55836,2767465,9602672
1993-02-12,1993,135,N,1,1,61230,3374859,12234050,58094,2825559,9602672
1993-02-13,1993,136,N,1,1,62102,3436961,12234050,55072,2880631,9602672
1993-02-14,1993,137,N,1,1,61993,3498954,12234050,50580,2931211,9602672
1993-02-15,1993,138,N,1,1,57589,3556543,12234050,46284,2977495,9602672
1993-02-16,1993,139,N,1,1,52470,3609013,12234050,39665,3017160,9602672
1993-02-17,1993,140,N,1,1,51366,3660379,12234050,39022,3056182,9602672
1993-02-18,1993,141,N,1,1,51823,3712202,12234050,40659,3096841,9602672
1993-02-19,1993,142,N,1,1,62883,3775085,12234050,53988,3150829,9602672
1993-02-20,1993,143,N,1,1,78194,3853279,12234050,71623,3222452,9602672
1993-02-21,1993,144,N,1,1,85852,3939131,12234050,80144,3302596,9602672
1993-02-22,1993,145,N,1,1,96156,4035287,12234050,92225,3394821,9602672
1993-02-23,1993,146,N,1,1,103271,4138558,12234050,99796,3494617,9602672
1993-02-24,1993,147,N,1,1,108947,4247505,12234050,108035,3602652,9602672
1993-02-25,1993,148,N,1,1,100871,4348376,12234050,99460,3702112,9602672
1993-02-26,1993,149,N,1,1,90472,4438848,12234050,92961,3795073,9602672
1993-02-27,1993,150,N,1,1,80972,4519820,12234050,83572,3878645,9602672
1993-02-28,1993,151,N,1,1,73689,4593509,12234050,74748,3953393,9602672
1993-03-01,1993,152,N,1,1,65894,4659403,12234050,64764,4018157,9602672
1993-03-02,1993,153,N,1,1,57260,4716663,12234050,56107,4074264,9602672
1993-03-03,1993,154,N,1,1,50870,4767533,12234050,45691,4119955,9602672
1993-03-04,1993,155,N,1,1,46509,4814042,12234050,41224,4161179,9602672
1993-03-05,1993,156,N,1,1,43488,4857530,12234050,38172,4199351,9602672
1993-03-06,1993,157,N,1,1,40692,4898222,12234050,35386,4234737,9602672
1993-03-07,1993,158,N,1,1,38456,4936678,12234050,33137,4267874,9602672
1993-03-08,1993,159,N,1,1,37880,4974558,12234050,32555,4300429,9602672
1993-03-09,1993,160,N,1,1,36167,5010725,12234050,30482,4330911,9602672
1993-03-10,1993,161,N,1,1,33338,5044063,12234050,26093,4357004,9602672
1993-03-11,1993,162,N,1,1,30868,5074931,12234050,23416,4380420,9602672
1993-03-12,1993,163,N,1,1,31609,5106540,12234050,24019,4404439,9602672
1993-03-13,1993,164,N,1,1,30179,5136719,12234050,22388,4426827,9602672
1993-03-14,1993,165,N,1,1,30048,5166767,12234050,22888,4449715,9602672
1993-03-15,1993,166,N,1,1,30185,5196952,12234050,22998,4472713,9602672
1993-03-16,1993,167,N,1,1,30612,5227564,12234050,23496,4496209,9602672
1993-03-17,1993,168,N,1,1,31827,5259391,12234050,28951,4525160,9602672
1993-03-18,1993,169,N,1,1,40636,5300027,12234050,38534,4563694,9602672
1993-03-19,1993,170,N,1,1,57819,5357846,12234050,54838,4618532,9602672
1993-03-20,1993,171,N,1,1,67303,5425149,12234050,64150,4682682,9602672
1993-03-21,1993,172,N,1,1,73709,5498858,12234050,70521,4753203,9602672
1993-03-22,1993,173,N,1,1,79594,5578452,12234050,71750,4824953,9602672
1993-03-23,1993,174,N,1,1,89085,5667537,12234050,81150,4906103,9602672
1993-03-24,1993,175,N,1,1,104914,5772451,12234050,104370,5010473,9602672
1993-03-25,1993,176,N,1,1,127061,5899512,12234050,127146,5137619,9602672
1993-03-26,1993,177,N,1,1,136769,6036281,12234050,140242,5277861,9602672
1993-03-27,1993,178,N,1,1,143337,6179618,12234050,147183,5425044,9602672
1993-03-28,1993,179,N,1,1,143649,6323267,12234050,150488,5575532,9602672
1993-03-29,1993,180,N,1,1,136980,6460247,12234050,136537,5712069,9602672
1993-03-30,1993,181,N,1,1,123410,6583657,12234050,121107,5833176,9602672
1993-03-31,1993,182,N,1,1,108890,6692547,12234050,103244,5936420,9602672
1993-04-01,1993,183,N,1,1,105348,6797895,12234050,99659,6036079,9602672
1993-04-02,1993,184,N,1,1,100227,6898122,12234050,91602,6127681,9602672
1993-04-03,1993,185,N,1,1,92579,6990701,12234050,84002,6211683,9602672
1993-04-04,1993,186,N,1,1,83213,7073914,12234050,75038,6286721,9602672
1993-04-05,1993,187,N,1,1,76902,7150816,12234050,68676,6355397,9602672
1993-04-06,1993,188,N,1,1,72140,7222956,12234050,63579,6418976,9602672
1993-04-07,1993,189,N,1,1,68470,7291426,12234050,59885,6478861,9602672
1993-04-08,1993,190,N,1,1,64903,7356329,12234050,56048,6534909,9602672
1993-04-09,1993,191,N,1,1,61232,7417561,12234050,52301,6587210,9602672
1993-04-10,1993,192,N,1,1,56355,7473916,12234050,47475,6634685,9602672
1993-04-11,1993,193,N,1,1,51768,7525684,12234050,43062,6677747,9602672
1993-04-12,1993,194,N,1,1,48829,7574513,12234050,40446,6718193,9602672
1993-04-13,1993,195,N,1,1,46517,7621030,12234050,38447,6756640,9602672
1993-04-14,1993,196,N,1,1,44075,7665105,12234050,35255,6791895,9602672
1993-04-15,1993,197,N,1,1,41572,7706677,12234050,32394,6824289,9602672
1993-04-16,1993,198,N,1,1,39045,7745722,12234050,30121,6854410,9602672
1993-04-17,1993,199,N,1,1,36469,7782191,12234050,27431,6881841,9602672
1993-04-18,1993,200,N,1,1,34167,7816358,12234050,27152,6908993,9602672
1993-04-19,1993,201,N,1,1,35695,7852053,12234050,28661,6937654,9602672
1993-04-20,1993,202,N,1,1,37869,7889922,12234050,31795,6969449,9602672
1993-04-21,1993,203,N,1,1,38709,7928631,12234050,33419,7002868,9602672
1993-04-22,1993,204,N,1,1,36760,7965391,12234050,31407,7034275,9602672
1993-04-23,1993,205,N,1,1,36003,8001394,12234050,29853,7064128,9602672
1993-04-24,1993,206,N,1,1,35649,8037043,12234050,29935,7094063,9602672
1993-04-25,1993,207,N,1,1,33479,8070522,12234050,27628,7121691,9602672
1993-04-26,1993,208,N,1,1,33180,8103702,12234050,29391,7151082,9602672
1993-04-27,1993,209,N,1,1,32477,8136179,12234050,29247,7180329,9602672
1993-04-28,1993,210,N,1,1,31732,8167911,12234050,28263,7208592,9602672
1993-04-29,1993,211,N,1,1,32849,8200760,12234050,29073,7237665,9602672
1993-04-30,1993,212,N,1,1,31325,8232085,12234050,27633,7265298,9602672
1993-05-01,1993,213,N,1,1,34045,8266130,12234050,30209,7295507,9602672
1993-05-02,1993,214,N,1,1,33421,8299551,12234050,29751,7325258,9602672
1993-05-03,1993,215,N,1,1,30788,8330339,12234050,26995,7352253,9602672
1993-05-04,1993,216,N,1,1,30119,8360458,12234050,26226,7378479,9602672
1993-05-05,1993,217,N,1,1,31236,8391694,12234050,27421,7405900,9602672
1993-05-06,1993,218,N,1,1,31914,8423608,12234050,28199,7434099,9602672
1993-05-07,1993,219,N,1,1,31955,8455563,12234050,28052,7462151,9602672
1993-05-08,1993,220,N,1,1,33168,8488731,12234050,29144,7491295,9602672
1993-05-09,1993,221,N,1,1,30971,8519702,12234050,27000,7518295,9602672
1993-05-10,1993,222,N,1,1,31396,8551098,12234050,27359,7545654,9602672
1993-05-11,1993,223,N,1,1,28888,8579986,12234050,24879,7570533,9602672
1993-05-12,1993,224,N,1,1,31121,8611107,12234050,27285,7597818,9602672
1993-05-13,1993,225,N,1,1,31470,8642577,12234050,27633,7625451,9602672
1993-05-14,1993,226,N,1,1,29735,8672312,12234050,25987,7651438,9602672
1993-05-15,1993,227,N,1,1,29668,8701980,12234050,25758,7677196,9602672
1993-05-16,1993,228,N,1,1,27716,8729696,12234050,23760,7700956,9602672
1993-05-17,1993,229,N,1,1,24522,8754218,12234050,18086,7719042,9602672
1993-05-18,1993,230,N,1,1,26719,8780937,12234050,18685,7737727,9602672
1993-05-19,1993,231,N,1,1,24469,8805406,12234050,15725,7753452,9602672
1993-05-20,1993,232,N,1,1,25374,8830780,12234050,16625,7770077,9602672
1993-05-21,1993,233,N,1,1,24306,8855086,12234050,15674,7785751,9602672
1993-05-22,1993,234,N,1,1,24634,8879720,12234050,15964,7801715,9602672
1993-05-23,1993,235,N,1,1,26486,8906206,12234050,17755,7819470,9602672
1993-05-24,1993,236,N,1,1,28625,8934831,12234050,22925,7842395,9602672
1993-05-25,1993,237,N,1,1,31884,8966715,12234050,25873,7868268,9602672
1993-05-26,1993,238,N,1,1,33143,8999858,12234050,27277,7895545,9602672
1993-05-27,1993,239,N,1,1,35725,9035583,12234050,31033,7926578,9602672
1993-05-28,1993,240,N,1,1,37794,9073377,12234050,33754,7960332,9602672
1993-05-29,1993,241,N,1,1,35981,9109358,12234050,29058,7989390,9602672
1993-05-30,1993,242,N,1,1,34454,9143812,12234050,27503,8016893,9602672
1993-05-31,1993,243,N,1,1,33520,9177332,12234050,29239,8046132,9602672
1993-06-01,1993,244,N,1,1,33990,9211322,12234050,28589,8074721,9602672
1993-06-02,1993,245,N,1,1,33238,9244560,12234050,28312,8103033,9602672
1993-06-03,1993,246,N,1,1,45763,9290323,12234050,40506,8143539,9602672
1993-06-04,1993,247,N,1,1,47367,9337690,12234050,42092,8185631,9602672
1993-06-05,1993,248,N,1,1,48077,9385767,12234050,41370,8227001,9602672
1993-06-06,1993,249,N,1,1,49134,9434901,12234050,43568,8270569,9602672
1993-06-07,1993,250,N,1,1,51906,9486807,12234050,46335,8316904,9602672
1993-06-08,1993,251,N,1,1,54362,9541169,12234050,48626,8365530,9602672
1993-06-09,1993,252,N,1,1,52410,9593579,12234050,46846,8412376,9602672
1993-06-10,1993,253,N,1,1,50230,9643809,12234050,43801,8456177,9602672
1993-06-11,1993,254,N,1,1,45735,9689544,12234050,38084,8494261,9602672
1993-06-12,1993,255,N,1,1,41666,9731210,12234050,33883,8528144,9602672
1993-06-13,1993,256,N,1,1,38342,9769552,12234050,30533,8558677,9602672
1993-06-14,1993,257,N,1,1,35224,9804776,12234050,27388,8586065,9602672
1993-06-15,1993,258,N,1,1,33388,9838164,12234050,25441,8611506,9602672
1993-06-16,1993,259,N,1,1,31907,9870071,12234050,24039,8635545,9602672
1993-06-17,1993,260,N,1,1,29721,9899792,12234050,21904,8657449,9602672
1993-06-18,1993,261,N,1,1,28165,9927957,12234050,20398,8677847,9602672
1993-06-19,1993,262,N,1,1,27091,9955048,12234050,19265,8697112,9602672
1993-06-20,1993,263,N,1,1,26375,9981423,12234050,18425,8715537,9602672
1993-06-21,1993,264,N,1,1,25891,10007314,12234050,18023,8733560,9602672
1993-06-22,1993,265,N,1,1,26004,10033318,12234050,18478,8752038,9602672
1993-06-23,1993,266,N,1,1,24778,10058096,12234050,17246,8769284,9602672
1993-06-24,1993,267,N,1,1,22953,10081049,12234050,15011,8784295,9602672
1993-06-25,1993,268,N,1,1,22735,10103784,12234050,14605,8798900,9602672
1993-06-26,1993,269,N,1,1,21614,10125398,12234050,12363,8811263,9602672
1993-06-27,1993,270,N,1,1,21071,10146469,12234050,11013,8822276,9602672
1993-06-28,1993,271,N,1,1,21217,10167686,12234050,11759,8834035,9602672
1993-06-29,1993,272,N,1,1,22100,10189786,12234050,12579,8846614,9602672
1993-06-30,1993,273,N,1,1,21500,10211286,12234050,11864,8858478,9602672
1993-07-01,1993,274,N,1,1,21392,10232678,12234050,9921,8868399,9602672
1993-07-02,1993,275,N,1,1,21251,10253929,12234050,8277,8876676,9602672
1993-07-03,1993,276,N,1,1,19455,10273384,12234050,6229,8882905,9602672
1993-07-04,1993,277,N,1,1,19494,10292878,12234050,6328,8889233,9602672
1993-07-05,1993,278,N,1,1,20852,10313730,12234050,7609,8896842,9602672
1993-07-06,1993,279,N,1,1,23948,10337678,12234050,10757,8907599,9602672
1993-07-07,1993,280,N,1,1,24527,10362205,12234050,13423,8921022,9602672
1993-07-08,1993,281,N,1,1,25053,10387258,12234050,13017,8934039,9602672
1993-07-09,1993,282,N,1,1,24918,10412176,12234050,11142,8945181,9602672
1993-07-10,1993,283,N,1,1,22842,10435018,12234050,8927,8954108,9602672
1993-07-11,1993,284,N,1,1,22856,10457874,12234050,8947,8963055,9602672
1993-07-12,1993,285,N,1,1,22767,10480641,12234050,9734,8972789,9602672
1993-07-13,1993,286,N,1,1,22573,10503214,12234050,9555,8982344,9602672
1993-07-14,1993,287,N,1,1,22345,10525559,12234050,9364,8991708,9602672
1993-07-15,1993,288,N,1,1,22214,10547773,12234050,9110,9000818,9602672
1993-07-16,1993,289,N,1,1,21951,10569724,12234050,8838,9009656,9602672
1993-07-17,1993,290,N,1,1,21807,10591531,12234050,8804,9018460,9602672
1993-07-18,1993,291,N,1,1,21779,10613310,12234050,8838,9027298,9602672
1993-07-19,1993,292,N,1,1,21828,10635138,12234050,8910,9036208,9602672
1993-07-20,1993,293,N,1,1,22101,10657239,12234050,9173,9045381,9602672
1993-07-21,1993,294,N,1,1,21856,10679095,12234050,8633,9054014,9602672
1993-07-22,1993,295,N,1,1,21058,10700153,12234050,7893,9061907,9602672
1993-07-23,1993,296,N,1,1,22331,10722484,12234050,9310,9071217,9602672
1993-07-24,1993,297,N,1,1,22784,10745268,12234050,9248,9080465,9602672
1993-07-25,1993,298,N,1,1,23300,10768568,12234050,9617,9090082,9602672
1993-07-26,1993,299,N,1,1,23312,10791880,12234050,9429,9099511,9602672
1993-07-27,1993,300,N,1,1,23641,10815521,12234050,9390,9108901,9602672
1993-07-28,1993,301,N,1,1,23818,10839339,12234050,9608,9118509,9602672
1993-07-29,1993,302,N,1,1,24329,10863668,12234050,10371,9128880,9602672
1993-07-30,1993,303,N,1,1,24942,10888610,12234050,11007,9139887,9602672
1993-07-31,1993,304,N,1,1,25522,10914132,12234050,11531,9151418,9602672
1993-08-01,1993,305,N,1,1,26325,10940457,12234050,12333,9163751,9602672
1993-08-02,1993,306,N,1,1,27542,10967999,12234050,11849,9175600,9602672
1993-08-03,1993,307,N,1,1,28541,10996540,12234050,12933,9188533,9602672
1993-08-04,1993,308,N,1,1,28152,11024692,12234050,13030,9201563,9602672
1993-08-05,1993,309,N,1,1,27339,11052031,12234050,12009,9213572,9602672
1993-08-06,1993,310,N,1,1,26309,11078340,12234050,10914,9224486,9602672
1993-08-07,1993,311,N,1,1,25842,11104182,12234050,10533,9235019,9602672
1993-08-08,1993,312,N,1,1,25142,11129324,12234050,10091,9245110,9602672
1993-08-09,1993,313,N,1,1,25203,11154527,12234050,10372,9255482,9602672
1993-08-10,1993,314,N,1,1,25091,11179618,12234050,10081,9265563,9602672
1993-08-11,1993,315,N,1,1,24695,11204313,12234050,9611,9275174,9602672
1993-08-12,1993,316,N,1,1,24498,11228811,12234050,9542,9284716,9602672
1993-08-13,1993,317,N,1,1,24025,11252836,12234050,9213,9293929,9602672
1993-08-14,1993,318,N,1,1,23767,11276603,12234050,9173,9303102,9602672
1993-08-15,1993,319,N,1,1,23434,11300037,12234050,8259,9311361,9602672
1993-08-16,1993,320,N,1,1,23851,11323888,12234050,9381,9320742,9602672
1993-08-17,1993,321,N,1,1,24182,11348070,12234050,9135,9329877,9602672
1993-08-18,1993,322,N,1,1,23819,11371889,12234050,8808,9338685,9602672
1993-08-19,1993,323,N,1,1,23411,11395300,12234050,8623,9347308,9602672
1993-08-20,1993,324,N,1,1,23769,11419069,12234050,9273,9356581,9602672
1993-08-21,1993,325,N,1,1,23542,11442611,12234050,8948,9365529,9602672
1993-08-22,1993,326,N,1,1,22923,11465534,12234050,8290,9373819,9602672
1993-08-23,1993,327,N,1,1,22279,11487813,12234050,7401,9381220,9602672
1993-08-24,1993,328,N,1,1,21452,11509265,12234050,6886,9388106,9602672
1993-08-25,1993,329,N,1,1,20739,11530004,12234050,6431,9394537,9602672
1993-08-26,1993,330,N,1,1,21079,11551083,12234050,6792,9401329,9602672
1993-08-27,1993,331,N,1,1,21405,11572488,12234050,7120,9408449,9602672
1993-08-28,1993,332,N,1,1,21860,11594348,12234050,8623,9417072,9602672
1993-08-29,1993,333,N,1,1,22817,11617165,12234050,8807,9425879,9602672
1993-08-30,1993,334,N,1,1,23129,11640294,12234050,9153,9435032,9602672
1993-08-31,1993,335,N,1,1,22953,11663247,12234050,8465,9443497,9602672
1993-09-01,1993,336,N,1,1,23008,11686255,12234050,8536,9452033,9602672
1993-09-02,1993,337,N,1,1,22416,11708671,12234050,7892,9459925,9602672
1993-09-03,1993,338,N,1,1,21326,11729997,12234050,6845,9466770,9602672
1993-09-04,1993,339,N,1,1,21063,11751060,12234050,6683,9473453,9602672
1993-09-05,1993,340,N,1,1,20849,11771909,12234050,6520,9479973,9602672
1993-09-06,1993,341,N,1,1,21005,11792914,12234050,6740,9486713,9602672
1993-09-07,1993,342,N,1,1,21011,11813925,12234050,6824,9493537,9602672
1993-09-08,1993,343,N,1,1,20357,11834282,12234050,6225,9499762,9602672
1993-09-09,1993,344,N,1,1,19832,11854114,12234050,5680,9505442,9602672
1993-09-10,1993,345,N,1,1,19631,11873745,12234050,5525,9510967,9602672
1993-09-11,1993,346,N,1,1,19185,11892930,12234050,5459,9516426,9602672
1993-09-12,1993,347,N,1,1,18808,11911738,12234050,4995,9521421,9602672
1993-09-13,1993,348,N,1,1,18309,11930047,12234050,4107,9525528,9602672
1993-09-14,1993,349,N,1,1,18105,11948152,12234050,3632,9529160,9602672
1993-09-15,1993,350,N,1,1,17965,11966117,12234050,4948,9534108,9602672
1993-09-16,1993,351,N,1,1,17771,11983888,12234050,3931,9538039,9602672
1993-09-17,1993,352,N,1,1,17882,12001770,12234050,3822,9541861,9602672
1993-09-18,1993,353,N,1,1,17848,12019618,12234050,4336,9546197,9602672
1993-09-19,1993,354,N,1,1,17547,12037165,12234050,3864,9550061,9602672
1993-09-20,1993,355,N,1,1,16753,12053918,12234050,3033,9553094,9602672
1993-09-21,1993,356,N,1,1,17414,12071332,12234050,4222,9557316,9602672
1993-09-22,1993,357,N,1,1,17605,12088937,12234050,4264,9561580,9602672
1993-09-23,1993,358,N,1,1,18003,12106940,12234050,5014,9566594,9602672
1993-09-24,1993,359,N,1,1,18164,12125104,12234050,6774,9573368,9602672
1993-09-25,1993,360,N,1,1,18318,12143422,12234050,5338,9578706,9602672
1993-09-26,1993,361,N,1,1,18211,12161633,12234050,4736,9583442,9602672
1993-09-27,1993,362,N,1,1,18352,12179985,12234050,4854,9588296,9602672
1993-09-28,1993,363,N,1,1,17970,12197955,12234050,4758,9593054,9602672
1993-09-29,1993,364,N,1,1,17700,12215655,12234050,4336,9597390,9602672
1993-09-30,1993,365,N,1,1,18395,12234050,12234050,5282,9602672,9602672
1993-10-01,1994,1,N,2,2,17835,17835,5578905,4426,4426,3013703
1993-10-02,1994,2,N,2,2,16600,34435,5578905,3307,7733,3013703
1993-10-03,1994,3,N,2,2,15910,50345,5578905,2586,10319,3013703
1993-10-04,1994,4,N,2,2,15550,65895,5578905,2451,12770,3013703
1993-10-05,1994,5,N,2,2,15680,81575,5578905,2558,15328,3013703
1993-10-06,1994,6,N,2,2,15632,97207,5578905,2706,18034,3013703
1993-10-07,1994,7,N,2,2,16805,114012,5578905,3683,21717,3013703
1993-10-08,1994,8,N,2,2,17566,131578,5578905,4448,26165,3013703
1993-10-09,1994,9,N,2,2,18239,149817,5578905,5232,31397,3013703
1993-10-10,1994,10,N,2,2,18791,168608,5578905,5858,37255,3013703
1993-10-11,1994,11,N,2,2,19558,188166,5578905,6504,43759,3013703
1993-10-12,1994,12,N,2,2,19358,207524,5578905,6332,50091,3013703
1993-10-13,1994,13,N,2,2,19780,227304,5578905,6864,56955,3013703
1993-10-14,1994,14,N,2,2,20759,248063,5578905,8892,65847,3013703
1993-10-15,1994,15,N,2,2,20385,268448,5578905,10834,76681,3013703
1993-10-16,1994,16,N,2,2,20355,288803,5578905,10769,87450,3013703
1993-10-17,1994,17,N,2,2,20340,309143,5578905,10794,98244,3013703
1993-10-18,1994,18,N,2,2,21247,330390,5578905,11751,109995,3013703
1993-10-19,1994,19,N,2,2,21876,352266,5578905,11365,121360,3013703
1993-10-20,1994,20,N,2,2,20029,372295,5578905,7231,128591,3013703
1993-10-21,1994,21,N,2,2,18001,390296,5578905,5139,133730,3013703
1993-10-22,1994,22,N,2,2,17345,407641,5578905,4534,138264,3013703
1993-10-23,1994,23,N,2,2,16528,424169,5578905,3746,142010,3013703
1993-10-24,1994,24,N,2,2,15617,439786,5578905,2837,144847,3013703
1993-10-25,1994,25,N,2,2,14761,454547,5578905,1922,146769,3013703
1993-10-26,1994,26,N,2,2,14136,468683,5578905,1404,148173,3013703
1993-10-27,1994,27,N,2,2,14047,482730,5578905,1187,149360,3013703
1993-10-28,1994,28,N,2,2,13774,496504,5578905,879,150239,3013703
1993-10-29,1994,29,N,2,2,14072,510576,5578905,2149,152388,3013703
1993-10-30,1994,30,N,2,2,14248,524824,5578905,3559,155947,3013703
1993-10-31,1994,31,N,2,2,14148,538972,5578905,2706,158653,3013703
1993-11-01,1994,32,N,2,2,14595,553567,5578905,5976,164629,3013703
1993-11-02,1994,33,N,2,2,14225,567792,5578905,8041,172670,3013703
1993-11-03,1994,34,N,2,2,13892,581684,5578905,7732,180402,3013703
1993-11-04,1994,35,N,2,2,13785,595469,5578905,7627,188029,3013703
1993-11-05,1994,36,N,2,2,14175,609644,5578905,7649,195678,3013703
1993-11-06,1994,37,N,2,2,14142,623786,5578905,7615,203293,3013703
1993-11-07,1994,38,N,2,2,14284,638070,5578905,7762,211055,3013703
1993-11-08,1994,39,N,2,2,14055,652125,5578905,5283,216338,3013703
1993-11-09,1994,40,N,2,2,13940,666065,5578905,5079,221417,3013703
1993-11-10,1994,41,N,2,2,13814,679879,5578905,9735,231152,3013703
1993-11-11,1994,42,N,2,2,14082,693961,5578905,11161,242313,3013703
1993-11-12,1994,43,N,2,2,14258,708219,5578905,11254,253567,3013703
1993-11-13,1994,44,N,2,2,14463,722682,5578905,11530,265097,3013703
1993-11-14,1994,45,N,2,2,14629,737311,5578905,11800,276897,3013703
1993-11-15,1994,46,N,2,2,14006,751317,5578905,6032,282929,3013703
1993-11-16,1994,47,N,2,2,14399,765716,5578905,5473,288402,3013703
1993-11-17,1994,48,N,2,2,14506,780222,5578905,5571,293973,3013703
1993-11-18,1994,49,N,2,2,14803,795025,5578905,5943,299916,3013703
1993-11-19,1994,50,N,2,2,14695,809720,5578905,5834,305750,3013703
1993-11-20,1994,51,N,2,2,14470,824190,5578905,5526,311276,3013703
1993-11-21,1994,52,N,2,2,14466,838656,5578905,5701,316977,3013703
1993-11-22,1994,53,N,2,2,14378,853034,5578905,2456,319433,3013703
1993-11-23,1994,54,N,2,2,14656,867690,5578905,2740,322173,3013703
1993-11-24,1994,55,N,2,2,14212,881902,5578905,3409,325582,3013703
1993-11-25,1994,56,N,2,2,14076,895978,5578905,5096,330678,3013703
1993-11-26,1994,57,N,2,2,14150,910128,5578905,4891,335569,3013703
1993-11-27,1994,58,N,2,2,14228,924356,5578905,4938,340507,3013703
1993-11-28,1994,59,N,2,2,14052,938408,5578905,8993,349500,3013703
1993-11-29,1994,60,N,2,2,14822,953230,5578905,14461,363961,3013703
1993-11-30,1994,61,N,2,2,16820,970050,5578905,16110,380071,3013703
1993-12-01,1994,62,N,2,2,16407,986457,5578905,13030,393101,3013703
1993-12-02,1994,63,N,2,2,16315,1002772,5578905,12849,405950,3013703
1993-12-03,1994,64,N,2,2,16508,1019280,5578905,8502,414452,3013703
1993-12-04,1994,65,N,2,2,16288,1035568,5578905,4977,419429,3013703
1993-12-05,1994,66,N,2,2,16844,1052412,5578905,4854,424283,3013703
1993-12-06,1994,67,N,2,2,17729,1070141,5578905,6528,430811,3013703
1993-12-07,1994,68,N,2,2,18706,1088847,5578905,6457,437268,3013703
1993-12-08,1994,69,N,2,2,19985,1108832,5578905,9686,446954,3013703
1993-12-09,1994,70,N,2,2,23312,1132144,5578905,12817,459771,3013703
1993-12-10,1994,71,N,2,2,24888,1157032,5578905,15274,475045,3013703
1993-12-11,1994,72,N,2,2,27622,1184654,5578905,22844,497889,3013703
1993-12-12,1994,73,N,2,2,28589,1213243,5578905,23287,521176,3013703
1993-12-13,1994,74,N,2,2,28138,1241381,5578905,22652,543828,3013703
1993-12-14,1994,75,N,2,2,29893,1271274,5578905,25013,568841,3013703
1993-12-15,1994,76,N,2,2,29394,1300668,5578905,23850,592691,3013703
1993-12-16,1994,77,N,2,2,30100,1330768,5578905,19079,611770,3013703
1993-12-17,1994,78,N,2,2,29723,1360491,5578905,18709,630479,3013703
1993-12-18,1994,79,N,2,2,27117,1387608,5578905,14233,644712,3013703
1993-12-19,1994,80,N,2,2,25004,1412612,5578905,11823,656535,3013703
1993-12-20,1994,81,N,2,2,23444,1436056,5578905,10639,667174,3013703
1993-12-21,1994,82,N,2,2,21879,1457935,5578905,8599,675773,3013703
1993-12-22,1994,83,N,2,2,21793,1479728,5578905,8611,684384,3013703
1993-12-23,1994,84,N,2,2,22221,1501949,5578905,8840,693224,3013703
1993-12-24,1994,85,N,2,2,22280,1524229,5578905,8774,701998,3013703
1993-12-25,1994,86,N,2,2,21740,1545969,5578905,8336,710334,3013703
1993-12-26,1994,87,N,2,2,21328,1567297,5578905,8377,718711,3013703
1993-12-27,1994,88,N,2,2,21224,1588521,5578905,8392,727103,3013703
1993-12-28,1994,89,N,2,2,20794,1609315,5578905,9123,736226,3013703
1993-12-29,1994,90,N,2,2,19937,1629252,5578905,8693,744919,3013703
1993-12-30,1994,91,N,2,2,18855,1648107,5578905,9796,754715,3013703
1993-12-31,1994,92,N,2,2,18042,1666149,5578905,8542,763257,3013703
1994-01-01,1994,93,N,2,2,17341,1683490,5578905,7398,770655,3013703
1994-01-02,1994,94,N,2,2,16780,1700270,5578905,7975,778630,3013703
1994-01-03,1994,95,N,2,2,16328,1716598,5578905,7992,786622,3013703
1994-01-04,1994,96,N,2,2,15983,1732581,5578905,9285,795907,3013703
1994-01-05,1994,97,N,2,2,15881,1748462,5578905,9200,805107,3013703
1994-01-06,1994,98,N,2,2,15755,1764217,5578905,9351,814458,3013703
1994-01-07,1994,99,N,2,2,15187,1779404,5578905,8902,823360,3013703
1994-01-08,1994,100,N,2,2,14752,1794156,5578905,9976,833336,3013703
1994-01-09,1994,101,N,2,2,14735,1808891,5578905,9735,843071,3013703
1994-01-10,1994,102,N,2,2,14900,1823791,5578905,9925,852996,3013703
1994-01-11,1994,103,N,2,2,14725,1838516,5578905,8753,861749,3013703
1994-01-12,1994,104,N,2,2,14628,1853144,5578905,9185,870934,3013703
1994-01-13,1994,105,N,2,2,14142,1867286,5578905,7593,878527,3013703
1994-01-14,1994,106,N,2,2,13863,1881149,5578905,7924,886451,3013703
1994-01-15,1994,107,N,2,2,13683,1894832,5578905,7376,893827,3013703
1994-01-16,1994,108,N,2,2,13750,1908582,5578905,7491,901318,3013703
1994-01-17,1994,109,N,2,2,13789,1922371,5578905,7523,908841,3013703
1994-01-18,1994,110,N,2,2,13673,1936044,5578905,8366,917207,3013703
1994-01-19,1994,111,N,2,2,14103,1950147,5578905,8830,926037,3013703
1994-01-20,1994,112,N,2,2,14172,1964319,5578905,8510,934547,3013703
1994-01-21,1994,113,N,2,2,14228,1978547,5578905,8313,942860,3013703
1994-01-22,1994,114,N,2,2,13808,1992355,5578905,13118,955978,3013703
1994-01-23,1994,115,N,2,2,13687,2006042,5578905,13877,969855,3013703
1994-01-24,1994,116,N,2,2,15206,2021248,5578905,16558,986413,3013703
1994-01-25,1994,117,N,2,2,18165,2039413,5578905,17662,1004075,3013703
1994-01-26,1994,118,N,2,2,24187,2063600,5578905,24392,1028467,3013703
1994-01-27,1994,119,N,2,2,26335,2089935,5578905,22170,1050637,3013703
1994-01-28,1994,120,N,2,2,24312,2114247,5578905,17402,1068039,3013703
1994-01-29,1994,121,N,2,2,21268,2135515,5578905,12462,1080501,3013703
1994-01-30,1994,122,N,2,2,19005,2154520,5578905,8447,1088948,3013703
1994-01-31,1994,123,N,2,2,17469,2171989,5578905,8711,1097659,3013703
1994-02-01,1994,124,N,2,2,16118,2188107,5578905,10908,1108567,3013703
1994-02-02,1994,125,N,2,2,15082,2203189,5578905,9886,1118453,3013703
1994-02-03,1994,126,N,2,2,14457,2217646,5578905,9621,1128074,3013703
1994-02-04,1994,127,N,2,2,14124,2231770,5578905,9382,1137456,3013703
1994-02-05,1994,128,N,2,2,13815,2245585,5578905,10338,1147794,3013703
1994-02-06,1994,129,N,2,2,13717,2259302,5578905,16311,1164105,3013703
1994-02-07,1994,130,N,2,2,15485,2274787,5578905,15020,1179125,3013703
1994-02-08,1994,131,N,2,2,22097,2296884,5578905,19806,1198931,3013703
1994-02-09,1994,132,N,2,2,33444,2330328,5578905,32133,1231064,3013703
1994-02-10,1994,133,N,2,2,34770,2365098,5578905,36774,1267838,3013703
1994-02-11,1994,134,N,2,2,29561,2394659,5578905,24414,1292252,3013703
1994-02-12,1994,135,N,2,2,26714,2421373,5578905,19645,1311897,3013703
1994-02-13,1994,136,N,2,2,25957,2447330,5578905,18945,1330842,3013703
1994-02-14,1994,137,N,2,2,23819,2471149,5578905,16357,1347199,3013703
1994-02-15,1994,138,N,2,2,21368,2492517,5578905,13777,1360976,3013703
1994-02-16,1994,139,N,2,2,19368,2511885,5578905,16386,1377362,3013703
1994-02-17,1994,140,N,2,2,18502,2530387,5578905,18385,1395747,3013703
1994-02-18,1994,141,N,2,2,19932,2550319,5578905,20288,1416035,3013703
1994-02-19,1994,142,N,2,2,22013,2572332,5578905,25953,1441988,3013703
1994-02-20,1994,143,N,2,2,26616,2598948,5578905,33504,1475492,3013703
1994-02-21,1994,144,N,2,2,28340,2627288,5578905,32327,1507819,3013703
1994-02-22,1994,145,N,2,2,33525,2660813,5578905,34700,1542519,3013703
1994-02-23,1994,146,N,2,2,32644,2693457,5578905,34778,1577297,3013703
1994-02-24,1994,147,N,2,2,28470,2721927,5578905,27202,1604499,3013703
1994-02-25,1994,148,N,2,2,25668,2747595,5578905,21995,1626494,3013703
1994-02-26,1994,149,N,2,2,23417,2771012,5578905,17404,1643898,3013703
1994-02-27,1994,150,N,2,2,21733,2792745,5578905,15398,1659296,3013703
1994-02-28,1994,151,N,2,2,20533,2813278,5578905,13960,1673256,3013703
1994-03-01,1994,152,N,2,2,20519,2833797,5578905,13916,1687172,3013703
1994-03-02,1994,153,N,2,2,20737,2854534,5578905,14909,1702081,3013703
1994-03-03,1994,154,N,2,2,19839,2874373,5578905,13721,1715802,3013703
1994-03-04,1994,155,N,2,2,19554,2893927,5578905,13597,1729399,3013703
1994-03-05,1994,156,N,2,2,19039,2912966,5578905,13047,1742446,3013703
1994-03-06,1994,157,N,2,2,19208,2932174,5578905,14055,1756501,3013703
1994-03-07,1994,158,N,2,2,19180,2951354,5578905,13104,1769605,3013703
1994-03-08,1994,159,N,2,2,19254,2970608,5578905,13497,1783102,3013703
1994-03-09,1994,160,N,2,2,18734,2989342,5578905,12993,1796095,3013703
1994-03-10,1994,161,N,2,2,17895,3007237,5578905,11820,1807915,3013703
1994-03-11,1994,162,N,2,2,17659,3024896,5578905,11523,1819438,3013703
1994-03-12,1994,163,N,2,2,16810,3041706,5578905,10816,1830254,3013703
1994-03-13,1994,164,N,2,2,16346,3058052,5578905,10325,1840579,3013703
1994-03-14,1994,165,N,2,2,16141,3074193,5578905,10173,1850752,3013703
1994-03-15,1994,166,N,2,2,15653,3089846,5578905,9798,1860550,3013703
1994-03-16,1994,167,N,2,2,15776,3105622,5578905,9854,1870404,3013703
1994-03-17,1994,168,N,2,2,15474,3121096,5578905,9740,1880144,3013703
1994-03-18,1994,169,N,2,2,14959,3136055,5578905,8965,1889109,3013703
1994-03-19,1994,170,N,2,2,15740,3151795,5578905,10052,1899161,3013703
1994-03-20,1994,171,N,2,2,15594,3167389,5578905,9829,1908990,3013703
1994-03-21,1994,172,N,2,2,14750,3182139,5578905,9150,1918140,3013703
1994-03-22,1994,173,N,2,2,14179,3196318,5578905,8758,1926898,3013703
1994-03-23,1994,174,N,2,2,14398,3210716,5578905,9166,1936064,3013703
1994-03-24,1994,175,N,2,2,13679,3224395,5578905,8985,1945049,3013703
1994-03-25,1994,176,N,2,2,13498,3237893,5578905,8411,1953460,3013703
1994-03-26,1994,177,N,2,2,13478,3251371,5578905,8731,1962191,3013703
1994-03-27,1994,178,N,2,2,13158,3264529,5578905,8304,1970495,3013703
1994-03-28,1994,179,N,2,2,12018,3276547,5578905,6740,1977235,3013703
1994-03-29,1994,180,N,2,2,12423,3288970,5578905,6620,1983855,3013703
1994-03-30,1994,181,N,2,2,11999,3300969,5578905,8416,1992271,3013703
1994-03-31,1994,182,N,2,2,11671,3312640,5578905,9433,2001704,3013703
1994-04-01,1994,183,N,2,2,11639,3324279,5578905,8612,2010316,3013703
1994-04-02,1994,184,N,2,2,12020,3336299,5578905,7459,2017775,3013703
1994-04-03,1994,185,N,2,2,12160,3348459,5578905,7485,2025260,3013703
1994-04-04,1994,186,N,2,2,11939,3360398,5578905,7379,2032639,3013703
1994-04-05,1994,187,N,2,2,10995,3371393,5578905,6128,2038767,3013703
1994-04-06,1994,188,N,2,2,10573,3381966,5578905,5750,2044517,3013703
1994-04-07,1994,189,N,2,2,10808,3392774,5578905,6353,2050870,3013703
1994-04-08,1994,190,N,2,2,10082,3402856,5578905,7065,2057935,3013703
1994-04-09,1994,191,N,2,2,10276,3413132,5578905,7719,2065654,3013703
1994-04-10,1994,192,N,2,2,10766,3423898,5578905,8193,2073847,3013703
1994-04-11,1994,193,N,2,2,10692,3434590,5578905,8761,2082608,3013703
1994-04-12,1994,194,N,2,2,10693,3445283,5578905,8140,2090748,3013703
1994-04-13,1994,195,N,2,2,10377,3455660,5578905,6525,2097273,3013703
1994-04-14,1994,196,N,2,2,10494,3466154,5578905,6684,2103957,3013703
1994-04-15,1994,197,N,2,2,9732,3475886,5578905,5896,2109853,3013703
1994-04-16,1994,198,N,2,2,9222,3485108,5578905,6089,2115942,3013703
1994-04-17,1994,199,N,2,2,9571,3494679,5578905,6727,2122669,3013703
1994-04-18,1994,200,N,2,2,9185,3503864,5578905,6337,2129006,3013703
1994-04-19,1994,201,N,2,2,9459,3513323,5578905,5721,2134727,3013703
1994-04-20,1994,202,N,2,2,9735,3523058,5578905,6741,2141468,3013703
1994-04-21,1994,203,N,2,2,9851,3532909,5578905,6584,2148052,3013703
1994-04-22,1994,204,N,2,2,9782,3542691,5578905,6045,2154097,3013703
1994-04-23,1994,205,N,2,2,9866,3552557,5578905,8611,2162708,3013703
1994-04-24,1994,206,N,2,2,10219,3562776,5578905,10294,2173002,3013703
1994-04-25,1994,207,N,2,2,10385,3573161,5578905,12525,2185527,3013703
1994-04-26,1994,208,N,2,2,11960,3585121,5578905,14509,2200036,3013703
1994-04-27,1994,209,N,2,2,12828,3597949,5578905,14988,2215024,3013703
1994-04-28,1994,210,N,2,2,14077,3612026,5578905,13241,2228265,3013703
1994-04-29,1994,211,N,2,2,13722,3625748,5578905,10618,2238883,3013703
1994-04-30,1994,212,N,2,2,12883,3638631,5578905,7311,2246194,3013703
1994-05-01,1994,213,N,2,2,11425,3650056,5578905,7488,2253682,3013703
1994-05-02,1994,214,N,2,2,10619,3660675,5578905,6917,2260599,3013703
1994-05-03,1994,215,N,2,2,10523,3671198,5578905,7365,2267964,3013703
1994-05-04,1994,216,N,2,2,10355,3681553,5578905,6793,2274757,3013703
1994-05-05,1994,217,N,2,2,10081,3691634,5578905,6677,2281434,3013703
1994-05-06,1994,218,N,2,2,9783,3701417,5578905,10134,2291568,3013703
1994-05-07,1994,219,N,2,2,11831,3713248,5578905,11990,2303558,3013703
1994-05-08,1994,220,N,2,2,12610,3725858,5578905,10967,2314525,3013703
1994-05-09,1994,221,N,2,2,14341,3740199,5578905,13288,2327813,3013703
1994-05-10,1994,222,N,2,2,14805,3755004,5578905,13530,2341343,3013703
1994-05-11,1994,223,N,2,2,14166,3769170,5578905,10139,2351482,3013703
1994-05-12,1994,224,N,2,2,13708,3782878,5578905,9514,2360996,3013703
1994-05-13,1994,225,N,2,2,12647,3795525,5578905,8335,2369331,3013703
1994-05-14,1994,226,N,2,2,11734,3807259,5578905,7717,2377048,3013703
1994-05-15,1994,227,N,2,2,12549,3819808,5578905,8872,2385920,3013703
1994-05-16,1994,228,N,2,2,11792,3831600,5578905,9258,2395178,3013703
1994-05-17,1994,229,N,2,2,11514,3843114,5578905,9801,2404979,3013703
1994-05-18,1994,230,N,2,2,10513,3853627,5578905,9207,2414186,3013703
1994-05-19,1994,231,N,2,2,10321,3863948,5578905,9385,2423571,3013703
1994-05-20,1994,232,N,2,2,10536,3874484,5578905,8988,2432559,3013703
1994-05-21,1994,233,N,2,2,10575,3885059,5578905,6919,2439478,3013703
1994-05-22,1994,234,N,2,2,11120,3896179,5578905,7336,2446814,3013703
1994-05-23,1994,235,N,2,2,11457,3907636,5578905,6825,2453639,3013703
1994-05-24,1994,236,N,2,2,11457,3919093,5578905,5743,2459382,3013703
1994-05-25,1994,237,N,2,2,11663,3930756,5578905,7868,2467250,3013703
1994-05-26,1994,238,N,2,2,11781,3942537,5578905,5973,2473223,3013703
1994-05-27,1994,239,N,2,2,11228,3953765,5578905,5100,2478323,3013703
1994-05-28,1994,240,N,2,2,10478,3964243,5578905,4108,2482431,3013703
1994-05-29,1994,241,N,2,2,9889,3974132,5578905,3172,2485603,3013703
1994-05-30,1994,242,N,2,2,9014,3983146,5578905,3377,2488980,3013703
1994-05-31,1994,243,N,2,2,8343,3991489,5578905,3392,2492372,3013703
1994-06-01,1994,244,N,2,2,9357,4000846,5578905,4527,2496899,3013703
1994-06-02,1994,245,N,2,2,9354,4010200,5578905,3684,2500583,3013703
1994-06-03,1994,246,N,2,2,9025,4019225,5578905,3864,2504447,3013703
1994-06-04,1994,247,N,2,2,8589,4027814,5578905,3400,2507847,3013703
1994-06-05,1994,248,N,2,2,7974,4035788,5578905,2752,2510599,3013703
1994-06-06,1994,249,N,2,2,7699,4043487,5578905,3407,2514006,3013703
1994-06-07,1994,250,N,2,2,8145,4051632,5578905,3798,2517804,3013703
1994-06-08,1994,251,N,2,2,8300,4059932,5578905,3679,2521483,3013703
1994-06-09,1994,252,N,2,2,8764,4068696,5578905,4156,2525639,3013703
1994-06-10,1994,253,N,2,2,8776,4077472,5578905,3493,2529132,3013703
1994-06-11,1994,254,N,2,2,8630,4086102,5578905,3535,2532667,3013703
1994-06-12,1994,255,N,2,2,9210,4095312,5578905,4534,2537201,3013703
1994-06-13,1994,256,N,2,2,9346,4104658,5578905,3639,2540840,3013703
1994-06-14,1994,257,N,2,2,9822,4114480,5578905,4098,2544938,3013703
1994-06-15,1994,258,N,2,2,9278,4123758,5578905,3295,2548233,3013703
1994-06-16,1994,259,N,2,2,9147,4132905,5578905,3448,2551681,3013703
1994-06-17,1994,260,N,2,2,9672,4142577,5578905,3923,2555604,3013703
1994-06-18,1994,261,N,2,2,10271,4152848,5578905,4034,2559638,3013703
1994-06-19,1994,262,N,2,2,10550,4163398,5578905,3864,2563502,3013703
1994-06-20,1994,263,N,2,2,10723,4174121,5578905,4092,2567594,3013703
1994-06-21,1994,264,N,2,2,10641,4184762,5578905,3792,2571386,3013703
1994-06-22,1994,265,N,2,2,10210,4194972,5578905,3333,2574719,3013703
1994-06-23,1994,266,N,2,2,10552,4205524,5578905,4305,2579024,3013703
1994-06-24,1994,267,N,2,2,10528,4216052,5578905,4163,2583187,3013703
1994-06-25,1994,268,N,2,2,10512,4226564,5578905,3713,2586900,3013703
1994-06-26,1994,269,N,2,2,11207,4237771,5578905,4556,2591456,3013703
1994-06-27,1994,270,N,2,2,10984,4248755,5578905,3374,2594830,3013703
1994-06-28,1994,271,N,2,2,10921,4259676,5578905,3670,2598500,3013703
1994-06-29,1994,272,N,2,2,10705,4270381,5578905,3575,2602075,3013703
1994-06-30,1994,273,N,2,2,10562,4280943,5578905,3742,2605817,3013703
1994-07-01,1994,274,N,2,2,10998,4291941,5578905,3826,2609643,3013703
1994-07-02,1994,275,N,2,2,10436,4302377,5578905,3239,2612882,3013703
1994-07-03,1994,276,N,2,2,10810,4313187,5578905,4331,2617213,3013703
1994-07-04,1994,277,N,2,2,11334,4324521,5578905,4862,2622075,3013703
1994-07-05,1994,278,N,2,2,11649,4336170,5578905,4746,2626821,3013703
1994-07-06,1994,279,N,2,2,11710,4347880,5578905,4882,2631703,3013703
1994-07-07,1994,280,N,2,2,12389,4360269,5578905,5447,2637150,3013703
1994-07-08,1994,281,N,2,2,14374,4374643,5578905,6991,2644141,3013703
1994-07-09,1994,282,N,2,2,16000,4390643,5578905,6232,2650373,3013703
1994-07-10,1994,283,N,2,2,16301,4406944,5578905,5532,2655905,3013703
1994-07-11,1994,284,N,2,2,15947,4422891,5578905,4671,2660576,3013703
1994-07-12,1994,285,N,2,2,15566,4438457,5578905,4657,2665233,3013703
1994-07-13,1994,286,N,2,2,15480,4453937,5578905,4508,2669741,3013703
1994-07-14,1994,287,N,2,2,15285,4469222,5578905,3797,2673538,3013703
1994-07-15,1994,288,N,2,2,15123,4484345,5578905,4065,2677603,3013703
1994-07-16,1994,289,N,2,2,15517,4499862,5578905,4971,2682574,3013703
1994-07-17,1994,290,N,2,2,15113,4514975,5578905,4158,2686732,3013703
1994-07-18,1994,291,N,2,2,14335,4529310,5578905,3671,2690403,3013703
1994-07-19,1994,292,N,2,2,13284,4542594,5578905,3904,2694307,3013703
1994-07-20,1994,293,N,2,2,12849,4555443,5578905,4873,2699180,3013703
1994-07-21,1994,294,N,2,2,12466,4567909,5578905,5732,2704912,3013703
1994-07-22,1994,295,N,2,2,12460,4580369,5578905,4598,2709510,3013703
1994-07-23,1994,296,N,2,2,12621,4592990,5578905,4684,2714194,3013703
1994-07-24,1994,297,N,2,2,13160,4606150,5578905,5171,2719365,3013703
1994-07-25,1994,298,N,2,2,13040,4619190,5578905,4622,2723987,3013703
1994-07-26,1994,299,N,2,2,12689,4631879,5578905,4016,2728003,3013703
1994-07-27,1994,300,N,2,2,12874,4644753,5578905,3917,2731920,3013703
1994-07-28,1994,301,N,2,2,12944,4657697,5578905,3692,2735612,3013703
1994-07-29,1994,302,N,2,2,13047,4670744,5578905,3058,2738670,3013703
1994-07-30,1994,303,N,2,2,12258,4683002,5578905,2554,2741224,3013703
1994-07-31,1994,304,N,2,2,12210,4695212,5578905,3927,2745151,3013703
1994-08-01,1994,305,N,2,2,12442,4707654,5578905,3647,2748798,3013703
1994-08-02,1994,306,N,2,2,12460,4720114,5578905,3368,2752166,3013703
1994-08-03,1994,307,N,2,2,12514,4732628,5578905,3456,2755622,3013703
1994-08-04,1994,308,N,2,2,12286,4744914,5578905,3511,2759133,3013703
1994-08-05,1994,309,N,2,2,11941,4756855,5578905,3067,2762200,3013703
1994-08-06,1994,310,N,2,2,11527,4768382,5578905,2471,2764671,3013703
1994-08-07,1994,311,N,2,2,11439,4779821,5578905,2588,2767259,3013703
1994-08-08,1994,312,N,2,2,12235,4792056,5578905,3320,2770579,3013703
1994-08-09,1994,313,N,2,2,11814,4803870,5578905,2508,2773087,3013703
1994-08-10,1994,314,N,2,2,11597,4815467,5578905,2489,2775576,3013703
1994-08-11,1994,315,N,2,2,11639,4827106,5578905,1881,2777457,3013703
1994-08-12,1994,316,N,2,2,11913,4839019,5578905,2460,2779917,3013703
1994-08-13,1994,317,N,2,2,12402,4851421,5578905,3025,2782942,3013703
1994-08-14,1994,318,N,2,2,12174,4863595,5578905,2432,2785374,3013703
1994-08-15,1994,319,N,2,2,12198,4875793,5578905,2556,2787930,3013703
1994-08-16,1994,320,N,2,2,12187,4887980,5578905,3675,2791605,3013703
1994-08-17,1994,321,N,2,2,11958,4899938,5578905,3807,2795412,3013703
1994-08-18,1994,322,N,2,2,12963,4912901,5578905,5866,2801278,3013703
1994-08-19,1994,323,N,2,2,12959,4925860,5578905,3782,2805060,3013703
1994-08-20,1994,324,N,2,2,13157,4939017,5578905,3849,2808909,3013703
1994-08-21,1994,325,N,2,2,13787,4952804,5578905,3728,2812637,3013703
1994-08-22,1994,326,N,2,2,15026,4967830,5578905,4358,2816995,3013703
1994-08-23,1994,327,N,2,2,14816,4982646,5578905,2437,2819432,3013703
1994-08-24,1994,328,N,2,2,14874,4997520,5578905,2567,2821999,3013703
1994-08-25,1994,329,N,2,2,14706,5012226,5578905,2692,2824691,3013703
1994-08-26,1994,330,N,2,2,15452,5027678,5578905,3791,2828482,3013703
1994-08-27,1994,331,N,2,2,15572,5043250,5578905,3410,2831892,3013703
1994-08-28,1994,332,N,2,2,16085,5059335,5578905,3800,2835692,3013703
1994-08-29,1994,333,N,2,2,16799,5076134,5578905,4567,2840259,3013703
1994-08-30,1994,334,N,2,2,16697,5092831,5578905,3482,2843741,3013703
1994-08-31,1994,335,N,2,2,16974,5109805,5578905,4784,2848525,3013703
1994-09-01,1994,336,N,2,2,17033,5126838,5578905,4382,2852907,3013703
1994-09-02,1994,337,N,2,2,16942,5143780,5578905,4581,2857488,3013703
1994-09-03,1994,338,N,2,2,17703,5161483,5578905,5314,2862802,3013703
1994-09-04,1994,339,N,2,2,18091,5179574,5578905,4980,2867782,3013703
1994-09-05,1994,340,N,2,2,18208,5197782,5578905,3839,2871621,3013703
1994-09-06,1994,341,N,2,2,17675,5215457,5578905,2970,2874591,3013703
1994-09-07,1994,342,N,2,2,17086,5232543,5578905,3182,2877773,3013703
1994-09-08,1994,343,N,2,2,16872,5249415,5578905,4503,2882276,3013703
1994-09-09,1994,344,N,2,2,17439,5266854,5578905,4621,2886897,3013703
1994-09-10,1994,345,N,2,2,16932,5283786,5578905,4391,2891288,3013703
1994-09-11,1994,346,N,2,2,16899,5300685,5578905,3602,2894890,3013703
1994-09-12,1994,347,N,2,2,16808,5317493,5578905,3991,2898881,3013703
1994-09-13,1994,348,N,2,2,16447,5333940,5578905,3890,2902771,3013703
1994-09-14,1994,349,N,2,2,16778,5350718,5578905,4534,2907305,3013703
1994-09-15,1994,350,N,2,2,16244,5366962,5578905,4175,2911480,3013703
1994-09-16,1994,351,N,2,2,15881,5382843,5578905,4773,2916253,3013703
1994-09-17,1994,352,N,2,2,15627,5398470,5578905,6037,2922290,3013703
1994-09-18,1994,353,N,2,2,16006,5414476,5578905,6667,2928957,3013703
1994-09-19,1994,354,N,2,2,15110,5429586,5578905,6411,2935368,3013703
1994-09-20,1994,355,N,2,2,14200,5443786,5578905,7341,2942709,3013703
1994-09-21,1994,356,N,2,2,13818,5457604,5578905,9393,2952102,3013703
1994-09-22,1994,357,N,2,2,13834,5471438,5578905,10181,2962283,3013703
1994-09-23,1994,358,N,2,2,14064,5485502,5578905,10395,2972678,3013703
1994-09-24,1994,359,N,2,2,13359,5498861,5578905,9734,2982412,3013703
1994-09-25,1994,360,N,2,2,13597,5512458,5578905,10044,2992456,3013703
1994-09-26,1994,361,N,2,2,13337,5525795,5578905,5666,2998122,3013703
1994-09-27,1994,362,N,2,2,13453,5539248,5578905,5076,3003198,3013703
1994-09-28,1994,363,N,2,2,13525,5552773,5578905,4060,3007258,3013703
1994-09-29,1994,364,N,2,2,13249,5566022,5578905,3359,3010617,3013703
1994-09-30,1994,365,N,2,2,12883,5578905,5578905,3086,3013703,3013703
1994-10-01,1995,1,W,1,1,12151,12151,23845293,2980,2980,21074140
1994-10-02,1995,2,W,1,1,11580,23731,23845293,2584,5564,21074140
1994-10-03,1995,3,W,1,1,10776,34507,23845293,2629,8193,21074140
1994-10-04,1995,4,W,1,1,11182,45689,23845293,3493,11686,21074140
1994-10-05,1995,5,W,1,1,11838,57527,23845293,7905,19591,21074140
1994-10-06,1995,6,W,1,1,11075,68602,23845293,6119,25710,21074140
1994-10-07,1995,7,W,1,1,10854,79456,23845293,6392,32102,21074140
1994-10-08,1995,8,W,1,1,10584,90040,23845293,6329,38431,21074140
1994-10-09,1995,9,W,1,1,10264,100304,23845293,6624,45055,21074140
1994-10-10,1995,10,W,1,1,10020,110324,23845293,2074,47129,21074140
1994-10-11,1995,11,W,1,1,10591,120915,23845293,2992,50121,21074140
1994-10-12,1995,12,W,1,1,10024,130939,23845293,1396,51517,21074140
1994-10-13,1995,13,W,1,1,9903,140842,23845293,1733,53250,21074140
1994-10-14,1995,14,W,1,1,9233,150075,23845293,1321,54571,21074140
1994-10-15,1995,15,W,1,1,9110,159185,23845293,1984,56555,21074140
1994-10-16,1995,16,W,1,1,8947,168132,23845293,496,57051,21074140
1994-10-17,1995,17,W,1,1,9390,177522,23845293,1562,58613,21074140
1994-10-18,1995,18,W,1,1,9471,186993,23845293,1948,60561,21074140
1994-10-19,1995,19,W,1,1,9413,196406,23845293,2426,62987,21074140
1994-10-20,1995,20,W,1,1,9931,206337,23845293,2860,65847,21074140
1994-10-21,1995,21,W,1,1,9385,215722,23845293,1945,67792,21074140
1994-10-22,1995,22,W,1,1,8847,224569,23845293,2286,70078,21074140
1994-10-23,1995,23,W,1,1,8584,233153,23845293,2303,72381,21074140
1994-10-24,1995,24,W,1,1,8674,241827,23845293,3479,75860,21074140
1994-10-25,1995,25,W,1,1,8767,250594,23845293,4462,80322,21074140
1994-10-26,1995,26,W,1,1,9461,260055,23845293,4420,84742,21074140
1994-10-27,1995,27,W,1,1,9435,269490,23845293,3093,87835,21074140
1994-10-28,1995,28,W,1,1,9727,279217,23845293,3446,91281,21074140
1994-10-29,1995,29,W,1,1,9205,288422,23845293,2763,94044,21074140
1994-10-30,1995,30,W,1,1,9244,297666,23845293,3228,97272,21074140
1994-10-31,1995,31,W,1,1,8707,306373,23845293,2461,99733,21074140
1994-11-01,1995,32,W,1,1,9099,315472,23845293,3989,103722,21074140
1994-11-02,1995,33,W,1,1,9406,324878,23845293,4476,108198,21074140
1994-11-03,1995,34,W,1,1,8864,333742,23845293,1946,110144,21074140
1994-11-04,1995,35,W,1,1,9426,343168,23845293,3003,113147,21074140
1994-11-05,1995,36,W,1,1,9810,352978,23845293,3888,117035,21074140
1994-11-06,1995,37,W,1,1,12157,365135,23845293,8978,126013,21074140
1994-11-07,1995,38,W,1,1,12455,377590,23845293,6979,132992,21074140
1994-11-08,1995,39,W,1,1,12910,390500,23845293,7838,140830,21074140
1994-11-09,1995,40,W,1,1,12692,403192,23845293,6216,147046,21074140
1994-11-10,1995,41,W,1,1,13551,416743,23845293,10658,157704,21074140
1994-11-11,1995,42,W,1,1,13257,430000,23845293,9590,167294,21074140
1994-11-12,1995,43,W,1,1,13592,443592,23845293,7911,175205,21074140
1994-11-13,1995,44,W,1,1,13376,456968,23845293,8495,183700,21074140
1994-11-14,1995,45,W,1,1,12479,469447,23845293,7630,191330,21074140
1994-11-15,1995,46,W,1,1,11485,480932,23845293,2274,193604,21074140
1994-11-16,1995,47,W,1,1,11567,492499,23845293,7070,200674,21074140
1994-11-17,1995,48,W,1,1,10887,503386,23845293,5861,206535,21074140
1994-11-18,1995,49,W,1,1,11416,514802,23845293,5935,212470,21074140
1994-11-19,1995,50,W,1,1,10507,525309,23845293,4208,216678,21074140
1994-11-20,1995,51,W,1,1,10300,535609,23845293,4509,221187,21074140
1994-11-21,1995,52,W,1,1,9991,545600,23845293,2143,223330,21074140
1994-11-22,1995,53,W,1,1,9812,555412,23845293,2862,226192,21074140
1994-11-23,1995,54,W,1,1,9569,564981,23845293,2201,228393,21074140
1994-11-24,1995,55,W,1,1,9566,574547,23845293,1900,230293,21074140
1994-11-25,1995,56,W,1,1,10194,584741,23845293,4014,234307,21074140
1994-11-26,1995,57,W,1,1,11426,596167,23845293,7024,241331,21074140
1994-11-27,1995,58,W,1,1,11342,607509,23845293,6510,247841,21074140
1994-11-28,1995,59,W,1,1,10954,618463,23845293,4946,252787,21074140
1994-11-29,1995,60,W,1,1,10678,629141,23845293,5232,258019,21074140
1994-11-30,1995,61,W,1,1,10163,639304,23845293,2399,260418,21074140
1994-12-01,1995,62,W,1,1,9910,649214,23845293,2155,262573,21074140
1994-12-02,1995,63,W,1,1,10130,659344,23845293,4865,267438,21074140
1994-12-03,1995,64,W,1,1,11487,670831,23845293,8891,276329,21074140
1994-12-04,1995,65,W,1,1,17826,688657,23845293,16839,293168,21074140
1994-12-05,1995,66,W,1,1,30652,719309,23845293,29781,322949,21074140
1994-12-06,1995,67,W,1,1,36539,755848,23845293,34696,357645,21074140
1994-12-07,1995,68,W,1,1,30329,786177,23845293,24159,381804,21074140
1994-12-08,1995,69,W,1,1,24056,810233,23845293,12823,394627,21074140
1994-12-09,1995,70,W,1,1,20403,830636,23845293,8470,403097,21074140
1994-12-10,1995,71,W,1,1,17684,848320,23845293,6566,409663,21074140
1994-12-11,1995,72,W,1,1,16258,864578,23845293,8177,417840,21074140
1994-12-12,1995,73,W,1,1,15598,880176,23845293,10040,427880,21074140
1994-12-13,1995,74,W,1,1,16035,896211,23845293,10953,438833,21074140
1994-12-14,1995,75,W,1,1,16263,912474,23845293,9207,448040,21074140
1994-12-15,1995,76,W,1,1,19450,931924,23845293,10646,458686,21074140
1994-12-16,1995,77,W,1,1,21732,953656,23845293,12612,471298,21074140
1994-12-17,1995,78,W,1,1,22110,975766,23845293,12870,484168,21074140
1994-12-18,1995,79,W,1,1,20289,996055,23845293,12646,496814,21074140
1994-12-19,1995,80,W,1,1,18978,1015033,23845293,11498,508312,21074140
1994-12-20,1995,81,W,1,1,17163,1032196,23845293,8215,516527,21074140
1994-12-21,1995,82,W,1,1,16760,1048956,23845293,8363,524890,21074140
1994-12-22,1995,83,W,1,1,15750,1064706,23845293,5353,530243,21074140
1994-12-23,1995,84,W,1,1,14850,1079556,23845293,2109,532352,21074140
1994-12-24,1995,85,W,1,1,14507,1094063,23845293,2072,534424,21074140
1994-12-25,1995,86,W,1,1,15036,1109099,23845293,3798,538222,21074140
1994-12-26,1995,87,W,1,1,15153,1124252,23845293,4045,542267,21074140
1994-12-27,1995,88,W,1,1,15091,1139343,23845293,3263,545530,21074140
1994-12-28,1995,89,W,1,1,14519,1153862,23845293,2408,547938,21074140
1994-12-29,1995,90,W,1,1,14546,1168408,23845293,2348,550286,21074140
1994-12-30,1995,91,W,1,1,16481,1184889,23845293,3905,554191,21074140
1994-12-31,1995,92,W,1,1,17169,1202058,23845293,4741,558932,21074140
1995-01-01,1995,93,W,1,1,16050,1218108,23845293,4643,563575,21074140
1995-01-02,1995,94,W,1,1,15236,1233344,23845293,3758,567333,21074140
1995-01-03,1995,95,W,1,1,15198,1248542,23845293,7813,575146,21074140
1995-01-04,1995,96,W,1,1,17137,1265679,23845293,10433,585579,21074140
1995-01-05,1995,97,W,1,1,23236,1288915,23845293,21513,607092,21074140
1995-01-06,1995,98,W,1,1,32512,1321427,23845293,29887,636979,21074140
1995-01-07,1995,99,W,1,1,35883,1357310,23845293,33576,670555,21074140
1995-01-08,1995,100,W,1,1,41227,1398537,23845293,35043,705598,21074140
1995-01-09,1995,101,W,1,1,65540,1464077,23845293,59207,764805,21074140
1995-01-10,1995,102,W,1,1,107833,1571910,23845293,105822,870627,21074140
1995-01-11,1995,103,W,1,1,185993,1757903,23845293,185421,1056048,21074140
1995-01-12,1995,104,W,1,1,248563,2006466,23845293,247920,1303968,21074140
1995-01-13,1995,105,W,1,1,230019,2236485,23845293,229518,1533486,21074140
1995-01-14,1995,106,W,1,1,222252,2458737,23845293,223738,1757224,21074140
1995-01-15,1995,107,W,1,1,215465,2674202,23845293,209973,1967197,21074140
1995-01-16,1995,108,W,1,1,194406,2868608,23845293,188149,2155346,21074140
1995-01-17,1995,109,W,1,1,168457,3037065,23845293,160933,2316279,21074140
1995-01-18,1995,110,W,1,1,139628,3176693,23845293,131175,2447454,21074140
1995-01-19,1995,111,W,1,1,117987,3294680,23845293,107509,2554963,21074140
1995-01-20,1995,112,W,1,1,104572,3399252,23845293,92229,2647192,21074140
1995-01-21,1995,113,W,1,1,96783,3496035,23845293,83928,2731120,21074140
1995-01-22,1995,114,W,1,1,94117,3590152,23845293,82482,2813602,21074140
1995-01-23,1995,115,W,1,1,97183,3687335,23845293,88521,2902123,21074140
1995-01-24,1995,116,W,1,1,99457,3786792,23845293,93729,2995852,21074140
1995-01-25,1995,117,W,1,1,109129,3895921,23845293,106520,3102372,21074140
1995-01-26,1995,118,W,1,1,118447,4014368,23845293,115383,3217755,21074140
1995-01-27,1995,119,W,1,1,131651,4146019,23845293,134901,3352656,21074140
1995-01-28,1995,120,W,1,1,149954,4295973,23845293,153100,3505756,21074140
1995-01-29,1995,121,W,1,1,139455,4435428,23845293,139289,3645045,21074140
1995-01-30,1995,122,W,1,1,126577,4562005,23845293,123109,3768154,21074140
1995-01-31,1995,123,W,1,1,126321,4688326,23845293,122890,3891044,21074140
1995-02-01,1995,124,W,1,1,121249,4809575,23845293,110075,4001119,21074140
1995-02-02,1995,125,W,1,1,120270,4929845,23845293,107499,4108618,21074140
1995-02-03,1995,126,W,1,1,129575,5059420,23845293,116485,4225103,21074140
1995-02-04,1995,127,W,1,1,132853,5192273,23845293,120077,4345180,21074140
1995-02-05,1995,128,W,1,1,129176,5321449,23845293,116047,4461227,21074140
1995-02-06,1995,129,W,1,1,121010,5442459,23845293,108082,4569309,21074140
1995-02-07,1995,130,W,1,1,112440,5554899,23845293,102013,4671322,21074140
1995-02-08,1995,131,W,1,1,106566,5661465,23845293,97464,4768786,21074140
1995-02-09,1995,132,W,1,1,101412,5762877,23845293,92531,4861317,21074140
1995-02-10,1995,133,W,1,1,98278,5861155,23845293,89534,4950851,21074140
1995-02-11,1995,134,W,1,1,93702,5954857,23845293,85119,5035970,21074140
1995-02-12,1995,135,W,1,1,89083,6043940,23845293,80860,5116830,21074140
1995-02-13,1995,136,W,1,1,84966,6128906,23845293,75908,5192738,21074140
1995-02-14,1995,137,W,1,1,82009,6210915,23845293,76876,5269614,21074140
1995-02-15,1995,138,W,1,1,78301,6289216,23845293,70829,5340443,21074140
1995-02-16,1995,139,W,1,1,75448,6364664,23845293,67767,5408210,21074140
1995-02-17,1995,140,W,1,1,72666,6437330,23845293,64448,5472658,21074140
1995-02-18,1995,141,W,1,1,68429,6505759,23845293,61017,5533675,21074140
1995-02-19,1995,142,W,1,1,63097,6568856,23845293,51969,5585644,21074140
1995-02-20,1995,143,W,1,1,58256,6627112,23845293,48193,5633837,21074140
1995-02-21,1995,144,W,1,1,53684,6680796,23845293,44005,5677842,21074140
1995-02-22,1995,145,W,1,1,50647,6731443,23845293,41855,5719697,21074140
1995-02-23,1995,146,W,1,1,47025,6778468,23845293,40760,5760457,21074140
1995-02-24,1995,147,W,1,1,45539,6824007,23845293,39536,5799993,21074140
1995-02-25,1995,148,W,1,1,43227,6867234,23845293,35436,5835429,21074140
1995-02-26,1995,149,W,1,1,41516,6908750,23845293,33710,5869139,21074140
1995-02-27,1995,150,W,1,1,40227,6948977,23845293,31536,5900675,21074140
1995-02-28,1995,151,W,1,1,38384,6987361,23845293,29776,5930451,21074140
1995-03-01,1995,152,W,1,1,38098,7025459,23845293,29949,5960400,21074140
1995-03-02,1995,153,W,1,1,38140,7063599,23845293,31143,5991543,21074140
1995-03-03,1995,154,W,1,1,43575,7107174,23845293,42002,6033545,21074140
1995-03-04,1995,155,W,1,1,53780,7160954,23845293,62421,6095966,21074140
1995-03-05,1995,156,W,1,1,59477,7220431,23845293,68413,6164379,21074140
1995-03-06,1995,157,W,1,1,56934,7277365,23845293,65883,6230262,21074140
1995-03-07,1995,158,W,1,1,52233,7329598,23845293,60866,6291128,21074140
1995-03-08,1995,159,W,1,1,50776,7380374,23845293,54223,6345351,21074140
1995-03-09,1995,160,W,1,1,60967,7441341,23845293,57768,6403119,21074140
1995-03-10,1995,161,W,1,1,114213,7555554,23845293,121315,6524434,21074140
1995-03-11,1995,162,W,1,1,224701,7780255,23845293,240712,6765146,21074140
1995-03-12,1995,163,W,1,1,337175,8117430,23845293,355653,7120799,21074140
1995-03-13,1995,164,W,1,1,387177,8504607,23845293,405822,7526621,21074140
1995-03-14,1995,165,W,1,1,369329,8873936,23845293,387594,7914215,21074140
1995-03-15,1995,166,W,1,1,361696,9235632,23845293,371817,8286032,21074140
1995-03-16,1995,167,W,1,1,348846,9584478,23845293,351178,8637210,21074140
1995-03-17,1995,168,W,1,1,332483,9916961,23845293,331447,8968657,21074140
1995-03-18,1995,169,W,1,1,303125,10220086,23845293,301359,9270016,21074140
1995-03-19,1995,170,W,1,1,280408,10500494,23845293,277197,9547213,21074140
1995-03-20,1995,171,W,1,1,266689,10767183,23845293,263226,9810439,21074140
1995-03-21,1995,172,W,1,1,272417,11039600,23845293,272346,10082785,21074140
1995-03-22,1995,173,W,1,1,271175,11310775,23845293,271812,10354597,21074140
1995-03-23,1995,174,W,1,1,291092,11601867,23845293,299126,10653723,21074140
1995-03-24,1995,175,W,1,1,278321,11880188,23845293,287678,10941401,21074140
1995-03-25,1995,176,W,1,1,245209,12125397,23845293,254564,11195965,21074140
1995-03-26,1995,177,W,1,1,214126,12339523,23845293,219982,11415947,21074140
1995-03-27,1995,178,W,1,1,189847,12529370,23845293,193668,11609615,21074140
1995-03-28,1995,179,W,1,1,156040,12685410,23845293,152030,11761645,21074140
1995-03-29,1995,180,W,1,1,142448,12827858,23845293,137858,11899503,21074140
1995-03-30,1995,181,W,1,1,134679,12962537,23845293,130106,12029609,21074140
1995-03-31,1995,182,W,1,1,125434,13087971,23845293,120834,12150443,21074140
1995-04-01,1995,183,W,1,1,118028,13205999,23845293,113348,12263791,21074140
1995-04-02,1995,184,W,1,1,112444,13318443,23845293,107898,12371689,21074140
1995-04-03,1995,185,W,1,1,105750,13424193,23845293,101070,12472759,21074140
1995-04-04,1995,186,W,1,1,98593,13522786,23845293,93837,12566596,21074140
1995-04-05,1995,187,W,1,1,94527,13617313,23845293,89732,12656328,21074140
1995-04-06,1995,188,W,1,1,93562,13710875,23845293,88744,12745072,21074140
1995-04-07,1995,189,W,1,1,91056,13801931,23845293,86639,12831711,21074140
1995-04-08,1995,190,W,1,1,92099,13894030,23845293,88328,12920039,21074140
1995-04-09,1995,191,W,1,1,95379,13989409,23845293,91733,13011772,21074140
1995-04-10,1995,192,W,1,1,99861,14089270,23845293,96182,13107954,21074140
1995-04-11,1995,193,W,1,1,110675,14199945,23845293,107010,13214964,21074140
1995-04-12,1995,194,W,1,1,115550,14315495,23845293,111515,13326479,21074140
1995-04-13,1995,195,W,1,1,116848,14432343,23845293,112358,13438837,21074140
1995-04-14,1995,196,W,1,1,117012,14549355,23845293,108980,13547817,21074140
1995-04-15,1995,197,W,1,1,115023,14664378,23845293,110142,13657959,21074140
1995-04-16,1995,198,W,1,1,113977,14778355,23845293,110246,13768205,21074140
1995-04-17,1995,199,W,1,1,111453,14889808,23845293,107712,13875917,21074140
1995-04-18,1995,200,W,1,1,106640,14996448,23845293,103315,13979232,21074140
1995-04-19,1995,201,W,1,1,100316,15096764,23845293,96989,14076221,21074140
1995-04-20,1995,202,W,1,1,95363,15192127,23845293,92950,14169171,21074140
1995-04-21,1995,203,W,1,1,91432,15283559,23845293,87836,14257007,21074140
1995-04-22,1995,204,W,1,1,86280,15369839,23845293,82739,14339746,21074140
1995-04-23,1995,205,W,1,1,82557,15452396,23845293,77745,14417491,21074140
1995-04-24,1995,206,W,1,1,78177,15530573,23845293,73315,14490806,21074140
1995-04-25,1995,207,W,1,1,73121,15603694,23845293,67187,14557993,21074140
1995-04-26,1995,208,W,1,1,68105,15671799,23845293,62144,14620137,21074140
1995-04-27,1995,209,W,1,1,64535,15736334,23845293,58555,14678692,21074140
1995-04-28,1995,210,W,1,1,62493,15798827,23845293,56916,14735608,21074140
1995-04-29,1995,211,W,1,1,66021,15864848,23845293,61627,14797235,21074140
1995-04-30,1995,212,W,1,1,82764,15947612,23845293,78315,14875550,21074140
1995-05-01,1995,213,W,1,1,93027,16040639,23845293,89951,14965501,21074140
1995-05-02,1995,214,W,1,1,128129,16168768,23845293,125975,15091476,21074140
1995-05-03,1995,215,W,1,1,167534,16336302,23845293,164849,15256325,21074140
1995-05-04,1995,216,W,1,1,176174,16512476,23845293,172462,15428787,21074140
1995-05-05,1995,217,W,1,1,171510,16683986,23845293,167570,15596357,21074140
1995-05-06,1995,218,W,1,1,167976,16851962,23845293,162948,15759305,21074140
1995-05-07,1995,219,W,1,1,152795,17004757,23845293,146408,15905713,21074140
1995-05-08,1995,220,W,1,1,142715,17147472,23845293,136663,16042376,21074140
1995-05-09,1995,221,W,1,1,135747,17283219,23845293,131183,16173559,21074140
1995-05-10,1995,222,W,1,1,127141,17410360,23845293,120718,16294277,21074140
1995-05-11,1995,223,W,1,1,117699,17528059,23845293,110745,16405022,21074140
1995-05-12,1995,224,W,1,1,111070,17639129,23845293,104106,16509128,21074140
1995-05-13,1995,225,W,1,1,105522,17744651,23845293,100217,16609345,21074140
1995-05-14,1995,226,W,1,1,102828,17847479,23845293,97696,16707041,21074140
1995-05-15,1995,227,W,1,1,100520,17947999,23845293,97259,16804300,21074140
1995-05-16,1995,228,W,1,1,97015,18045014,23845293,93632,16897932,21074140
1995-05-17,1995,229,W,1,1,92368,18137382,23845293,88410,16986342,21074140
1995-05-18,1995,230,W,1,1,86504,18223886,23845293,80641,17066983,21074140
1995-05-19,1995,231,W,1,1,81600,18305486,23845293,73443,17140426,21074140
1995-05-20,1995,232,W,1,1,77290,18382776,23845293,68961,17209387,21074140
1995-05-21,1995,233,W,1,1,75219,18457995,23845293,66901,17276288,21074140
1995-05-22,1995,234,W,1,1,71945,18529940,23845293,64436,17340724,21074140
1995-05-23,1995,235,W,1,1,71578,18601518,23845293,65487,17406211,21074140
1995-05-24,1995,236,W,1,1,70244,18671762,23845293,64690,17470901,21074140
1995-05-25,1995,237,W,1,1,68503,18740265,23845293,61588,17532489,21074140
1995-05-26,1995,238,W,1,1,69800,18810065,23845293,62826,17595315,21074140
1995-05-27,1995,239,W,1,1,72247,18882312,23845293,63447,17658762,21074140
1995-05-28,1995,240,W,1,1,72717,18955029,23845293,63758,17722520,21074140
1995-05-29,1995,241,W,1,1,73589,19028618,23845293,64504,17787024,21074140
1995-05-30,1995,242,W,1,1,73479,19102097,23845293,64302,17851326,21074140
1995-05-31,1995,243,W,1,1,72248,19174345,23845293,63696,17915022,21074140
1995-06-01,1995,244,W,1,1,71650,19245995,23845293,62645,17977667,21074140
1995-06-02,1995,245,W,1,1,71521,19317516,23845293,61987,18039654,21074140
1995-06-03,1995,246,W,1,1,70870,19388386,23845293,57131,18096785,21074140
1995-06-04,1995,247,W,1,1,69292,19457678,23845293,55477,18152262,21074140
1995-06-05,1995,248,W,1,1,68688,19526366,23845293,57112,18209374,21074140
1995-06-06,1995,249,W,1,1,68782,19595148,23845293,57793,18267167,21074140
1995-06-07,1995,250,W,1,1,66984,19662132,23845293,54984,18322151,21074140
1995-06-08,1995,251,W,1,1,64228,19726360,23845293,52282,18374433,21074140
1995-06-09,1995,252,W,1,1,61734,19788094,23845293,50308,18424741,21074140
1995-06-10,1995,253,W,1,1,60308,19848402,23845293,48760,18473501,21074140
1995-06-11,1995,254,W,1,1,57134,19905536,23845293,50336,18523837,21074140
1995-06-12,1995,255,W,1,1,54993,19960529,23845293,48168,18572005,21074140
1995-06-13,1995,256,W,1,1,53905,20014434,23845293,46737,18618742,21074140
1995-06-14,1995,257,W,1,1,52780,20067214,23845293,40194,18658936,21074140
1995-06-15,1995,258,W,1,1,55679,20122893,23845293,42102,18701038,21074140
1995-06-16,1995,259,W,1,1,54358,20177251,23845293,44536,18745574,21074140
1995-06-17,1995,260,W,1,1,58499,20235750,23845293,49400,18794974,21074140
1995-06-18,1995,261,W,1,1,61071,20296821,23845293,51860,18846834,21074140
1995-06-19,1995,262,W,1,1,59537,20356358,23845293,51365,18898199,21074140
1995-06-20,1995,263,W,1,1,58127,20414485,23845293,47999,18946198,21074140
1995-06-21,1995,264,W,1,1,56638,20471123,23845293,44900,18991098,21074140
1995-06-22,1995,265,W,1,1,53774,20524897,23845293,42763,19033861,21074140
1995-06-23,1995,266,W,1,1,52469,20577366,23845293,42399,19076260,21074140
1995-06-24,1995,267,W,1,1,48805,20626171,23845293,38410,19114670,21074140
1995-06-25,1995,268,W,1,1,47018,20673189,23845293,33937,19148607,21074140
1995-06-26,1995,269,W,1,1,45520,20718709,23845293,33130,19181737,21074140
1995-06-27,1995,270,W,1,1,45900,20764609,23845293,33024,19214761,21074140
1995-06-28,1995,271,W,1,1,47844,20812453,23845293,34341,19249102,21074140
1995-06-29,1995,272,W,1,1,48339,20860792,23845293,34800,19283902,21074140
1995-06-30,1995,273,W,1,1,47411,20908203,23845293,33741,19317643,21074140
1995-07-01,1995,274,W,1,1,47187,20955390,23845293,32337,19349980,21074140
1995-07-02,1995,275,W,1,1,45487,21000877,23845293,31327,19381307,21074140
1995-07-03,1995,276,W,1,1,44661,21045538,23845293,31684,19412991,21074140
1995-07-04,1995,277,W,1,1,43573,21089111,23845293,30016,19443007,21074140
1995-07-05,1995,278,W,1,1,42502,21131613,23845293,29279,19472286,21074140
1995-07-06,1995,279,W,1,1,42888,21174501,23845293,29472,19501758,21074140
1995-07-07,1995,280,W,1,1,42750,21217251,23845293,28887,19530645,21074140
1995-07-08,1995,281,W,1,1,40980,21258231,23845293,24705,19555350,21074140
1995-07-09,1995,282,W,1,1,39777,21298008,23845293,24074,19579424,21074140
1995-07-10,1995,283,W,1,1,41762,21339770,23845293,27091,19606515,21074140
1995-07-11,1995,284,W,1,1,43967,21383737,23845293,28611,19635126,21074140
1995-07-12,1995,285,W,1,1,45599,21429336,23845293,29565,19664691,21074140
1995-07-13,1995,286,W,1,1,44758,21474094,23845293,28958,19693649,21074140
1995-07-14,1995,287,W,1,1,44758,21518852,23845293,29247,19722896,21074140
1995-07-15,1995,288,W,1,1,44129,21562981,23845293,28404,19751300,21074140
1995-07-16,1995,289,W,1,1,41927,21604908,23845293,26112,19777412,21074140
1995-07-17,1995,290,W,1,1,46827,21651735,23845293,31058,19808470,21074140
1995-07-18,1995,291,W,1,1,63070,21714805,23845293,47226,19855696,21074140
1995-07-19,1995,292,W,1,1,59797,21774602,23845293,45318,19901014,21074140
1995-07-20,1995,293,W,1,1,52868,21827470,23845293,37085,19938099,21074140
1995-07-21,1995,294,W,1,1,46947,21874417,23845293,31326,19969425,21074140
1995-07-22,1995,295,W,1,1,42922,21917339,23845293,27422,19996847,21074140
1995-07-23,1995,296,W,1,1,39708,21957047,23845293,23946,20020793,21074140
1995-07-24,1995,297,W,1,1,37769,21994816,23845293,22060,20042853,21074140
1995-07-25,1995,298,W,1,1,34141,22028957,23845293,18399,20061252,21074140
1995-07-26,1995,299,W,1,1,32347,22061304,23845293,17240,20078492,21074140
1995-07-27,1995,300,W,1,1,30316,22091620,23845293,14820,20093312,21074140
1995-07-28,1995,301,W,1,1,29125,22120745,23845293,14957,20108269,21074140
1995-07-29,1995,302,W,1,1,28002,22148747,23845293,13373,20121642,21074140
1995-07-30,1995,303,W,1,1,28307,22177054,23845293,12784,20134426,21074140
1995-07-31,1995,304,W,1,1,27415,22204469,23845293,13683,20148109,21074140
1995-08-01,1995,305,W,1,1,27183,22231652,23845293,14622,20162731,21074140
1995-08-02,1995,306,W,1,1,28170,22259822,23845293,15870,20178601,21074140
1995-08-03,1995,307,W,1,1,26777,22286599,23845293,13625,20192226,21074140
1995-08-04,1995,308,W,1,1,26817,22313416,23845293,13873,20206099,21074140
1995-08-05,1995,309,W,1,1,27275,22340691,23845293,12430,20218529,21074140
1995-08-06,1995,310,W,1,1,25382,22366073,23845293,9841,20228370,21074140
1995-08-07,1995,311,W,1,1,23395,22389468,23845293,9299,20237669,21074140
1995-08-08,1995,312,W,1,1,23072,22412540,23845293,9339,20247008,21074140
1995-08-09,1995,313,W,1,1,23915,22436455,23845293,9746,20256754,21074140
1995-08-10,1995,314,W,1,1,22578,22459033,23845293,9093,20265847,21074140
1995-08-11,1995,315,W,1,1,23826,22482859,23845293,9568,20275415,21074140
1995-08-12,1995,316,W,1,1,23397,22506256,23845293,8371,20283786,21074140
1995-08-13,1995,317,W,1,1,23165,22529421,23845293,7909,20291695,21074140
1995-08-14,1995,318,W,1,1,21304,22550725,23845293,7163,20298858,21074140
1995-08-15,1995,319,W,1,1,21607,22572332,23845293,8622,20307480,21074140
1995-08-16,1995,320,W,1,1,21562,22593894,23845293,8783,20316263,21074140
1995-08-17,1995,321,W,1,1,24533,22618427,23845293,12046,20328309,21074140
1995-08-18,1995,322,W,1,1,22920,22641347,23845293,10466,20338775,21074140
1995-08-19,1995,323,W,1,1,22627,22663974,23845293,7967,20346742,21074140
1995-08-20,1995,324,W,1,1,23561,22687535,23845293,10508,20357250,21074140
1995-08-21,1995,325,W,1,1,22441,22709976,23845293,13055,20370305,21074140
1995-08-22,1995,326,W,1,1,23188,22733164,23845293,13344,20383649,21074140
1995-08-23,1995,327,W,1,1,23146,22756310,23845293,11972,20395621,21074140
1995-08-24,1995,328,W,1,1,24335,22780645,23845293,11143,20406764,21074140
1995-08-25,1995,329,W,1,1,24091,22804736,23845293,9467,20416231,21074140
1995-08-26,1995,330,W,1,1,24321,22829057,23845293,9556,20425787,21074140
1995-08-27,1995,331,W,1,1,24480,22853537,23845293,9665,20435452,21074140
1995-08-28,1995,332,W,1,1,23759,22877296,23845293,10995,20446447,21074140
1995-08-29,1995,333,W,1,1,24280,22901576,23845293,11433,20457880,21074140
1995-08-30,1995,334,W,1,1,24951,22926527,23845293,12254,20470134,21074140
1995-08-31,1995,335,W,1,1,25822,22952349,23845293,15124,20485258,21074140
1995-09-01,1995,336,W,1,1,26185,22978534,23845293,15736,20500994,21074140
1995-09-02,1995,337,W,1,1,26838,23005372,23845293,15849,20516843,21074140
1995-09-03,1995,338,W,1,1,27161,23032533,23845293,13504,20530347,21074140
1995-09-04,1995,339,W,1,1,27093,23059626,23845293,13366,20543713,21074140
1995-09-05,1995,340,W,1,1,27011,23086637,23845293,14764,20558477,21074140
1995-09-06,1995,341,W,1,1,26897,23113534,23845293,15678,20574155,21074140
1995-09-07,1995,342,W,1,1,27313,23140847,23845293,15792,20589947,21074140
1995-09-08,1995,343,W,1,1,27279,23168126,23845293,15802,20605749,21074140
1995-09-09,1995,344,W,1,1,28271,23196397,23845293,16662,20622411,21074140
1995-09-10,1995,345,W,1,1,29215,23225612,23845293,18496,20640907,21074140
1995-09-11,1995,346,W,1,1,29112,23254724,23845293,18451,20659358,21074140
1995-09-12,1995,347,W,1,1,29448,23284172,23845293,20559,20679917,21074140
1995-09-13,1995,348,W,1,1,29760,23313932,23845293,20698,20700615,21074140
1995-09-14,1995,349,W,1,1,30471,23344403,23845293,22562,20723177,21074140
1995-09-15,1995,350,W,1,1,30580,23374983,23845293,21994,20745171,21074140
1995-09-16,1995,351,W,1,1,30617,23405600,23845293,21705,20766876,21074140
1995-09-17,1995,352,W,1,1,31598,23437198,23845293,21390,20788266,21074140
1995-09-18,1995,353,W,1,1,31909,23469107,23845293,22083,20810349,21074140
1995-09-19,1995,354,W,1,1,31693,23500800,23845293,22749,20833098,21074140
1995-09-20,1995,355,W,1,1,31535,23532335,23845293,23434,20856532,21074140
1995-09-21,1995,356,W,1,1,31069,23563404,23845293,21828,20878360,21074140
1995-09-22,1995,357,W,1,1,31472,23594876,23845293,22123,20900483,21074140
1995-09-23,1995,358,W,1,1,32254,23627130,23845293,24134,20924617,21074140
1995-09-24,1995,359,W,1,1,32425,23659555,23845293,21777,20946394,21074140
1995-09-25,1995,360,W,1,1,32416,23691971,23845293,22795,20969189,21074140
1995-09-26,1995,361,W,1,1,31214,23723185,23845293,21377,20990566,21074140
1995-09-27,1995,362,W,1,1,30766,23753951,23845293,20970,21011536,21074140
1995-09-28,1995,363,W,1,1,30751,23784702,23845293,20555,21032091,21074140
1995-09-29,1995,364,W,1,1,30255,23814957,23845293,20850,21052941,21074140
1995-09-30,1995,365,W,1,1,30336,23845293,23845293,21199,21074140,21074140
1995-10-01,1996,1,W,2,2,30853,30853,15853123,22079,22079,12849206
1995-10-02,1996,2,W,2,2,31308,62161,15853123,21897,43976,12849206
1995-10-03,1996,3,W,2,2,30793,92954,15853123,22029,66005,12849206
1995-10-04,1996,4,W,2,2,29735,122689,15853123,20547,86552,12849206
1995-10-05,1996,5,W,2,2,28331,151020,15853123,19698,106250,12849206
1995-10-06,1996,6,W,2,2,27173,178193,15853123,18379,124629,12849206
1995-10-07,1996,7,W,2,2,25510,203703,15853123,16913,141542,12849206
1995-10-08,1996,8,W,2,2,23713,227416,15853123,14589,156131,12849206
1995-10-09,1996,9,W,2,2,22027,249443,15853123,12990,169121,12849206
1995-10-10,1996,10,W,2,2,20602,270045,15853123,11947,181068,12849206
1995-10-11,1996,11,W,2,2,19659,289704,15853123,11132,192200,12849206
1995-10-12,1996,12,W,2,2,20166,309870,15853123,12003,204203,12849206
1995-10-13,1996,13,W,2,2,19453,329323,15853123,11140,215343,12849206
1995-10-14,1996,14,W,2,2,19307,348630,15853123,11372,226715,12849206
1995-10-15,1996,15,W,2,2,19187,367817,15853123,10478,237193,12849206
1995-10-16,1996,16,W,2,2,20256,388073,15853123,11202,248395,12849206
1995-10-17,1996,17,W,2,2,19751,407824,15853123,11682,260077,12849206
1995-10-18,1996,18,W,2,2,19205,427029,15853123,11445,271522,12849206
1995-10-19,1996,19,W,2,2,18424,445453,15853123,10671,282193,12849206
1995-10-20,1996,20,W,2,2,17692,463145,15853123,10687,292880,12849206
1995-10-21,1996,21,W,2,2,17165,480310,15853123,9697,302577,12849206
1995-10-22,1996,22,W,2,2,16801,497111,15853123,9027,311604,12849206
1995-10-23,1996,23,W,2,2,16319,513430,15853123,8641,320245,12849206
1995-10-24,1996,24,W,2,2,16059,529489,15853123,7649,327894,12849206
1995-10-25,1996,25,W,2,2,15526,545015,15853123,4752,332646,12849206
1995-10-26,1996,26,W,2,2,15699,560714,15853123,3725,336371,12849206
1995-10-27,1996,27,W,2,2,15741,576455,15853123,2927,339298,12849206
1995-10-28,1996,28,W,2,2,15992,592447,15853123,3339,342637,12849206
1995-10-29,1996,29,W,2,2,16185,608632,15853123,2542,345179,12849206
1995-10-30,1996,30,W,2,2,16026,624658,15853123,3669,348848,12849206
1995-10-31,1996,31,W,2,2,16473,641131,15853123,3664,352512,12849206
1995-11-01,1996,32,W,2,2,16447,657578,15853123,4781,357293,12849206
1995-11-02,1996,33,W,2,2,15895,673473,15853123,4584,361877,12849206
1995-11-03,1996,34,W,2,2,15567,689040,15853123,3435,365312,12849206
1995-11-04,1996,35,W,2,2,14882,703922,15853123,2794,368106,12849206
1995-11-05,1996,36,W,2,2,14569,718491,15853123,2472,370578,12849206
1995-11-06,1996,37,W,2,2,15254,733745,15853123,4107,374685,12849206
1995-11-07,1996,38,W,2,2,15630,749375,15853123,8642,383327,12849206
1995-11-08,1996,39,W,2,2,15764,765139,15853123,11087,394414,12849206
1995-11-09,1996,40,W,2,2,16041,781180,15853123,10690,405104,12849206
1995-11-10,1996,41,W,2,2,16493,797673,15853123,10343,415447,12849206
1995-11-11,1996,42,W,2,2,16428,814101,15853123,10202,425649,12849206
1995-11-12,1996,43,W,2,2,16165,830266,15853123,9913,435562,12849206
1995-11-13,1996,44,W,2,2,15928,846194,15853123,9737,445299,12849206
1995-11-14,1996,45,W,2,2,15749,861943,15853123,9508,454807,12849206
1995-11-15,1996,46,W,2,2,16072,878015,15853123,9798,464605,12849206
1995-11-16,1996,47,W,2,2,16243,894258,15853123,9994,474599,12849206
1995-11-17,1996,48,W,2,2,15930,910188,15853123,9722,484321,12849206
1995-11-18,1996,49,W,2,2,15825,926013,15853123,9581,493902,12849206
1995-11-19,1996,50,W,2,2,16025,942038,15853123,9427,503329,12849206
1995-11-20,1996,51,W,2,2,16025,958063,15853123,9394,512723,12849206
1995-11-21,1996,52,W,2,2,15979,974042,15853123,9339,522062,12849206
1995-11-22,1996,53,W,2,2,16076,990118,15853123,9872,531934,12849206
1995-11-23,1996,54,W,2,2,15976,1006094,15853123,9746,541680,12849206
1995-11-24,1996,55,W,2,2,15876,1021970,15853123,9666,551346,12849206
1995-11-25,1996,56,W,2,2,14962,1036932,15853123,8668,560014,12849206
1995-11-26,1996,57,W,2,2,15558,1052490,15853123,8821,568835,12849206
1995-11-27,1996,58,W,2,2,15261,1067751,15853123,8924,577759,12849206
1995-11-28,1996,59,W,2,2,15056,1082807,15853123,8639,586398,12849206
1995-11-29,1996,60,W,2,2,15147,1097954,15853123,8723,595121,12849206
1995-11-30,1996,61,W,2,2,15355,1113309,15853123,8892,604013,12849206
1995-12-01,1996,62,W,2,2,15621,1128930,15853123,9067,613080,12849206
1995-12-02,1996,63,W,2,2,15836,1144766,15853123,9327,622407,12849206
1995-12-03,1996,64,W,2,2,15795,1160561,15853123,9291,631698,12849206
1995-12-04,1996,65,W,2,2,15484,1176045,15853123,8875,640573,12849206
1995-12-05,1996,66,W,2,2,14974,1191019,15853123,8322,648895,12849206
1995-12-06,1996,67,W,2,2,15375,1206394,15853123,8743,657638,12849206
1995-12-07,1996,68,W,2,2,15755,1222149,15853123,9062,666700,12849206
1995-12-08,1996,69,W,2,2,15862,1238011,15853123,9224,675924,12849206
1995-12-09,1996,70,W,2,2,16047,1254058,15853123,9394,685318,12849206
1995-12-10,1996,71,W,2,2,15824,1269882,15853123,9150,694468,12849206
1995-12-11,1996,72,W,2,2,17695,1287577,15853123,16146,710614,12849206
1995-12-12,1996,73,W,2,2,21824,1309401,15853123,30515,741129,12849206
1995-12-13,1996,74,W,2,2,31575,1340976,15853123,44343,785472,12849206
1995-12-14,1996,75,W,2,2,46326,1387302,15853123,66724,852196,12849206
1995-12-15,1996,76,W,2,2,50089,1437391,15853123,71595,923791,12849206
1995-12-16,1996,77,W,2,2,49313,1486704,15853123,65840,989631,12849206
1995-12-17,1996,78,W,2,2,51739,1538443,15853123,58042,1047673,12849206
1995-12-18,1996,79,W,2,2,52266,1590709,15853123,56568,1104241,12849206
1995-12-19,1996,80,W,2,2,49175,1639884,15853123,47475,1151716,12849206
1995-12-20,1996,81,W,2,2,44290,1684174,15853123,41484,1193200,12849206
1995-12-21,1996,82,W,2,2,39469,1723643,15853123,36734,1229934,12849206
1995-12-22,1996,83,W,2,2,35468,1759111,15853123,32753,1262687,12849206
1995-12-23,1996,84,W,2,2,31548,1790659,15853123,28505,1291192,12849206
1995-12-24,1996,85,W,2,2,29126,1819785,15853123,24468,1315660,12849206
1995-12-25,1996,86,W,2,2,27209,1846994,15853123,22466,1338126,12849206
1995-12-26,1996,87,W,2,2,25776,1872770,15853123,21171,1359297,12849206
1995-12-27,1996,88,W,2,2,25174,1897944,15853123,20606,1379903,12849206
1995-12-28,1996,89,W,2,2,24354,1922298,15853123,18480,1398383,12849206
1995-12-29,1996,90,W,2,2,23097,1945395,15853123,17336,1415719,12849206
1995-12-30,1996,91,W,2,2,23504,1968899,15853123,23013,1438732,12849206
1995-12-31,1996,92,W,2,2,25799,1994698,15853123,24261,1462993,12849206
1996-01-01,1996,93,W,2,2,30788,2025486,15853123,30982,1493975,12849206
1996-01-02,1996,94,W,2,2,31008,2056494,15853123,30661,1524636,12849206
1996-01-03,1996,95,W,2,2,28764,2085258,15853123,23615,1548251,12849206
1996-01-04,1996,96,W,2,2,26508,2111766,15853123,14085,1562336,12849206
1996-01-05,1996,97,W,2,2,24603,2136369,15853123,12956,1575292,12849206
1996-01-06,1996,98,W,2,2,23136,2159505,15853123,11302,1586594,12849206
1996-01-07,1996,99,W,2,2,22191,2181696,15853123,10073,1596667,12849206
1996-01-08,1996,100,W,2,2,21553,2203249,15853123,8646,1605313,12849206
1996-01-09,1996,101,W,2,2,20946,2224195,15853123,8748,1614061,12849206
1996-01-10,1996,102,W,2,2,20499,2244694,15853123,9589,1623650,12849206
1996-01-11,1996,103,W,2,2,19996,2264690,15853123,8398,1632048,12849206
1996-01-12,1996,104,W,2,2,19772,2284462,15853123,7275,1639323,12849206
1996-01-13,1996,105,W,2,2,19646,2304108,15853123,10551,1649874,12849206
1996-01-14,1996,106,W,2,2,19131,2323239,15853123,8147,1658021,12849206
1996-01-15,1996,107,W,2,2,18733,2341972,15853123,6652,1664673,12849206
1996-01-16,1996,108,W,2,2,19478,2361450,15853123,7421,1672094,12849206
1996-01-17,1996,109,W,2,2,25090,2386540,15853123,20916,1693010,12849206
1996-01-18,1996,110,W,2,2,36859,2423399,15853123,31647,1724657,12849206
1996-01-19,1996,111,W,2,2,45080,2468479,15853123,40497,1765154,12849206
1996-01-20,1996,112,W,2,2,49765,2518244,15853123,45498,1810652,12849206
1996-01-21,1996,113,W,2,2,53491,2571735,15853123,50746,1861398,12849206
1996-01-22,1996,114,W,2,2,56567,2628302,15853123,48673,1910071,12849206
1996-01-23,1996,115,W,2,2,57283,2685585,15853123,49285,1959356,12849206
1996-01-24,1996,116,W,2,2,57156,2742741,15853123,49684,2009040,12849206
1996-01-25,1996,117,W,2,2,62348,2805089,15853123,57665,2066705,12849206
1996-01-26,1996,118,W,2,2,61619,2866708,15853123,56851,2123556,12849206
1996-01-27,1996,119,W,2,2,62847,2929555,15853123,56878,2180434,12849206
1996-01-28,1996,120,W,2,2,68683,2998238,15853123,65744,2246178,12849206
1996-01-29,1996,121,W,2,2,72501,3070739,15853123,69185,2315363,12849206
1996-01-30,1996,122,W,2,2,74917,3145656,15853123,69284,2384647,12849206
1996-01-31,1996,123,W,2,2,78649,3224305,15853123,74821,2459468,12849206
1996-02-01,1996,124,W,2,2,82896,3307201,15853123,85069,2544537,12849206
1996-02-02,1996,125,W,2,2,80604,3387805,15853123,82474,2627011,12849206
1996-02-03,1996,126,W,2,2,77425,3465230,15853123,79406,2706417,12849206
1996-02-04,1996,127,W,2,2,81991,3547221,15853123,78670,2785087,12849206
1996-02-05,1996,128,W,2,2,111018,3658239,15853123,114309,2899396,12849206
1996-02-06,1996,129,W,2,2,144815,3803054,15853123,146192,3045588,12849206
1996-02-07,1996,130,W,2,2,157827,3960881,15853123,158855,3204443,12849206
1996-02-08,1996,131,W,2,2,152646,4113527,15853123,153267,3357710,12849206
1996-02-09,1996,132,W,2,2,136137,4249664,15853123,134478,3492188,12849206
1996-02-10,1996,133,W,2,2,123456,4373120,15853123,114785,3606973,12849206
1996-02-11,1996,134,W,2,2,111438,4484558,15853123,101509,3708482,12849206
1996-02-12,1996,135,W,2,2,103993,4588551,15853123,97128,3805610,12849206
1996-02-13,1996,136,W,2,2,100801,4689352,15853123,93175,3898785,12849206
1996-02-14,1996,137,W,2,2,98036,4787388,15853123,88790,3987575,12849206
1996-02-15,1996,138,W,2,2,94164,4881552,15853123,85031,4072606,12849206
1996-02-16,1996,139,W,2,2,91889,4973441,15853123,83002,4155608,12849206
1996-02-17,1996,140,W,2,2,93371,5066812,15853123,85996,4241604,12849206
1996-02-18,1996,141,W,2,2,98635,5165447,15853123,91720,4333324,12849206
1996-02-19,1996,142,W,2,2,113624,5279071,15853123,105447,4438771,12849206
1996-02-20,1996,143,W,2,2,139912,5418983,15853123,137365,4576136,12849206
1996-02-21,1996,144,W,2,2,169342,5588325,15853123,167265,4743401,12849206
1996-02-22,1996,145,W,2,2,200568,5788893,15853123,204837,4948238,12849206
1996-02-23,1996,146,W,2,2,207020,5995913,15853123,212184,5160422,12849206
1996-02-24,1996,147,W,2,2,201336,6197249,15853123,206497,5366919,12849206
1996-02-25,1996,148,W,2,2,187367,6384616,15853123,187085,5554004,12849206
1996-02-26,1996,149,W,2,2,170210,6554826,15853123,169070,5723074,12849206
1996-02-27,1996,150,W,2,2,155808,6710634,15853123,150792,5873866,12849206
1996-02-28,1996,151,W,2,2,140398,6851032,15853123,134983,6008849,12849206
1996-02-29,1996,152,W,2,2,134117,6985149,15853123,131081,6139930,12849206
1996-03-01,1996,153,W,2,2,129978,7115127,15853123,126924,6266854,12849206
1996-03-02,1996,154,W,2,2,126481,7241608,15853123,122955,6389809,12849206
1996-03-03,1996,155,W,2,2,124313,7365921,15853123,117818,6507627,12849206
1996-03-04,1996,156,W,2,2,123256,7489177,15853123,119499,6627126,12849206
1996-03-05,1996,157,W,2,2,129922,7619099,15853123,130424,6757550,12849206
1996-03-06,1996,158,W,2,2,125817,7744916,15853123,127930,6885480,12849206
1996-03-07,1996,159,W,2,2,121040,7865956,15853123,123485,7008965,12849206
1996-03-08,1996,160,W,2,2,116713,7982669,15853123,120268,7129233,12849206
1996-03-09,1996,161,W,2,2,111067,8093736,15853123,114206,7243439,12849206
1996-03-10,1996,162,W,2,2,105670,8199406,15853123,105048,7348487,12849206
1996-03-11,1996,163,W,2,2,101362,8300768,15853123,98142,7446629,12849206
1996-03-12,1996,164,W,2,2,104692,8405460,15853123,98603,7545232,12849206
1996-03-13,1996,165,W,2,2,113054,8518514,15853123,115138,7660370,12849206
1996-03-14,1996,166,W,2,2,111222,8629736,15853123,113396,7773766,12849206
1996-03-15,1996,167,W,2,2,105278,8735014,15853123,107178,7880944,12849206
1996-03-16,1996,168,W,2,2,98677,8833691,15853123,100837,7981781,12849206
1996-03-17,1996,169,W,2,2,92942,8926633,15853123,94825,8076606,12849206
1996-03-18,1996,170,W,2,2,89106,9015739,15853123,84434,8161040,12849206
1996-03-19,1996,171,W,2,2,85178,9100917,15853123,81244,8242284,12849206
1996-03-20,1996,172,W,2,2,80880,9181797,15853123,77132,8319416,12849206
1996-03-21,1996,173,W,2,2,76983,9258780,15853123,73114,8392530,12849206
1996-03-22,1996,174,W,2,2,72988,9331768,15853123,69361,8461891,12849206
1996-03-23,1996,175,W,2,2,68820,9400588,15853123,63651,8525542,12849206
1996-03-24,1996,176,W,2,2,63590,9464178,15853123,57212,8582754,12849206
1996-03-25,1996,177,W,2,2,59325,9523503,15853123,55649,8638403,12849206
1996-03-26,1996,178,W,2,2,55532,9579035,15853123,49629,8688032,12849206
1996-03-27,1996,179,W,2,2,52817,9631852,15853123,47238,8735270,12849206
1996-03-28,1996,180,W,2,2,51390,9683242,15853123,43872,8779142,12849206
1996-03-29,1996,181,W,2,2,50508,9733750,15853123,43110,8822252,12849206
1996-03-30,1996,182,W,2,2,49838,9783588,15853123,42243,8864495,12849206
1996-03-31,1996,183,W,2,2,47493,9831081,15853123,39017,8903512,12849206
1996-04-01,1996,184,W,2,2,48759,9879840,15853123,39613,8943125,12849206
1996-04-02,1996,185,W,2,2,53462,9933302,15853123,47584,8990709,12849206
1996-04-03,1996,186,W,2,2,62363,9995665,15853123,55705,9046414,12849206
1996-04-04,1996,187,W,2,2,63951,10059616,15853123,57161,9103575,12849206
1996-04-05,1996,188,W,2,2,60139,10119755,15853123,53611,9157186,12849206
1996-04-06,1996,189,W,2,2,55908,10175663,15853123,48883,9206069,12849206
1996-04-07,1996,190,W,2,2,52502,10228165,15853123,43442,9249511,12849206
1996-04-08,1996,191,W,2,2,50214,10278379,15853123,41229,9290740,12849206
1996-04-09,1996,192,W,2,2,48923,10327302,15853123,41223,9331963,12849206
1996-04-10,1996,193,W,2,2,47346,10374648,15853123,39538,9371501,12849206
1996-04-11,1996,194,W,2,2,46309,10420957,15853123,37941,9409442,12849206
1996-04-12,1996,195,W,2,2,45676,10466633,15853123,36166,9445608,12849206
1996-04-13,1996,196,W,2,2,44229,10510862,15853123,32885,9478493,12849206
1996-04-14,1996,197,W,2,2,43684,10554546,15853123,31650,9510143,12849206
1996-04-15,1996,198,W,2,2,42777,10597323,15853123,38209,9548352,12849206
1996-04-16,1996,199,W,2,2,44867,10642190,15853123,41211,9589563,12849206
1996-04-17,1996,200,W,2,2,47689,10689879,15853123,44161,9633724,12849206
1996-04-18,1996,201,W,2,2,51191,10741070,15853123,48351,9682075,12849206
1996-04-19,1996,202,W,2,2,53378,10794448,15853123,50771,9732846,12849206
1996-04-20,1996,203,W,2,2,53616,10848064,15853123,51183,9784029,12849206
1996-04-21,1996,204,W,2,2,51582,10899646,15853123,49271,9833300,12849206
1996-04-22,1996,205,W,2,2,49319,10948965,15853123,46871,9880171,12849206
1996-04-23,1996,206,W,2,2,46060,10995025,15853123,42978,9923149,12849206
1996-04-24,1996,207,W,2,2,42983,11038008,15853123,39648,9962797,12849206
1996-04-25,1996,208,W,2,2,40407,11078415,15853123,36877,9999674,12849206
1996-04-26,1996,209,W,2,2,37977,11116392,15853123,34194,10033868,12849206
1996-04-27,1996,210,W,2,2,37461,11153853,15853123,33699,10067567,12849206
1996-04-28,1996,211,W,2,2,36536,11190389,15853123,32630,10100197,12849206
1996-04-29,1996,212,W,2,2,36366,11226755,15853123,32568,10132765,12849206
1996-04-30,1996,213,W,2,2,35672,11262427,15853123,31719,10164484,12849206
1996-05-01,1996,214,W,2,2,34748,11297175,15853123,30950,10195434,12849206
1996-05-02,1996,215,W,2,2,33745,11330920,15853123,29924,10225358,12849206
1996-05-03,1996,216,W,2,2,33079,11363999,15853123,29036,10254394,12849206
1996-05-04,1996,217,W,2,2,34283,11398282,15853123,30258,10284652,12849206
1996-05-05,1996,218,W,2,2,34636,11432918,15853123,30784,10315436,12849206
1996-05-06,1996,219,W,2,2,33592,11466510,15853123,29528,10344964,12849206
1996-05-07,1996,220,W,2,2,30684,11497194,15853123,26588,10371552,12849206
1996-05-08,1996,221,W,2,2,28455,11525649,15853123,24487,10396039,12849206
1996-05-09,1996,222,W,2,2,27275,11552924,15853123,23299,10419338,12849206
1996-05-10,1996,223,W,2,2,26087,11579011,15853123,21933,10441271,12849206
1996-05-11,1996,224,W,2,2,25057,11604068,15853123,20830,10462101,12849206
1996-05-12,1996,225,W,2,2,24815,11628883,15853123,20428,10482529,12849206
1996-05-13,1996,226,W,2,2,25106,11653989,15853123,20797,10503326,12849206
1996-05-14,1996,227,W,2,2,25231,11679220,15853123,20859,10524185,12849206
1996-05-15,1996,228,W,2,2,26403,11705623,15853123,22106,10546291,12849206
1996-05-16,1996,229,W,2,2,38279,11743902,15853123,41807,10588098,12849206
1996-05-17,1996,230,W,2,2,76449,11820351,15853123,80300,10668398,12849206
1996-05-18,1996,231,W,2,2,88369,11908720,15853123,92189,10760587,12849206
1996-05-19,1996,232,W,2,2,93347,12002067,15853123,97130,10857717,12849206
1996-05-20,1996,233,W,2,2,98021,12100088,15853123,101686,10959403,12849206
1996-05-21,1996,234,W,2,2,94660,12194748,15853123,84754,11044157,12849206
1996-05-22,1996,235,W,2,2,87214,12281962,15853123,76015,11120172,12849206
1996-05-23,1996,236,W,2,2,82185,12364147,15853123,70897,11191069,12849206
1996-05-24,1996,237,W,2,2,79828,12443975,15853123,68553,11259622,12849206
1996-05-25,1996,238,W,2,2,78471,12522446,15853123,65132,11324754,12849206
1996-05-26,1996,239,W,2,2,72861,12595307,15853123,59539,11384293,12849206
1996-05-27,1996,240,W,2,2,66352,12661659,15853123,53003,11437296,12849206
1996-05-28,1996,241,W,2,2,59315,12720974,15853123,45925,11483221,12849206
1996-05-29,1996,242,W,2,2,54305,12775279,15853123,40744,11523965,12849206
1996-05-30,1996,243,W,2,2,49321,12824600,15853123,35764,11559729,12849206
1996-05-31,1996,244,W,2,2,45164,12869764,15853123,31407,11591136,12849206
1996-06-01,1996,245,W,2,2,42378,12912142,15853123,28691,11619827,12849206
1996-06-02,1996,246,W,2,2,39960,12952102,15853123,26045,11645872,12849206
1996-06-03,1996,247,W,2,2,38488,12990590,15853123,24724,11670596,12849206
1996-06-04,1996,248,W,2,2,38197,13028787,15853123,24533,11695129,12849206
1996-06-05,1996,249,W,2,2,36323,13065110,15853123,22219,11717348,12849206
1996-06-06,1996,250,W,2,2,35391,13100501,15853123,20979,11738327,12849206
1996-06-07,1996,251,W,2,2,34284,13134785,15853123,21277,11759604,12849206
1996-06-08,1996,252,W,2,2,33463,13168248,15853123,18579,11778183,12849206
1996-06-09,1996,253,W,2,2,32957,13201205,15853123,18349,11796532,12849206
1996-06-10,1996,254,W,2,2,32543,13233748,15853123,17528,11814060,12849206
1996-06-11,1996,255,W,2,2,31908,13265656,15853123,23049,11837109,12849206
1996-06-12,1996,256,W,2,2,30694,13296350,15853123,22442,11859551,12849206
1996-06-13,1996,257,W,2,2,29015,13325365,15853123,15619,11875170,12849206
1996-06-14,1996,258,W,2,2,28330,13353695,15853123,13145,11888315,12849206
1996-06-15,1996,259,W,2,2,26794,13380489,15853123,11767,11900082,12849206
1996-06-16,1996,260,W,2,2,25101,13405590,15853123,10396,11910478,12849206
1996-06-17,1996,261,W,2,2,25224,13430814,15853123,10663,11921141,12849206
1996-06-18,1996,262,W,2,2,24751,13455565,15853123,9790,11930931,12849206
1996-06-19,1996,263,W,2,2,24468,13480033,15853123,11591,11942522,12849206
1996-06-20,1996,264,W,2,2,23620,13503653,15853123,9702,11952224,12849206
1996-06-21,1996,265,W,2,2,23105,13526758,15853123,8843,11961067,12849206
1996-06-22,1996,266,W,2,2,22723,13549481,15853123,8794,11969861,12849206
1996-06-23,1996,267,W,2,2,22758,13572239,15853123,8851,11978712,12849206
1996-06-24,1996,268,W,2,2,22950,13595189,15853123,9143,11987855,12849206
1996-06-25,1996,269,W,2,2,23388,13618577,15853123,10029,11997884,12849206
1996-06-26,1996,270,W,2,2,22876,13641453,15853123,10884,12008768,12849206
1996-06-27,1996,271,W,2,2,23273,13664726,15853123,8735,12017503,12849206
1996-06-28,1996,272,W,2,2,22750,13687476,15853123,9775,12027278,12849206
1996-06-29,1996,273,W,2,2,22996,13710472,15853123,11063,12038341,12849206
1996-06-30,1996,274,W,2,2,24161,13734633,15853123,10887,12049228,12849206
1996-07-01,1996,275,W,2,2,25016,13759649,15853123,12088,12061316,12849206
1996-07-02,1996,276,W,2,2,25724,13785373,15853123,12020,12073336,12849206
1996-07-03,1996,277,W,2,2,26000,13811373,15853123,12617,12085953,12849206
1996-07-04,1996,278,W,2,2,26253,13837626,15853123,15066,12101019,12849206
1996-07-05,1996,279,W,2,2,26033,13863659,15853123,10530,12111549,12849206
1996-07-06,1996,280,W,2,2,25479,13889138,15853123,10127,12121676,12849206
1996-07-07,1996,281,W,2,2,24365,13913503,15853123,8524,12130200,12849206
1996-07-08,1996,282,W,2,2,24503,13938006,15853123,8712,12138912,12849206
1996-07-09,1996,283,W,2,2,24777,13962783,15853123,9036,12147948,12849206
1996-07-10,1996,284,W,2,2,24564,13987347,15853123,9523,12157471,12849206
1996-07-11,1996,285,W,2,2,24353,14011700,15853123,8911,12166382,12849206
1996-07-12,1996,286,W,2,2,24214,14035914,15853123,8663,12175045,12849206
1996-07-13,1996,287,W,2,2,24152,14060066,15853123,8528,12183573,12849206
1996-07-14,1996,288,W,2,2,24246,14084312,15853123,8456,12192029,12849206
1996-07-15,1996,289,W,2,2,24467,14108779,15853123,8397,12200426,12849206
1996-07-16,1996,290,W,2,2,24286,14133065,15853123,8539,12208965,12849206
1996-07-17,1996,291,W,2,2,23854,14156919,15853123,8412,12217377,12849206
1996-07-18,1996,292,W,2,2,24005,14180924,15853123,8541,12225918,12849206
1996-07-19,1996,293,W,2,2,23709,14204633,15853123,8389,12234307,12849206
1996-07-20,1996,294,W,2,2,23511,14228144,15853123,8041,12242348,12849206
1996-07-21,1996,295,W,2,2,23190,14251334,15853123,8833,12251181,12849206
1996-07-22,1996,296,W,2,2,23558,14274892,15853123,7951,12259132,12849206
1996-07-23,1996,297,W,2,2,23965,14298857,15853123,8279,12267411,12849206
1996-07-24,1996,298,W,2,2,23763,14322620,15853123,8056,12275467,12849206
1996-07-25,1996,299,W,2,2,23634,14346254,15853123,7806,12283273,12849206
1996-07-26,1996,300,W,2,2,23463,14369717,15853123,7705,12290978,12849206
1996-07-27,1996,301,W,2,2,23589,14393306,15853123,8085,12299063,12849206
1996-07-28,1996,302,W,2,2,23375,14416681,15853123,7915,12306978,12849206
1996-07-29,1996,303,W,2,2,23433,14440114,15853123,8040,12315018,12849206
1996-07-30,1996,304,W,2,2,24124,14464238,15853123,8889,12323907,12849206
1996-07-31,1996,305,W,2,2,24689,14488927,15853123,9160,12333067,12849206
1996-08-01,1996,306,W,2,2,24241,14513168,15853123,8504,12341571,12849206
1996-08-02,1996,307,W,2,2,23957,14537125,15853123,8305,12349876,12849206
1996-08-03,1996,308,W,2,2,23883,14561008,15853123,8509,12358385,12849206
1996-08-04,1996,309,W,2,2,24067,14585075,15853123,8629,12367014,12849206
1996-08-05,1996,310,W,2,2,23748,14608823,15853123,8240,12375254,12849206
1996-08-06,1996,311,W,2,2,23810,14632633,15853123,8632,12383886,12849206
1996-08-07,1996,312,W,2,2,23361,14655994,15853123,8302,12392188,12849206
1996-08-08,1996,313,W,2,2,23634,14679628,15853123,8668,12400856,12849206
1996-08-09,1996,314,W,2,2,23934,14703562,15853123,8550,12409406,12849206
1996-08-10,1996,315,W,2,2,23825,14727387,15853123,9451,12418857,12849206
1996-08-11,1996,316,W,2,2,24210,14751597,15853123,12000,12430857,12849206
1996-08-12,1996,317,W,2,2,24810,14776407,15853123,10682,12441539,12849206
1996-08-13,1996,318,W,2,2,25627,14802034,15853123,11756,12453295,12849206
1996-08-14,1996,319,W,2,2,26116,14828150,15853123,10865,12464160,12849206
1996-08-15,1996,320,W,2,2,26093,14854243,15853123,10897,12475057,12849206
1996-08-16,1996,321,W,2,2,25065,14879308,15853123,9916,12484973,12849206
1996-08-17,1996,322,W,2,2,24707,14904015,15853123,9451,12494424,12849206
1996-08-18,1996,323,W,2,2,24295,14928310,15853123,9849,12504273,12849206
1996-08-19,1996,324,W,2,2,23588,14951898,15853123,8687,12512960,12849206
1996-08-20,1996,325,W,2,2,23468,14975366,15853123,8675,12521635,12849206
1996-08-21,1996,326,W,2,2,23285,14998651,15853123,8212,12529847,12849206
1996-08-22,1996,327,W,2,2,23820,15022471,15853123,8753,12538600,12849206
1996-08-23,1996,328,W,2,2,24593,15047064,15853123,9572,12548172,12849206
1996-08-24,1996,329,W,2,2,24785,15071849,15853123,9938,12558110,12849206
1996-08-25,1996,330,W,2,2,25029,15096878,15853123,10243,12568353,12849206
1996-08-26,1996,331,W,2,2,24710,15121588,15853123,9929,12578282,12849206
1996-08-27,1996,332,W,2,2,24675,15146263,15853123,11890,12590172,12849206
1996-08-28,1996,333,W,2,2,24438,15170701,15853123,9697,12599869,12849206
1996-08-29,1996,334,W,2,2,24409,15195110,15853123,9789,12609658,12849206
1996-08-30,1996,335,W,2,2,23934,15219044,15853123,11417,12621075,12849206
1996-08-31,1996,336,W,2,2,23728,15242772,15853123,9352,12630427,12849206
1996-09-01,1996,337,W,2,2,23381,15266153,15853123,10313,12640740,12849206
1996-09-02,1996,338,W,2,2,23258,15289411,15853123,10183,12650923,12849206
1996-09-03,1996,339,W,2,2,23677,15313088,15853123,10487,12661410,12849206
1996-09-04,1996,340,W,2,2,24125,15337213,15853123,9743,12671153,12849206
1996-09-05,1996,341,W,2,2,24538,15361751,15853123,10432,12681585,12849206
1996-09-06,1996,342,W,2,2,24080,15385831,15853123,10090,12691675,12849206
1996-09-07,1996,343,W,2,2,23826,15409657,15853123,9778,12701453,12849206
1996-09-08,1996,344,W,2,2,22938,15432595,15853123,8964,12710417,12849206
1996-09-09,1996,345,W,2,2,22121,15454716,15853123,8196,12718613,12849206
1996-09-10,1996,346,W,2,2,21493,15476209,15853123,13163,12731776,12849206
1996-09-11,1996,347,W,2,2,20945,15497154,15853123,10467,12742243,12849206
1996-09-12,1996,348,W,2,2,21272,15518426,15853123,12333,12754576,12849206
1996-09-13,1996,349,W,2,2,20727,15539153,15853123,7453,12762029,12849206
1996-09-14,1996,350,W,2,2,20968,15560121,15853123,8139,12770168,12849206
1996-09-15,1996,351,W,2,2,20653,15580774,15853123,6842,12777010,12849206
1996-09-16,1996,352,W,2,2,20718,15601492,15853123,7003,12784013,12849206
1996-09-17,1996,353,W,2,2,20216,15621708,15853123,6885,12790898,12849206
1996-09-18,1996,354,W,2,2,19823,15641531,15853123,6154,12797052,12849206
1996-09-19,1996,355,W,2,2,19325,15660856,15853123,5725,12802777,12849206
1996-09-20,1996,356,W,2,2,19050,15679906,15853123,5401,12808178,12849206
1996-09-21,1996,357,W,2,2,18737,15698643,15853123,5120,12813298,12849206
1996-09-22,1996,358,W,2,2,18802,15717445,15853123,5764,12819062,12849206
1996-09-23,1996,359,W,2,2,17917,15735362,15853123,4588,12823650,12849206
1996-09-24,1996,360,W,2,2,17435,15752797,15853123,3957,12827607,12849206
1996-09-25,1996,361,W,2,2,16563,15769360,15853123,3198,12830805,12849206
1996-09-26,1996,362,W,2,2,16542,15785902,15853123,3163,12833968,12849206
1996-09-27,1996,363,W,2,2,17455,15803357,15853123,4277,12838245,12849206
1996-09-28,1996,364,W,2,2,16914,15820271,15853123,4122,12842367,12849206
1996-09-29,1996,365,W,2,2,16453,15836724,15853123,3599,12845966,12849206
1996-09-30,1996,366,W,2,2,16399,15853123,15853123,3240,12849206,12849206
1996-10-01,1997,1,W,3,3+,17788,17788,20272411,4722,4722,17310711
1996-10-02,1997,2,W,3,3+,17538,35326,20272411,4230,8952,17310711
1996-10-03,1997,3,W,3,3+,17667,52993,20272411,4486,13438,17310711
1996-10-04,1997,4,W,3,3+,17307,70300,20272411,4201,17639,17310711
1996-10-05,1997,5,W,3,3+,17540,87840,20272411,5087,22726,17310711
1996-10-06,1997,6,W,3,3+,17311,105151,20272411,5012,27738,17310711
1996-10-07,1997,7,W,3,3+,16618,121769,20272411,4057,31795,17310711
1996-10-08,1997,8,W,3,3+,16259,138028,20272411,4030,35825,17310711
1996-10-09,1997,9,W,3,3+,15757,153785,20272411,2578,38403,17310711
1996-10-10,1997,10,W,3,3+,16006,169791,20272411,3614,42017,17310711
1996-10-11,1997,11,W,3,3+,16008,185799,20272411,4137,46154,17310711
1996-10-12,1997,12,W,3,3+,15602,201401,20272411,4582,50736,17310711
1996-10-13,1997,13,W,3,3+,16572,217973,20272411,5568,56304,17310711
1996-10-14,1997,14,W,3,3+,16160,234133,20272411,3964,60268,17310711
1996-10-15,1997,15,W,3,3+,15669,249802,20272411,3936,64204,17310711
1996-10-16,1997,16,W,3,3+,15689,265491,20272411,3855,68059,17310711
1996-10-17,1997,17,W,3,3+,15492,280983,20272411,3430,71489,17310711
1996-10-18,1997,18,W,3,3+,15026,296009,20272411,3269,74758,17310711
1996-10-19,1997,19,W,3,3+,15686,311695,20272411,4319,79077,17310711
1996-10-20,1997,20,W,3,3+,15572,327267,20272411,4245,83322,17310711
1996-10-21,1997,21,W,3,3+,15250,342517,20272411,4529,87851,17310711
1996-10-22,1997,22,W,3,3+,15135,357652,20272411,3676,91527,17310711
1996-10-23,1997,23,W,3,3+,14926,372578,20272411,4920,96447,17310711
1996-10-24,1997,24,W,3,3+,14924,387502,20272411,3619,100066,17310711
1996-10-25,1997,25,W,3,3+,15554,403056,20272411,4138,104204,17310711
1996-10-26,1997,26,W,3,3+,16151,419207,20272411,5451,109655,17310711
1996-10-27,1997,27,W,3,3+,14850,434057,20272411,4353,114008,17310711
1996-10-28,1997,28,W,3,3+,14286,448343,20272411,3722,117730,17310711
1996-10-29,1997,29,W,3,3+,14931,463274,20272411,3491,121221,17310711
1996-10-30,1997,30,W,3,3+,16169,479443,20272411,12195,133416,17310711
1996-10-31,1997,31,W,3,3+,17396,496839,20272411,14422,147838,17310711
1996-11-01,1997,32,W,3,3+,17940,514779,20272411,15223,163061,17310711
1996-11-02,1997,33,W,3,3+,17207,531986,20272411,13487,176548,17310711
1996-11-03,1997,34,W,3,3+,17343,549329,20272411,13714,190262,17310711
1996-11-04,1997,35,W,3,3+,17590,566919,20272411,7600,197862,17310711
1996-11-05,1997,36,W,3,3+,17011,583930,20272411,5512,203374,17310711
1996-11-06,1997,37,W,3,3+,16424,600354,20272411,5455,208829,17310711
1996-11-07,1997,38,W,3,3+,16118,616472,20272411,4538,213367,17310711
1996-11-08,1997,39,W,3,3+,15974,632446,20272411,3949,217316,17310711
1996-11-09,1997,40,W,3,3+,15803,648249,20272411,3946,221262,17310711
1996-11-10,1997,41,W,3,3+,15672,663921,20272411,4189,225451,17310711
1996-11-11,1997,42,W,3,3+,15561,679482,20272411,4258,229709,17310711
1996-11-12,1997,43,W,3,3+,15807,695289,20272411,4240,233949,17310711
1996-11-13,1997,44,W,3,3+,15843,711132,20272411,5270,239219,17310711
1996-11-14,1997,45,W,3,3+,15889,727021,20272411,3953,243172,17310711
1996-11-15,1997,46,W,3,3+,15850,742871,20272411,4340,247512,17310711
1996-11-16,1997,47,W,3,3+,16199,759070,20272411,5155,252667,17310711
1996-11-17,1997,48,W,3,3+,16698,775768,20272411,8441,261108,17310711
1996-11-18,1997,49,W,3,3+,18988,794756,20272411,15400,276508,17310711
1996-11-19,1997,50,W,3,3+,19356,814112,20272411,16859,293367,17310711
1996-11-20,1997,51,W,3,3+,20460,834572,20272411,17805,311172,17310711
1996-11-21,1997,52,W,3,3+,20606,855178,20272411,17434,328606,17310711
1996-11-22,1997,53,W,3,3+,22810,877988,20272411,18495,347101,17310711
1996-11-23,1997,54,W,3,3+,26260,904248,20272411,16704,363805,17310711
1996-11-24,1997,55,W,3,3+,25763,930011,20272411,16004,379809,17310711
1996-11-25,1997,56,W,3,3+,26205,956216,20272411,15756,395565,17310711
1996-11-26,1997,57,W,3,3+,24472,980688,20272411,14714,410279,17310711
1996-11-27,1997,58,W,3,3+,23170,1003858,20272411,10938,421217,17310711
1996-11-28,1997,59,W,3,3+,22127,1025985,20272411,9531,430748,17310711
1996-11-29,1997,60,W,3,3+,21960,1047945,20272411,9434,440182,17310711
1996-11-30,1997,61,W,3,3+,21126,1069071,20272411,8719,448901,17310711
1996-12-01,1997,62,W,3,3+,19732,1088803,20272411,7040,455941,17310711
1996-12-02,1997,63,W,3,3+,19300,1108103,20272411,8676,464617,17310711
1996-12-03,1997,64,W,3,3+,18819,1126922,20272411,8076,472693,17310711
1996-12-04,1997,65,W,3,3+,20667,1147589,20272411,10937,483630,17310711
1996-12-05,1997,66,W,3,3+,31066,1178655,20272411,20624,504254,17310711
1996-12-06,1997,67,W,3,3+,49369,1228024,20272411,39985,544239,17310711
1996-12-07,1997,68,W,3,3+,51464,1279488,20272411,42122,586361,17310711
1996-12-08,1997,69,W,3,3+,50727,1330215,20272411,41194,627555,17310711
1996-12-09,1997,70,W,3,3+,49190,1379405,20272411,39727,667282,17310711
1996-12-10,1997,71,W,3,3+,56639,1436044,20272411,48869,716151,17310711
1996-12-11,1997,72,W,3,3+,67400,1503444,20272411,63881,780032,17310711
1996-12-12,1997,73,W,3,3+,85548,1588992,20272411,79498,859530,17310711
1996-12-13,1997,74,W,3,3+,107723,1696715,20272411,102962,962492,17310711
1996-12-14,1997,75,W,3,3+,130890,1827605,20272411,127545,1090037,17310711
1996-12-15,1997,76,W,3,3+,132441,1960046,20272411,125300,1215337,17310711
1996-12-16,1997,77,W,3,3+,124912,2084958,20272411,115048,1330385,17310711
1996-12-17,1997,78,W,3,3+,115792,2200750,20272411,109357,1439742,17310711
1996-12-18,1997,79,W,3,3+,103197,2303947,20272411,96515,1536257,17310711
1996-12-19,1997,80,W,3,3+,94159,2398106,20272411,86884,1623141,17310711
1996-12-20,1997,81,W,3,3+,87840,2485946,20272411,81038,1704179,17310711
1996-12-21,1997,82,W,3,3+,92544,2578490,20272411,84202,1788381,17310711
1996-12-22,1997,83,W,3,3+,94533,2673023,20272411,95407,1883788,17310711
1996-12-23,1997,84,W,3,3+,96135,2769158,20272411,110127,1993915,17310711
1996-12-24,1997,85,W,3,3+,94784,2863942,20272411,108874,2102789,17310711
1996-12-25,1997,86,W,3,3+,89900,2953842,20272411,104967,2207756,17310711
1996-12-26,1997,87,W,3,3+,85669,3039511,20272411,100975,2308731,17310711
1996-12-27,1997,88,W,3,3+,98415,3137926,20272411,105001,2413732,17310711
1996-12-28,1997,89,W,3,3+,115342,3253268,20272411,110175,2523907,17310711
1996-12-29,1997,90,W,3,3+,144305,3397573,20272411,139275,2663182,17310711
1996-12-30,1997,91,W,3,3+,181168,3578741,20272411,177331,2840513,17310711
1996-12-31,1997,92,W,3,3+,227220,3805961,20272411,225094,3065607,17310711
1997-01-01,1997,93,W,3,3+,318478,4124439,20272411,314657,3380264,17310711
1997-01-02,1997,94,W,3,3+,555168,4679607,20272411,557208,3937472,17310711
1997-01-03,1997,95,W,3,3+,561889,5241496,20272411,567086,4504558,17310711
1997-01-04,1997,96,W,3,3+,557840,5799336,20272411,560341,5064899,17310711
1997-01-05,1997,97,W,3,3+,480314,6279650,20272411,482525,5547424,17310711
1997-01-06,1997,98,W,3,3+,382903,6662553,20272411,388826,5936250,17310711
1997-01-07,1997,99,W,3,3+,344179,7006732,20272411,344379,6280629,17310711
1997-01-08,1997,100,W,3,3+,317776,7324508,20272411,299653,6580282,17310711
1997-01-09,1997,101,W,3,3+,286733,7611241,20272411,263041,6843323,17310711
1997-01-10,1997,102,W,3,3+,256915,7868156,20272411,239378,7082701,17310711
1997-01-11,1997,103,W,3,3+,230527,8098683,20272411,214141,7296842,17310711
1997-01-12,1997,104,W,3,3+,201436,8300119,20272411,185397,7482239,17310711
1997-01-13,1997,105,W,3,3+,179039,8479158,20272411,171004,7653243,17310711
1997-01-14,1997,106,W,3,3+,166109,8645267,20272411,163045,7816288,17310711
1997-01-15,1997,107,W,3,3+,158195,8803462,20272411,155093,7971381,17310711
1997-01-16,1997,108,W,3,3+,151242,8954704,20272411,150121,8121502,17310711
1997-01-17,1997,109,W,3,3+,144641,9099345,20272411,144306,8265808,17310711
1997-01-18,1997,110,W,3,3+,138290,9237635,20272411,137141,8402949,17310711
1997-01-19,1997,111,W,3,3+,133243,9370878,20272411,133123,8536072,17310711
1997-01-20,1997,112,W,3,3+,129098,9499976,20272411,129274,8665346,17310711
1997-01-21,1997,113,W,3,3+,126580,9626556,20272411,127496,8792842,17310711
1997-01-22,1997,114,W,3,3+,139492,9766048,20272411,139954,8932796,17310711
1997-01-23,1997,115,W,3,3+,201628,9967676,20272411,212323,9145119,17310711
1997-01-24,1997,116,W,3,3+,212515,10180191,20272411,223700,9368819,17310711
1997-01-25,1997,117,W,3,3+,226500,10406691,20272411,240309,9609128,17310711
1997-01-26,1997,118,W,3,3+,268271,10674962,20272411,281165,9890293,17310711
1997-01-27,1997,119,W,3,3+,268232,10943194,20272411,283009,10173302,17310711
1997-01-28,1997,120,W,3,3+,262844,11206038,20272411,267676,10440978,17310711
1997-01-29,1997,121,W,3,3+,264352,11470390,20272411,269037,10710015,17310711
1997-01-30,1997,122,W,3,3+,252612,11723002,20272411,254386,10964401,17310711
1997-01-31,1997,123,W,3,3+,235656,11958658,20272411,237512,11201913,17310711
1997-02-01,1997,124,W,3,3+,218603,12177261,20272411,216492,11418405,17310711
1997-02-02,1997,125,W,3,3+,203858,12381119,20272411,200509,11618914,17310711
1997-02-03,1997,126,W,3,3+,191898,12573017,20272411,189512,11808426,17310711
1997-02-04,1997,127,W,3,3+,181295,12754312,20272411,179082,11987508,17310711
1997-02-05,1997,128,W,3,3+,172307,12926619,20272411,170382,12157890,17310711
1997-02-06,1997,129,W,3,3+,165211,13091830,20272411,163282,12321172,17310711
1997-02-07,1997,130,W,3,3+,160224,13252054,20272411,158303,12479475,17310711
1997-02-08,1997,131,W,3,3+,155229,13407283,20272411,152272,12631747,17310711
1997-02-09,1997,132,W,3,3+,148904,13556187,20272411,144165,12775912,17310711
1997-02-10,1997,133,W,3,3+,142838,13699025,20272411,140022,12915934,17310711
1997-02-11,1997,134,W,3,3+,136269,13835294,20272411,134540,13050474,17310711
1997-02-12,1997,135,W,3,3+,127256,13962550,20272411,125534,13176008,17310711
1997-02-13,1997,136,W,3,3+,116215,14078765,20272411,112745,13288753,17310711
1997-02-14,1997,137,W,3,3+,108711,14187476,20272411,105214,13393967,17310711
1997-02-15,1997,138,W,3,3+,103062,14290538,20272411,99171,13493138,17310711
1997-02-16,1997,139,W,3,3+,96711,14387249,20272411,93007,13586145,17310711
1997-02-17,1997,140,W,3,3+,90961,14478210,20272411,87165,13673310,17310711
1997-02-18,1997,141,W,3,3+,85881,14564091,20272411,82272,13755582,17310711
1997-02-19,1997,142,W,3,3+,83238,14647329,20272411,79757,13835339,17310711
1997-02-20,1997,143,W,3,3+,83322,14730651,20272411,79927,13915266,17310711
1997-02-21,1997,144,W,3,3+,82734,14813385,20272411,77917,13993183,17310711
1997-02-22,1997,145,W,3,3+,81649,14895034,20272411,82076,14075259,17310711
1997-02-23,1997,146,W,3,3+,80517,14975551,20272411,81143,14156402,17310711
1997-02-24,1997,147,W,3,3+,78458,15054009,20272411,77552,14233954,17310711
1997-02-25,1997,148,W,3,3+,76355,15130364,20272411,74813,14308767,17310711
1997-02-26,1997,149,W,3,3+,76774,15207138,20272411,74711,14383478,17310711
1997-02-27,1997,150,W,3,3+,75732,15282870,20272411,71546,14455024,17310711
1997-02-28,1997,151,W,3,3+,74478,15357348,20272411,69814,14524838,17310711
1997-03-01,1997,152,W,3,3+,73712,15431060,20272411,69138,14593976,17310711
1997-03-02,1997,153,W,3,3+,71846,15502906,20272411,70831,14664807,17310711
1997-03-03,1997,154,W,3,3+,70178,15573084,20272411,68613,14733420,17310711
1997-03-04,1997,155,W,3,3+,67340,15640424,20272411,65130,14798550,17310711
1997-03-05,1997,156,W,3,3+,63893,15704317,20272411,60947,14859497,17310711
1997-03-06,1997,157,W,3,3+,58329,15762646,20272411,55345,14914842,17310711
1997-03-07,1997,158,W,3,3+,53412,15816058,20272411,48061,14962903,17310711
1997-03-08,1997,159,W,3,3+,49075,15865133,20272411,42928,15005831,17310711
1997-03-09,1997,160,W,3,3+,46283,15911416,20272411,38970,15044801,17310711
1997-03-10,1997,161,W,3,3+,44036,15955452,20272411,37635,15082436,17310711
1997-03-11,1997,162,W,3,3+,41776,15997228,20272411,34672,15117108,17310711
1997-03-12,1997,163,W,3,3+,39115,16036343,20272411,31478,15148586,17310711
1997-03-13,1997,164,W,3,3+,36797,16073140,20272411,28448,15177034,17310711
1997-03-14,1997,165,W,3,3+,34937,16108077,20272411,26417,15203451,17310711
1997-03-15,1997,166,W,3,3+,32648,16140725,20272411,23957,15227408,17310711
1997-03-16,1997,167,W,3,3+,31580,16172305,20272411,23087,15250495,17310711
1997-03-17,1997,168,W,3,3+,31612,16203917,20272411,23766,15274261,17310711
1997-03-18,1997,169,W,3,3+,32212,16236129,20272411,23604,15297865,17310711
1997-03-19,1997,170,W,3,3+,34743,16270872,20272411,25945,15323810,17310711
1997-03-20,1997,171,W,3,3+,34714,16305586,20272411,26386,15350196,17310711
1997-03-21,1997,172,W,3,3+,32652,16338238,20272411,24362,15374558,17310711
1997-03-22,1997,173,W,3,3+,31457,16369695,20272411,23619,15398177,17310711
1997-03-23,1997,174,W,3,3+,30931,16400626,20272411,21651,15419828,17310711
1997-03-24,1997,175,W,3,3+,30565,16431191,20272411,21770,15441598,17310711
1997-03-25,1997,176,W,3,3+,29705,16460896,20272411,21488,15463086,17310711
1997-03-26,1997,177,W,3,3+,28853,16489749,20272411,21032,15484118,17310711
1997-03-27,1997,178,W,3,3+,28613,16518362,20272411,20542,15504660,17310711
1997-03-28,1997,179,W,3,3+,28710,16547072,20272411,19604,15524264,17310711
1997-03-29,1997,180,W,3,3+,27102,16574174,20272411,17783,15542047,17310711
1997-03-30,1997,181,W,3,3+,25644,16599818,20272411,13894,15555941,17310711
1997-03-31,1997,182,W,3,3+,25676,16625494,20272411,15918,15571859,17310711
1997-04-01,1997,183,W,3,3+,25012,16650506,20272411,17053,15588912,17310711
1997-04-02,1997,184,W,3,3+,24343,16674849,20272411,16291,15605203,17310711
1997-04-03,1997,185,W,3,3+,23978,16698827,20272411,15453,15620656,17310711
1997-04-04,1997,186,W,3,3+,23262,16722089,20272411,15456,15636112,17310711
1997-04-05,1997,187,W,3,3+,22342,16744431,20272411,13059,15649171,17310711
1997-04-06,1997,188,W,3,3+,21066,16765497,20272411,10672,15659843,17310711
1997-04-07,1997,189,W,3,3+,20646,16786143,20272411,11025,15670868,17310711
1997-04-08,1997,190,W,3,3+,19268,16805411,20272411,10153,15681021,17310711
1997-04-09,1997,191,W,3,3+,19088,16824499,20272411,9429,15690450,17310711
1997-04-10,1997,192,W,3,3+,18499,16842998,20272411,9158,15699608,17310711
1997-04-11,1997,193,W,3,3+,18700,16861698,20272411,10346,15709954,17310711
1997-04-12,1997,194,W,3,3+,18459,16880157,20272411,8474,15718428,17310711
1997-04-13,1997,195,W,3,3+,18155,16898312,20272411,8677,15727105,17310711
1997-04-14,1997,196,W,3,3+,17995,16916307,20272411,9603,15736708,17310711
1997-04-15,1997,197,W,3,3+,17754,16934061,20272411,13537,15750245,17310711
1997-04-16,1997,198,W,3,3+,17384,16951445,20272411,13013,15763258,17310711
1997-04-17,1997,199,W,3,3+,18010,16969455,20272411,13622,15776880,17310711
1997-04-18,1997,200,W,3,3+,18214,16987669,20272411,13849,15790729,17310711
1997-04-19,1997,201,W,3,3+,18873,17006542,20272411,16574,15807303,17310711
1997-04-20,1997,202,W,3,3+,19336,17025878,20272411,17677,15824980,17310711
1997-04-21,1997,203,W,3,3+,20800,17046678,20272411,19140,15844120,17310711
1997-04-22,1997,204,W,3,3+,22474,17069152,20272411,20869,15864989,17310711
1997-04-23,1997,205,W,3,3+,22992,17092144,20272411,21359,15886348,17310711
1997-04-24,1997,206,W,3,3+,23376,17115520,20272411,19611,15905959,17310711
1997-04-25,1997,207,W,3,3+,22110,17137630,20272411,17617,15923576,17310711
1997-04-26,1997,208,W,3,3+,21477,17159107,20272411,17105,15940681,17310711
1997-04-27,1997,209,W,3,3+,19827,17178934,20272411,15325,15956006,17310711
1997-04-28,1997,210,W,3,3+,18770,17197704,20272411,14269,15970275,17310711
1997-04-29,1997,211,W,3,3+,18745,17216449,20272411,14187,15984462,17310711
1997-04-30,1997,212,W,3,3+,18250,17234699,20272411,13783,15998245,17310711
1997-05-01,1997,213,W,3,3+,18646,17253345,20272411,14130,16012375,17310711
1997-05-02,1997,214,W,3,3+,17942,17271287,20272411,13403,16025778,17310711
1997-05-03,1997,215,W,3,3+,17604,17288891,20272411,13049,16038827,17310711
1997-05-04,1997,216,W,3,3+,17519,17306410,20272411,12880,16051707,17310711
1997-05-05,1997,217,W,3,3+,17702,17324112,20272411,13071,16064778,17310711
1997-05-06,1997,218,W,3,3+,17694,17341806,20272411,13013,16077791,17310711
1997-05-07,1997,219,W,3,3+,17027,17358833,20272411,12268,16090059,17310711
1997-05-08,1997,220,W,3,3+,17140,17375973,20272411,12235,16102294,17310711
1997-05-09,1997,221,W,3,3+,17190,17393163,20272411,12515,16114809,17310711
1997-05-10,1997,222,W,3,3+,17091,17410254,20272411,12233,16127042,17310711
1997-05-11,1997,223,W,3,3+,17580,17427834,20272411,12728,16139770,17310711
1997-05-12,1997,224,W,3,3+,17774,17445608,20272411,12809,16152579,17310711
1997-05-13,1997,225,W,3,3+,17703,17463311,20272411,12808,16165387,17310711
1997-05-14,1997,226,W,3,3+,18188,17481499,20272411,14339,16179726,17310711
1997-05-15,1997,227,W,3,3+,17684,17499183,20272411,13829,16193555,17310711
1997-05-16,1997,228,W,3,3+,17246,17516429,20272411,13308,16206863,17310711
1997-05-17,1997,229,W,3,3+,16381,17532810,20272411,12538,16219401,17310711
1997-05-18,1997,230,W,3,3+,15073,17547883,20272411,9151,16228552,17310711
1997-05-19,1997,231,W,3,3+,15329,17563212,20272411,11742,16240294,17310711
1997-05-20,1997,232,W,3,3+,15366,17578578,20272411,11906,16252200,17310711
1997-05-21,1997,233,W,3,3+,15663,17594241,20272411,12148,16264348,17310711
1997-05-22,1997,234,W,3,3+,16219,17610460,20272411,11810,16276158,17310711
1997-05-23,1997,235,W,3,3+,17652,17628112,20272411,13217,16289375,17310711
1997-05-24,1997,236,W,3,3+,18267,17646379,20272411,14684,16304059,17310711
1997-05-25,1997,237,W,3,3+,19030,17665409,20272411,12653,16316712,17310711
1997-05-26,1997,238,W,3,3+,20093,17685502,20272411,12696,16329408,17310711
1997-05-27,1997,239,W,3,3+,20393,17705895,20272411,12178,16341586,17310711
1997-05-28,1997,240,W,3,3+,20095,17725990,20272411,11482,16353068,17310711
1997-05-29,1997,241,W,3,3+,19968,17745958,20272411,9878,16362946,17310711
1997-05-30,1997,242,W,3,3+,19304,17765262,20272411,9172,16372118,17310711
1997-05-31,1997,243,W,3,3+,18991,17784253,20272411,8969,16381087,17310711
1997-06-01,1997,244,W,3,3+,18045,17802298,20272411,8211,16389298,17310711
1997-06-02,1997,245,W,3,3+,17513,17819811,20272411,7843,16397141,17310711
1997-06-03,1997,246,W,3,3+,17553,17837364,20272411,7866,16405007,17310711
1997-06-04,1997,247,W,3,3+,17997,17855361,20272411,9082,16414089,17310711
1997-06-05,1997,248,W,3,3+,17932,17873293,20272411,8742,16422831,17310711
1997-06-06,1997,249,W,3,3+,18576,17891869,20272411,9323,16432154,17310711
1997-06-07,1997,250,W,3,3+,18840,17910709,20272411,10575,16442729,17310711
1997-06-08,1997,251,W,3,3+,17841,17928550,20272411,9515,16452244,17310711
1997-06-09,1997,252,W,3,3+,17432,17945982,20272411,8622,16460866,17310711
1997-06-10,1997,253,W,3,3+,16996,17962978,20272411,7910,16468776,17310711
1997-06-11,1997,254,W,3,3+,17025,17980003,20272411,7944,16476720,17310711
1997-06-12,1997,255,W,3,3+,17531,17997534,20272411,7327,16484047,17310711
1997-06-13,1997,256,W,3,3+,18667,18016201,20272411,8141,16492188,17310711
1997-06-14,1997,257,W,3,3+,18610,18034811,20272411,8140,16500328,17310711
1997-06-15,1997,258,W,3,3+,19578,18054389,20272411,8274,16508602,17310711
1997-06-16,1997,259,W,3,3+,20944,18075333,20272411,9578,16518180,17310711
1997-06-17,1997,260,W,3,3+,21487,18096820,20272411,9172,16527352,17310711
1997-06-18,1997,261,W,3,3+,21814,18118634,20272411,8879,16536231,17310711
1997-06-19,1997,262,W,3,3+,20724,18139358,20272411,7626,16543857,17310711
1997-06-20,1997,263,W,3,3+,20095,18159453,20272411,7481,16551338,17310711
1997-06-21,1997,264,W,3,3+,19505,18178958,20272411,7173,16558511,17310711
1997-06-22,1997,265,W,3,3+,19677,18198635,20272411,7447,16565958,17310711
1997-06-23,1997,266,W,3,3+,19326,18217961,20272411,7180,16573138,17310711
1997-06-24,1997,267,W,3,3+,18790,18236751,20272411,6705,16579843,17310711
1997-06-25,1997,268,W,3,3+,19448,18256199,20272411,7377,16587220,17310711
1997-06-26,1997,269,W,3,3+,20201,18276400,20272411,7873,16595093,17310711
1997-06-27,1997,270,W,3,3+,20130,18296530,20272411,8214,16603307,17310711
1997-06-28,1997,271,W,3,3+,20463,18316993,20272411,8180,16611487,17310711
1997-06-29,1997,272,W,3,3+,21595,18338588,20272411,8882,16620369,17310711
1997-06-30,1997,273,W,3,3+,23213,18361801,20272411,9918,16630287,17310711
1997-07-01,1997,274,W,3,3+,23583,18385384,20272411,9191,16639478,17310711
1997-07-02,1997,275,W,3,3+,23574,18408958,20272411,8460,16647938,17310711
1997-07-03,1997,276,W,3,3+,23382,18432340,20272411,8135,16656073,17310711
1997-07-04,1997,277,W,3,3+,23397,18455737,20272411,8210,16664283,17310711
1997-07-05,1997,278,W,3,3+,23624,18479361,20272411,8096,16672379,17310711
1997-07-06,1997,279,W,3,3+,23439,18502800,20272411,8397,16680776,17310711
1997-07-07,1997,280,W,3,3+,23220,18526020,20272411,8290,16689066,17310711
1997-07-08,1997,281,W,3,3+,22803,18548823,20272411,8408,16697474,17310711
1997-07-09,1997,282,W,3,3+,22627,18571450,20272411,9922,16707396,17310711
1997-07-10,1997,283,W,3,3+,22851,18594301,20272411,11351,16718747,17310711
1997-07-11,1997,284,W,3,3+,23133,18617434,20272411,11352,16730099,17310711
1997-07-12,1997,285,W,3,3+,23496,18640930,20272411,11780,16741879,17310711
1997-07-13,1997,286,W,3,3+,23647,18664577,20272411,10930,16752809,17310711
1997-07-14,1997,287,W,3,3+,23866,18688443,20272411,12648,16765457,17310711
1997-07-15,1997,288,W,3,3+,23852,18712295,20272411,10865,16776322,17310711
1997-07-16,1997,289,W,3,3+,23658,18735953,20272411,10046,16786368,17310711
1997-07-17,1997,290,W,3,3+,23685,18759638,20272411,10078,16796446,17310711
1997-07-18,1997,291,W,3,3+,23913,18783551,20272411,9560,16806006,17310711
1997-07-19,1997,292,W,3,3+,23855,18807406,20272411,8743,16814749,17310711
1997-07-20,1997,293,W,3,3+,23890,18831296,20272411,8721,16823470,17310711
1997-07-21,1997,294,W,3,3+,24261,18855557,20272411,9110,16832580,17310711
1997-07-22,1997,295,W,3,3+,24199,18879756,20272411,9490,16842070,17310711
1997-07-23,1997,296,W,3,3+,24562,18904318,20272411,9367,16851437,17310711
1997-07-24,1997,297,W,3,3+,24463,18928781,20272411,9935,16861372,17310711
1997-07-25,1997,298,W,3,3+,24438,18953219,20272411,8945,16870317,17310711
1997-07-26,1997,299,W,3,3+,24026,18977245,20272411,8749,16879066,17310711
1997-07-27,1997,300,W,3,3+,24068,19001313,20272411,8703,16887769,17310711
1997-07-28,1997,301,W,3,3+,24183,19025496,20272411,8788,16896557,17310711
1997-07-29,1997,302,W,3,3+,23781,19049277,20272411,8196,16904753,17310711
1997-07-30,1997,303,W,3,3+,23294,19072571,20272411,7878,16912631,17310711
1997-07-31,1997,304,W,3,3+,23506,19096077,20272411,8532,16921163,17310711
1997-08-01,1997,305,W,3,3+,23456,19119533,20272411,8096,16929259,17310711
1997-08-02,1997,306,W,3,3+,23506,19143039,20272411,8162,16937421,17310711
1997-08-03,1997,307,W,3,3+,23274,19166313,20272411,8285,16945706,17310711
1997-08-04,1997,308,W,3,3+,23461,19189774,20272411,8179,16953885,17310711
1997-08-05,1997,309,W,3,3+,23494,19213268,20272411,7984,16961869,17310711
1997-08-06,1997,310,W,3,3+,23680,19236948,20272411,8048,16969917,17310711
1997-08-07,1997,311,W,3,3+,24063,19261011,20272411,10201,16980118,17310711
1997-08-08,1997,312,W,3,3+,23644,19284655,20272411,9084,16989202,17310711
1997-08-09,1997,313,W,3,3+,23123,19307778,20272411,12358,17001560,17310711
1997-08-10,1997,314,W,3,3+,23160,19330938,20272411,13987,17015547,17310711
1997-08-11,1997,315,W,3,3+,21954,19352892,20272411,12966,17028513,17310711
1997-08-12,1997,316,W,3,3+,21219,19374111,20272411,12253,17040766,17310711
1997-08-13,1997,317,W,3,3+,20682,19394793,20272411,11967,17052733,17310711
1997-08-14,1997,318,W,3,3+,20424,19415217,20272411,11410,17064143,17310711
1997-08-15,1997,319,W,3,3+,19415,19434632,20272411,9218,17073361,17310711
1997-08-16,1997,320,W,3,3+,19017,19453649,20272411,6659,17080020,17310711
1997-08-17,1997,321,W,3,3+,19555,19473204,20272411,8550,17088570,17310711
1997-08-18,1997,322,W,3,3+,20066,19493270,20272411,8978,17097548,17310711
1997-08-19,1997,323,W,3,3+,19939,19513209,20272411,8228,17105776,17310711
1997-08-20,1997,324,W,3,3+,19532,19532741,20272411,7785,17113561,17310711
1997-08-21,1997,325,W,3,3+,19459,19552200,20272411,7427,17120988,17310711
1997-08-22,1997,326,W,3,3+,20013,19572213,20272411,6825,17127813,17310711
1997-08-23,1997,327,W,3,3+,21284,19593497,20272411,7309,17135122,17310711
1997-08-24,1997,328,W,3,3+,22178,19615675,20272411,7908,17143030,17310711
1997-08-25,1997,329,W,3,3+,22907,19638582,20272411,8699,17151729,17310711
1997-08-26,1997,330,W,3,3+,22913,19661495,20272411,8960,17160689,17310711
1997-08-27,1997,331,W,3,3+,22071,19683566,20272411,7434,17168123,17310711
1997-08-28,1997,332,W,3,3+,21278,19704844,20272411,7249,17175372,17310711
1997-08-29,1997,333,W,3,3+,20445,19725289,20272411,5839,17181211,17310711
1997-08-30,1997,334,W,3,3+,19705,19744994,20272411,5178,17186389,17310711
1997-08-31,1997,335,W,3,3+,19463,19764457,20272411,5027,17191416,17310711
1997-09-01,1997,336,W,3,3+,19418,19783875,20272411,5093,17196509,17310711
1997-09-02,1997,337,W,3,3+,19190,19803065,20272411,4788,17201297,17310711
1997-09-03,1997,338,W,3,3+,18982,19822047,20272411,4902,17206199,17310711
1997-09-04,1997,339,W,3,3+,18838,19840885,20272411,6965,17213164,17310711
1997-09-05,1997,340,W,3,3+,19002,19859887,20272411,5699,17218863,17310711
1997-09-06,1997,341,W,3,3+,19089,19878976,20272411,4979,17223842,17310711
1997-09-07,1997,342,W,3,3+,19050,19898026,20272411,5255,17229097,17310711
1997-09-08,1997,343,W,3,3+,19142,19917168,20272411,5153,17234250,17310711
1997-09-09,1997,344,W,3,3+,18850,19936018,20272411,4776,17239026,17310711
1997-09-10,1997,345,W,3,3+,18940,19954958,20272411,4897,17243923,17310711
1997-09-11,1997,346,W,3,3+,18468,19973426,20272411,4446,17248369,17310711
1997-09-12,1997,347,W,3,3+,17646,19991072,20272411,3735,17252104,17310711
1997-09-13,1997,348,W,3,3+,17131,20008203,20272411,3215,17255319,17310711
1997-09-14,1997,349,W,3,3+,16586,20024789,20272411,3086,17258405,17310711
1997-09-15,1997,350,W,3,3+,16262,20041051,20272411,2737,17261142,17310711
1997-09-16,1997,351,W,3,3+,15188,20056239,20272411,2605,17263747,17310711
1997-09-17,1997,352,W,3,3+,15402,20071641,20272411,2329,17266076,17310711
1997-09-18,1997,353,W,3,3+,16032,20087673,20272411,3368,17269444,17310711
1997-09-19,1997,354,W,3,3+,15683,20103356,20272411,2994,17272438,17310711
1997-09-20,1997,355,W,3,3+,15856,20119212,20272411,2955,17275393,17310711
1997-09-21,1997,356,W,3,3+,15962,20135174,20272411,3072,17278465,17310711
1997-09-22,1997,357,W,3,3+,15990,20151164,20272411,3093,17281558,17310711
1997-09-23,1997,358,W,3,3+,15327,20166491,20272411,5147,17286705,17310711
1997-09-24,1997,359,W,3,3+,14831,20181322,20272411,5162,17291867,17310711
1997-09-25,1997,360,W,3,3+,14318,20195640,20272411,4826,17296693,17310711
1997-09-26,1997,361,W,3,3+,14992,20210632,20272411,3346,17300039,17310711
1997-09-27,1997,362,W,3,3+,15482,20226114,20272411,2935,17302974,17310711
1997-09-28,1997,363,W,3,3+,15039,20241153,20272411,2388,17305362,17310711
1997-09-29,1997,364,W,3,3+,15520,20256673,20272411,2611,17307973,17310711
1997-09-30,1997,365,W,3,3+,15738,20272411,20272411,2738,17310711,17310711
1997-10-01,1998,1,W,4,3+,15560,15560,24205904,3987,3987,21658845
1997-10-02,1998,2,W,4,3+,16566,32126,24205904,4941,8928,21658845
1997-10-03,1998,3,W,4,3+,16676,48802,24205904,4219,13147,21658845
1997-10-04,1998,4,W,4,3+,16955,65757,24205904,4325,17472,21658845
1997-10-05,1998,5,W,4,3+,16838,82595,24205904,3768,21240,21658845
1997-10-06,1998,6,W,4,3+,15857,98452,24205904,3082,24322,21658845
1997-10-07,1998,7,W,4,3+,16613,115065,24205904,5053,29375,21658845
1997-10-08,1998,8,W,4,3+,16173,131238,24205904,4617,33992,21658845
1997-10-09,1998,9,W,4,3+,16843,148081,24205904,6363,40355,21658845
1997-10-10,1998,10,W,4,3+,16679,164760,24205904,5647,46002,21658845
1997-10-11,1998,11,W,4,3+,17595,182355,24205904,7321,53323,21658845
1997-10-12,1998,12,W,4,3+,17544,199899,24205904,7053,60376,21658845
1997-10-13,1998,13,W,4,3+,16983,216882,24205904,6475,66851,21658845
1997-10-14,1998,14,W,4,3+,16294,233176,24205904,3500,70351,21658845
1997-10-15,1998,15,W,4,3+,15291,248467,24205904,2711,73062,21658845
1997-10-16,1998,16,W,4,3+,14651,263118,24205904,3088,76150,21658845
1997-10-17,1998,17,W,4,3+,14560,277678,24205904,3872,80022,21658845
1997-10-18,1998,18,W,4,3+,14632,292310,24205904,4958,84980,21658845
1997-10-19,1998,19,W,4,3+,14063,306373,24205904,4221,89201,21658845
1997-10-20,1998,20,W,4,3+,14257,320630,24205904,5011,94212,21658845
1997-10-21,1998,21,W,4,3+,14768,335398,24205904,6009,100221,21658845
1997-10-22,1998,22,W,4,3+,15284,350682,24205904,6572,106793,21658845
1997-10-23,1998,23,W,4,3+,15076,365758,24205904,6155,112948,21658845
1997-10-24,1998,24,W,4,3+,14809,380567,24205904,6023,118971,21658845
1997-10-25,1998,25,W,4,3+,13621,394188,24205904,4547,123518,21658845
1997-10-26,1998,26,W,4,3+,12888,407076,24205904,4206,127724,21658845
1997-10-27,1998,27,W,4,3+,12827,419903,24205904,4826,132550,21658845
1997-10-28,1998,28,W,4,3+,12921,432824,24205904,4714,137264,21658845
1997-10-29,1998,29,W,4,3+,13052,445876,24205904,4908,142172,21658845
1997-10-30,1998,30,W,4,3+,13013,458889,24205904,4442,146614,21658845
1997-10-31,1998,31,W,4,3+,12954,471843,24205904,3488,150102,21658845
1997-11-01,1998,32,W,4,3+,13231,485074,24205904,4016,154118,21658845
1997-11-02,1998,33,W,4,3+,13068,498142,24205904,3283,157401,21658845
1997-11-03,1998,34,W,4,3+,13051,511193,24205904,3834,161235,21658845
1997-11-04,1998,35,W,4,3+,13461,524654,24205904,3776,165011,21658845
1997-11-05,1998,36,W,4,3+,13436,538090,24205904,2974,167985,21658845
1997-11-06,1998,37,W,4,3+,13737,551827,24205904,4038,172023,21658845
1997-11-07,1998,38,W,4,3+,14164,565991,24205904,4033,176056,21658845
1997-11-08,1998,39,W,4,3+,14251,580242,24205904,5029,181085,21658845
1997-11-09,1998,40,W,4,3+,13948,594190,24205904,4626,185711,21658845
1997-11-10,1998,41,W,4,3+,13877,608067,24205904,7897,193608,21658845
1997-11-11,1998,42,W,4,3+,14416,622483,24205904,8759,202367,21658845
1997-11-12,1998,43,W,4,3+,14325,636808,24205904,8982,211349,21658845
1997-11-13,1998,44,W,4,3+,14220,651028,24205904,13214,224563,21658845
1997-11-14,1998,45,W,4,3+,15416,666444,24205904,14540,239103,21658845
1997-11-15,1998,46,W,4,3+,15696,682140,24205904,14177,253280,21658845
1997-11-16,1998,47,W,4,3+,16806,698946,24205904,13633,266913,21658845
1997-11-17,1998,48,W,4,3+,16960,715906,24205904,13502,280415,21658845
1997-11-18,1998,49,W,4,3+,17358,733264,24205904,7559,287974,21658845
1997-11-19,1998,50,W,4,3+,18359,751623,24205904,8999,296973,21658845
1997-11-20,1998,51,W,4,3+,19015,770638,24205904,7940,304913,21658845
1997-11-21,1998,52,W,4,3+,19498,790136,24205904,7965,312878,21658845
1997-11-22,1998,53,W,4,3+,20198,810334,24205904,8520,321398,21658845
1997-11-23,1998,54,W,4,3+,19455,829789,24205904,7420,328818,21658845
1997-11-24,1998,55,W,4,3+,18413,848202,24205904,7818,336636,21658845
1997-11-25,1998,56,W,4,3+,17716,865918,24205904,9651,346287,21658845
1997-11-26,1998,57,W,4,3+,18951,884869,24205904,14707,360994,21658845
1997-11-27,1998,58,W,4,3+,23542,908411,24205904,19582,380576,21658845
1997-11-28,1998,59,W,4,3+,27685,936096,24205904,23636,404212,21658845
1997-11-29,1998,60,W,4,3+,30377,966473,24205904,24665,428877,21658845
1997-11-30,1998,61,W,4,3+,26856,993329,24205904,21631,450508,21658845
1997-12-01,1998,62,W,4,3+,27431,1020760,24205904,18182,468690,21658845
1997-12-02,1998,63,W,4,3+,34099,1054859,24205904,24708,493398,21658845
1997-12-03,1998,64,W,4,3+,32108,1086967,24205904,22513,515911,21658845
1997-12-04,1998,65,W,4,3+,28042,1115009,24205904,19200,535111,21658845
1997-12-05,1998,66,W,4,3+,24686,1139695,24205904,13771,548882,21658845
1997-12-06,1998,67,W,4,3+,23207,1162902,24205904,13596,562478,21658845
1997-12-07,1998,68,W,4,3+,24517,1187419,24205904,18203,580681,21658845
1997-12-08,1998,69,W,4,3+,29316,1216735,24205904,23733,604414,21658845
1997-12-09,1998,70,W,4,3+,34123,1250858,24205904,28250,632664,21658845
1997-12-10,1998,71,W,4,3+,35978,1286836,24205904,27758,660422,21658845
1997-12-11,1998,72,W,4,3+,32460,1319296,24205904,22592,683014,21658845
1997-12-12,1998,73,W,4,3+,27488,1346784,24205904,14447,697461,21658845
1997-12-13,1998,74,W,4,3+,24636,1371420,24205904,11510,708971,21658845
1997-12-14,1998,75,W,4,3+,23095,1394515,24205904,15303,724274,21658845
1997-12-15,1998,76,W,4,3+,23845,1418360,24205904,15320,739594,21658845
1997-12-16,1998,77,W,4,3+,26763,1445123,24205904,18192,757786,21658845
1997-12-17,1998,78,W,4,3+,31874,1476997,24205904,23304,781090,21658845
1997-12-18,1998,79,W,4,3+,29830,1506827,24205904,21546,802636,21658845
1997-12-19,1998,80,W,4,3+,27000,1533827,24205904,13370,816006,21658845
1997-12-20,1998,81,W,4,3+,26751,1560578,24205904,13386,829392,21658845
1997-12-21,1998,82,W,4,3+,25583,1586161,24205904,12300,841692,21658845
1997-12-22,1998,83,W,4,3+,23830,1609991,24205904,11702,853394,21658845
1997-12-23,1998,84,W,4,3+,21751,1631742,24205904,9113,862507,21658845
1997-12-24,1998,85,W,4,3+,20529,1652271,24205904,7204,869711,21658845
1997-12-25,1998,86,W,4,3+,19683,1671954,24205904,6261,875972,21658845
1997-12-26,1998,87,W,4,3+,18958,1690912,24205904,5524,881496,21658845
1997-12-27,1998,88,W,4,3+,18548,1709460,24205904,5250,886746,21658845
1997-12-28,1998,89,W,4,3+,18125,1727585,24205904,4783,891529,21658845
1997-12-29,1998,90,W,4,3+,17605,1745190,24205904,4209,895738,21658845
1997-12-30,1998,91,W,4,3+,17279,1762469,24205904,3921,899659,21658845
1997-12-31,1998,92,W,4,3+,17183,1779652,24205904,3873,903532,21658845
1998-01-01,1998,93,W,4,3+,16896,1796548,24205904,3747,907279,21658845
1998-01-02,1998,94,W,4,3+,16941,1813489,24205904,5438,912717,21658845
1998-01-03,1998,95,W,4,3+,18325,1831814,24205904,6935,919652,21658845
1998-01-04,1998,96,W,4,3+,22111,1853925,24205904,14175,933827,21658845
1998-01-05,1998,97,W,4,3+,28405,1882330,24205904,21029,954856,21658845
1998-01-06,1998,98,W,4,3+,31164,1913494,24205904,24742,979598,21658845
1998-01-07,1998,99,W,4,3+,29400,1942894,24205904,20662,1000260,21658845
1998-01-08,1998,100,W,4,3+,26800,1969694,24205904,17712,1017972,21658845
1998-01-09,1998,101,W,4,3+,27057,1996751,24205904,16874,1034846,21658845
1998-01-10,1998,102,W,4,3+,27499,2024250,24205904,18841,1053687,21658845
1998-01-11,1998,103,W,4,3+,29329,2053579,24205904,20679,1074366,21658845
1998-01-12,1998,104,W,4,3+,43161,2096740,24205904,39744,1114110,21658845
1998-01-13,1998,105,W,4,3+,63150,2159890,24205904,59864,1173974,21658845
1998-01-14,1998,106,W,4,3+,70023,2229913,24205904,75035,1249009,21658845
1998-01-15,1998,107,W,4,3+,80011,2309924,24205904,85988,1334997,21658845
1998-01-16,1998,108,W,4,3+,97333,2407257,24205904,102711,1437708,21658845
1998-01-17,1998,109,W,4,3+,114933,2522190,24205904,115058,1552766,21658845
1998-01-18,1998,110,W,4,3+,121181,2643371,24205904,125248,1678014,21658845
1998-01-19,1998,111,W,4,3+,127623,2770994,24205904,129177,1807191,21658845
1998-01-20,1998,112,W,4,3+,124961,2895955,24205904,124222,1931413,21658845
1998-01-21,1998,113,W,4,3+,120960,3016915,24205904,120530,2051943,21658845
1998-01-22,1998,114,W,4,3+,115206,3132121,24205904,114798,2166741,21658845
1998-01-23,1998,115,W,4,3+,107343,3239464,24205904,102570,2269311,21658845
1998-01-24,1998,116,W,4,3+,101738,3341202,24205904,96733,2366044,21658845
1998-01-25,1998,117,W,4,3+,98064,3439266,24205904,93083,2459127,21658845
1998-01-26,1998,118,W,4,3+,93355,3532621,24205904,88580,2547707,21658845
1998-01-27,1998,119,W,4,3+,92763,3625384,24205904,88036,2635743,21658845
1998-01-28,1998,120,W,4,3+,94733,3720117,24205904,88229,2723972,21658845
1998-01-29,1998,121,W,4,3+,101753,3821870,24205904,98108,2822080,21658845
1998-01-30,1998,122,W,4,3+,111839,3933709,24205904,107612,2929692,21658845
1998-01-31,1998,123,W,4,3+,112517,4046226,24205904,108856,3038548,21658845
1998-02-01,1998,124,W,4,3+,110810,4157036,24205904,109147,3147695,21658845
1998-02-02,1998,125,W,4,3+,116799,4273835,24205904,118817,3266512,21658845
1998-02-03,1998,126,W,4,3+,180225,4454060,24205904,190682,3457194,21658845
1998-02-04,1998,127,W,4,3+,229378,4683438,24205904,240909,3698103,21658845
1998-02-05,1998,128,W,4,3+,247130,4930568,24205904,259547,3957650,21658845
1998-02-06,1998,129,W,4,3+,271123,5201691,24205904,283342,4240992,21658845
1998-02-07,1998,130,W,4,3+,286993,5488684,24205904,297268,4538260,21658845
1998-02-08,1998,131,W,4,3+,308013,5796697,24205904,311298,4849558,21658845
1998-02-09,1998,132,W,4,3+,301943,6098640,24205904,304498,5154056,21658845
1998-02-10,1998,133,W,4,3+,289688,6388328,24205904,291973,5446029,21658845
1998-02-11,1998,134,W,4,3+,270403,6658731,24205904,271149,5717178,21658845
1998-02-12,1998,135,W,4,3+,248882,6907613,24205904,250226,5967404,21658845
1998-02-13,1998,136,W,4,3+,236040,7143653,24205904,235790,6203194,21658845
1998-02-14,1998,137,W,4,3+,230013,7373666,24205904,233887,6437081,21658845
1998-02-15,1998,138,W,4,3+,240526,7614192,24205904,243027,6680108,21658845
1998-02-16,1998,139,W,4,3+,228683,7842875,24205904,233961,6914069,21658845
1998-02-17,1998,140,W,4,3+,223682,8066557,24205904,226385,7140454,21658845
1998-02-18,1998,141,W,4,3+,205198,8271755,24205904,207827,7348281,21658845
1998-02-19,1998,142,W,4,3+,195033,8466788,24205904,197410,7545691,21658845
1998-02-20,1998,143,W,4,3+,204521,8671309,24205904,206777,7752468,21658845
1998-02-21,1998,144,W,4,3+,195434,8866743,24205904,198035,7950503,21658845
1998-02-22,1998,145,W,4,3+,220605,9087348,24205904,223864,8174367,21658845
1998-02-23,1998,146,W,4,3+,217936,9305284,24205904,222335,8396702,21658845
1998-02-24,1998,147,W,4,3+,213794,9519078,24205904,214861,8611563,21658845
1998-02-25,1998,148,W,4,3+,198136,9717214,24205904,200528,8812091,21658845
1998-02-26,1998,149,W,4,3+,186338,9903552,24205904,186143,8998234,21658845
1998-02-27,1998,150,W,4,3+,173107,10076659,24205904,172795,9171029,21658845
1998-02-28,1998,151,W,4,3+,161837,10238496,24205904,159232,9330261,21658845
1998-03-01,1998,152,W,4,3+,151443,10389939,24205904,148497,9478758,21658845
1998-03-02,1998,153,W,4,3+,140900,10530839,24205904,138483,9617241,21658845
1998-03-03,1998,154,W,4,3+,134516,10665355,24205904,132570,9749811,21658845
1998-03-04,1998,155,W,4,3+,129511,10794866,24205904,126863,9876674,21658845
1998-03-05,1998,156,W,4,3+,123372,10918238,24205904,121828,9998502,21658845
1998-03-06,1998,157,W,4,3+,120592,11038830,24205904,119025,10117527,21658845
1998-03-07,1998,158,W,4,3+,115621,11154451,24205904,114595,10232122,21658845
1998-03-08,1998,159,W,4,3+,110021,11264472,24205904,108952,10341074,21658845
1998-03-09,1998,160,W,4,3+,104979,11369451,24205904,104046,10445120,21658845
1998-03-10,1998,161,W,4,3+,100071,11469522,24205904,97454,10542574,21658845
1998-03-11,1998,162,W,4,3+,94812,11564334,24205904,92048,10634622,21658845
1998-03-12,1998,163,W,4,3+,90303,11654637,24205904,86990,10721612,21658845
1998-03-13,1998,164,W,4,3+,86489,11741126,24205904,83077,10804689,21658845
1998-03-14,1998,165,W,4,3+,82963,11824089,24205904,79506,10884195,21658845
1998-03-15,1998,166,W,4,3+,80108,11904197,24205904,76659,10960854,21658845
1998-03-16,1998,167,W,4,3+,78228,11982425,24205904,74730,11035584,21658845
1998-03-17,1998,168,W,4,3+,76077,12058502,24205904,72549,11108133,21658845
1998-03-18,1998,169,W,4,3+,72677,12131179,24205904,69154,11177287,21658845
1998-03-19,1998,170,W,4,3+,71260,12202439,24205904,67732,11245019,21658845
1998-03-20,1998,171,W,4,3+,73375,12275814,24205904,69871,11314890,21658845
1998-03-21,1998,172,W,4,3+,74981,12350795,24205904,71646,11386536,21658845
1998-03-22,1998,173,W,4,3+,77433,12428228,24205904,74357,11460893,21658845
1998-03-23,1998,174,W,4,3+,81556,12509784,24205904,82639,11543532,21658845
1998-03-24,1998,175,W,4,3+,93729,12603513,24205904,96670,11640202,21658845
1998-03-25,1998,176,W,4,3+,116747,12720260,24205904,121649,11761851,21658845
1998-03-26,1998,177,W,4,3+,129564,12849824,24205904,134174,11896025,21658845
1998-03-27,1998,178,W,4,3+,136559,12986383,24205904,141730,12037755,21658845
1998-03-28,1998,179,W,4,3+,139210,13125593,24205904,140511,12178266,21658845
1998-03-29,1998,180,W,4,3+,138182,13263775,24205904,136511,12314777,21658845
1998-03-30,1998,181,W,4,3+,134753,13398528,24205904,130552,12445329,21658845
1998-03-31,1998,182,W,4,3+,128999,13527527,24205904,127048,12572377,21658845
1998-04-01,1998,183,W,4,3+,123048,13650575,24205904,121676,12694053,21658845
1998-04-02,1998,184,W,4,3+,116282,13766857,24205904,113574,12807627,21658845
1998-04-03,1998,185,W,4,3+,115807,13882664,24205904,115550,12923177,21658845
1998-04-04,1998,186,W,4,3+,115628,13998292,24205904,117367,13040544,21658845
1998-04-05,1998,187,W,4,3+,113417,14111709,24205904,113195,13153739,21658845
1998-04-06,1998,188,W,4,3+,110282,14221991,24205904,110490,13264229,21658845
1998-04-07,1998,189,W,4,3+,108115,14330106,24205904,107256,13371485,21658845
1998-04-08,1998,190,W,4,3+,105480,14435586,24205904,102367,13473852,21658845
1998-04-09,1998,191,W,4,3+,103751,14539337,24205904,101096,13574948,21658845
1998-04-10,1998,192,W,4,3+,101231,14640568,24205904,98882,13673830,21658845
1998-04-11,1998,193,W,4,3+,98437,14739005,24205904,96930,13770760,21658845
1998-04-12,1998,194,W,4,3+,96072,14835077,24205904,95074,13865834,21658845
1998-04-13,1998,195,W,4,3+,95415,14930492,24205904,96384,13962218,21658845
1998-04-14,1998,196,W,4,3+,94608,15025100,24205904,95778,14057996,21658845
1998-04-15,1998,197,W,4,3+,93816,15118916,24205904,94981,14152977,21658845
1998-04-16,1998,198,W,4,3+,90398,15209314,24205904,90321,14243298,21658845
1998-04-17,1998,199,W,4,3+,86806,15296120,24205904,85896,14329194,21658845
1998-04-18,1998,200,W,4,3+,82564,15378684,24205904,79736,14408930,21658845
1998-04-19,1998,201,W,4,3+,78812,15457496,24205904,75760,14484690,21658845
1998-04-20,1998,202,W,4,3+,76293,15533789,24205904,72562,14557252,21658845
1998-04-21,1998,203,W,4,3+,74239,15608028,24205904,70152,14627404,21658845
1998-04-22,1998,204,W,4,3+,71934,15679962,24205904,67905,14695309,21658845
1998-04-23,1998,205,W,4,3+,70521,15750483,24205904,66402,14761711,21658845
1998-04-24,1998,206,W,4,3+,71310,15821793,24205904,67130,14828841,21658845
1998-04-25,1998,207,W,4,3+,72555,15894348,24205904,68426,14897267,21658845
1998-04-26,1998,208,W,4,3+,73010,15967358,24205904,68368,14965635,21658845
1998-04-27,1998,209,W,4,3+,71679,16039037,24205904,67499,15033134,21658845
1998-04-28,1998,210,W,4,3+,71562,16110599,24205904,67340,15100474,21658845
1998-04-29,1998,211,W,4,3+,70682,16181281,24205904,66459,15166933,21658845
1998-04-30,1998,212,W,4,3+,69522,16250803,24205904,65281,15232214,21658845
1998-05-01,1998,213,W,4,3+,67798,16318601,24205904,63554,15295768,21658845
1998-05-02,1998,214,W,4,3+,68867,16387468,24205904,65963,15361731,21658845
1998-05-03,1998,215,W,4,3+,70357,16457825,24205904,68144,15429875,21658845
1998-05-04,1998,216,W,4,3+,72008,16529833,24205904,69998,15499873,21658845
1998-05-05,1998,217,W,4,3+,72751,16602584,24205904,71920,15571793,21658845
1998-05-06,1998,218,W,4,3+,72638,16675222,24205904,72961,15644754,21658845
1998-05-07,1998,219,W,4,3+,72499,16747721,24205904,70511,15715265,21658845
1998-05-08,1998,220,W,4,3+,71462,16819183,24205904,69471,15784736,21658845
1998-05-09,1998,221,W,4,3+,69343,16888526,24205904,67224,15851960,21658845
1998-05-10,1998,222,W,4,3+,67070,16955596,24205904,63802,15915762,21658845
1998-05-11,1998,223,W,4,3+,65986,17021582,24205904,61484,15977246,21658845
1998-05-12,1998,224,W,4,3+,65554,17087136,24205904,63533,16040779,21658845
1998-05-13,1998,225,W,4,3+,68015,17155151,24205904,66911,16107690,21658845
1998-05-14,1998,226,W,4,3+,71018,17226169,24205904,69912,16177602,21658845
1998-05-15,1998,227,W,4,3+,72901,17299070,24205904,71812,16249414,21658845
1998-05-16,1998,228,W,4,3+,72943,17372013,24205904,70556,16319970,21658845
1998-05-17,1998,229,W,4,3+,73075,17445088,24205904,67836,16387806,21658845
1998-05-18,1998,230,W,4,3+,74125,17519213,24205904,67929,16455735,21658845
1998-05-19,1998,231,W,4,3+,74232,17593445,24205904,67930,16523665,21658845
1998-05-20,1998,232,W,4,3+,73386,17666831,24205904,66869,16590534,21658845
1998-05-21,1998,233,W,4,3+,70984,17737815,24205904,64366,16654900,21658845
1998-05-22,1998,234,W,4,3+,68549,17806364,24205904,60294,16715194,21658845
1998-05-23,1998,235,W,4,3+,66231,17872595,24205904,57922,16773116,21658845
1998-05-24,1998,236,W,4,3+,64832,17937427,24205904,55917,16829033,21658845
1998-05-25,1998,237,W,4,3+,64629,18002056,24205904,55405,16884438,21658845
1998-05-26,1998,238,W,4,3+,65187,18067243,24205904,56499,16940937,21658845
1998-05-27,1998,239,W,4,3+,67359,18134602,24205904,59424,17000361,21658845
1998-05-28,1998,240,W,4,3+,71344,18205946,24205904,67559,17067920,21658845
1998-05-29,1998,241,W,4,3+,77771,18283717,24205904,75553,17143473,21658845
1998-05-30,1998,242,W,4,3+,83799,18367516,24205904,81558,17225031,21658845
1998-05-31,1998,243,W,4,3+,90577,18458093,24205904,88533,17313564,21658845
1998-06-01,1998,244,W,4,3+,101774,18559867,24205904,99772,17413336,21658845
1998-06-02,1998,245,W,4,3+,111121,18670988,24205904,105153,17518489,21658845
1998-06-03,1998,246,W,4,3+,106331,18777319,24205904,100078,17618567,21658845
1998-06-04,1998,247,W,4,3+,99257,18876576,24205904,92678,17711245,21658845
1998-06-05,1998,248,W,4,3+,92648,18969224,24205904,85883,17797128,21658845
1998-06-06,1998,249,W,4,3+,89566,19058790,24205904,82231,17879359,21658845
1998-06-07,1998,250,W,4,3+,88449,19147239,24205904,82171,17961530,21658845
1998-06-08,1998,251,W,4,3+,86643,19233882,24205904,79624,18041154,21658845
1998-06-09,1998,252,W,4,3+,84482,19318364,24205904,77166,18118320,21658845
1998-06-10,1998,253,W,4,3+,81665,19400029,24205904,74669,18192989,21658845
1998-06-11,1998,254,W,4,3+,79704,19479733,24205904,72216,18265205,21658845
1998-06-12,1998,255,W,4,3+,78408,19558141,24205904,70469,18335674,21658845
1998-06-13,1998,256,W,4,3+,78890,19637031,24205904,70947,18406621,21658845
1998-06-14,1998,257,W,4,3+,79271,19716302,24205904,71294,18477915,21658845
1998-06-15,1998,258,W,4,3+,80816,19797118,24205904,72773,18550688,21658845
1998-06-16,1998,259,W,4,3+,82739,19879857,24205904,75013,18625701,21658845
1998-06-17,1998,260,W,4,3+,83245,19963102,24205904,75343,18701044,21658845
1998-06-18,1998,261,W,4,3+,82241,20045343,24205904,73831,18774875,21658845
1998-06-19,1998,262,W,4,3+,79659,20125002,24205904,70288,18845163,21658845
1998-06-20,1998,263,W,4,3+,74633,20199635,24205904,65117,18910280,21658845
1998-06-21,1998,264,W,4,3+,72140,20271775,24205904,61568,18971848,21658845
1998-06-22,1998,265,W,4,3+,71293,20343068,24205904,61166,19033014,21658845
1998-06-23,1998,266,W,4,3+,70931,20413999,24205904,60060,19093074,21658845
1998-06-24,1998,267,W,4,3+,69986,20483985,24205904,59666,19152740,21658845
1998-06-25,1998,268,W,4,3+,68511,20552496,24205904,57027,19209767,21658845
1998-06-26,1998,269,W,4,3+,66014,20618510,24205904,52487,19262254,21658845
1998-06-27,1998,270,W,4,3+,64363,20682873,24205904,51098,19313352,21658845
1998-06-28,1998,271,W,4,3+,63771,20746644,24205904,50675,19364027,21658845
1998-06-29,1998,272,W,4,3+,63045,20809689,24205904,49848,19413875,21658845
1998-06-30,1998,273,W,4,3+,61818,20871507,24205904,48984,19462859,21658845
1998-07-01,1998,274,W,4,3+,59984,20931491,24205904,47830,19510689,21658845
1998-07-02,1998,275,W,4,3+,57439,20988930,24205904,44807,19555496,21658845
1998-07-03,1998,276,W,4,3+,54812,21043742,24205904,42533,19598029,21658845
1998-07-04,1998,277,W,4,3+,53066,21096808,24205904,41279,19639308,21658845
1998-07-05,1998,278,W,4,3+,51512,21148320,24205904,39871,19679179,21658845
1998-07-06,1998,279,W,4,3+,51137,21199457,24205904,39171,19718350,21658845
1998-07-07,1998,280,W,4,3+,50723,21250180,24205904,40209,19758559,21658845
1998-07-08,1998,281,W,4,3+,49220,21299400,24205904,40628,19799187,21658845
1998-07-09,1998,282,W,4,3+,48918,21348318,24205904,39673,19838860,21658845
1998-07-10,1998,283,W,4,3+,48528,21396846,24205904,36460,19875320,21658845
1998-07-11,1998,284,W,4,3+,48529,21445375,24205904,36164,19911484,21658845
1998-07-12,1998,285,W,4,3+,48317,21493692,24205904,36189,19947673,21658845
1998-07-13,1998,286,W,4,3+,47794,21541486,24205904,38749,19986422,21658845
1998-07-14,1998,287,W,4,3+,47000,21588486,24205904,37152,20023574,21658845
1998-07-15,1998,288,W,4,3+,44810,21633296,24205904,30761,20054335,21658845
1998-07-16,1998,289,W,4,3+,43014,21676310,24205904,28935,20083270,21658845
1998-07-17,1998,290,W,4,3+,42109,21718419,24205904,27922,20111192,21658845
1998-07-18,1998,291,W,4,3+,40112,21758531,24205904,27264,20138456,21658845
1998-07-19,1998,292,W,4,3+,38906,21797437,24205904,25978,20164434,21658845
1998-07-20,1998,293,W,4,3+,37989,21835426,24205904,25320,20189754,21658845
1998-07-21,1998,294,W,4,3+,37758,21873184,24205904,24260,20214014,21658845
1998-07-22,1998,295,W,4,3+,36930,21910114,24205904,24287,20238301,21658845
1998-07-23,1998,296,W,4,3+,36417,21946531,24205904,23712,20262013,21658845
1998-07-24,1998,297,W,4,3+,36070,21982601,24205904,23010,20285023,21658845
1998-07-25,1998,298,W,4,3+,35997,22018598,24205904,22923,20307946,21658845
1998-07-26,1998,299,W,4,3+,35354,22053952,24205904,19886,20327832,21658845
1998-07-27,1998,300,W,4,3+,34660,22088612,24205904,21650,20349482,21658845
1998-07-28,1998,301,W,4,3+,34594,22123206,24205904,21496,20370978,21658845
1998-07-29,1998,302,W,4,3+,34665,22157871,24205904,21731,20392709,21658845
1998-07-30,1998,303,W,4,3+,34293,22192164,24205904,21375,20414084,21658845
1998-07-31,1998,304,W,4,3+,33857,22226021,24205904,20941,20435025,21658845
1998-08-01,1998,305,W,4,3+,33170,22259191,24205904,20206,20455231,21658845
1998-08-02,1998,306,W,4,3+,33035,22292226,24205904,17708,20472939,21658845
1998-08-03,1998,307,W,4,3+,33069,22325295,24205904,20097,20493036,21658845
1998-08-04,1998,308,W,4,3+,33383,22358678,24205904,20093,20513129,21658845
1998-08-05,1998,309,W,4,3+,33280,22391958,24205904,20139,20533268,21658845
1998-08-06,1998,310,W,4,3+,33271,22425229,24205904,21558,20554826,21658845
1998-08-07,1998,311,W,4,3+,33153,22458382,24205904,19729,20574555,21658845
1998-08-08,1998,312,W,4,3+,32749,22491131,24205904,19401,20593956,21658845
1998-08-09,1998,313,W,4,3+,33090,22524221,24205904,18157,20612113,21658845
1998-08-10,1998,314,W,4,3+,33452,22557673,24205904,20674,20632787,21658845
1998-08-11,1998,315,W,4,3+,33554,22591227,24205904,20278,20653065,21658845
1998-08-12,1998,316,W,4,3+,32990,22624217,24205904,20496,20673561,21658845
1998-08-13,1998,317,W,4,3+,32926,22657143,24205904,19926,20693487,21658845
1998-08-14,1998,318,W,4,3+,33362,22690505,24205904,20292,20713779,21658845
1998-08-15,1998,319,W,4,3+,33466,22723971,24205904,20465,20734244,21658845
1998-08-16,1998,320,W,4,3+,32644,22756615,24205904,17381,20751625,21658845
1998-08-17,1998,321,W,4,3+,32159,22788774,24205904,19183,20770808,21658845
1998-08-18,1998,322,W,4,3+,32092,22820866,24205904,19209,20790017,21658845
1998-08-19,1998,323,W,4,3+,32255,22853121,24205904,19700,20809717,21658845
1998-08-20,1998,324,W,4,3+,32705,22885826,24205904,20772,20830489,21658845
1998-08-21,1998,325,W,4,3+,33307,22919133,24205904,21611,20852100,21658845
1998-08-22,1998,326,W,4,3+,33275,22952408,24205904,21608,20873708,21658845
1998-08-23,1998,327,W,4,3+,33297,22985705,24205904,19753,20893461,21658845
1998-08-24,1998,328,W,4,3+,33605,23019310,24205904,21093,20914554,21658845
1998-08-25,1998,329,W,4,3+,33452,23052762,24205904,20871,20935425,21658845
1998-08-26,1998,330,W,4,3+,33105,23085867,24205904,20837,20956262,21658845
1998-08-27,1998,331,W,4,3+,32849,23118716,24205904,20890,20977152,21658845
1998-08-28,1998,332,W,4,3+,32908,23151624,24205904,20860,20998012,21658845
1998-08-29,1998,333,W,4,3+,32568,23184192,24205904,20136,21018148,21658845
1998-08-30,1998,334,W,4,3+,32215,23216407,24205904,17660,21035808,21658845
1998-08-31,1998,335,W,4,3+,32241,23248648,24205904,19535,21055343,21658845
1998-09-01,1998,336,W,4,3+,31976,23280624,24205904,20204,21075547,21658845
1998-09-02,1998,337,W,4,3+,32177,23312801,24205904,21846,21097393,21658845
1998-09-03,1998,338,W,4,3+,32555,23345356,24205904,20569,21117962,21658845
1998-09-04,1998,339,W,4,3+,33060,23378416,24205904,20767,21138729,21658845
1998-09-05,1998,340,W,4,3+,34238,23412654,24205904,22203,21160932,21658845
1998-09-06,1998,341,W,4,3+,34884,23447538,24205904,21993,21182925,21658845
1998-09-07,1998,342,W,4,3+,35235,23482773,24205904,22530,21205455,21658845
1998-09-08,1998,343,W,4,3+,35133,23517906,24205904,23556,21229011,21658845
1998-09-09,1998,344,W,4,3+,34481,23552387,24205904,23489,21252500,21658845
1998-09-10,1998,345,W,4,3+,33812,23586199,24205904,23197,21275697,21658845
1998-09-11,1998,346,W,4,3+,34773,23620972,24205904,23656,21299353,21658845
1998-09-12,1998,347,W,4,3+,33916,23654888,24205904,21692,21321045,21658845
1998-09-13,1998,348,W,4,3+,32862,23687750,24205904,19102,21340147,21658845
1998-09-14,1998,349,W,4,3+,31830,23719580,24205904,20016,21360163,21658845
1998-09-15,1998,350,W,4,3+,31491,23751071,24205904,20918,21381081,21658845
1998-09-16,1998,351,W,4,3+,31012,23782083,24205904,18912,21399993,21658845
1998-09-17,1998,352,W,4,3+,30236,23812319,24205904,19588,21419581,21658845
1998-09-18,1998,353,W,4,3+,30868,23843187,24205904,20177,21439758,21658845
1998-09-19,1998,354,W,4,3+,30637,23873824,24205904,18551,21458309,21658845
1998-09-20,1998,355,W,4,3+,30725,23904549,24205904,18460,21476769,21658845
1998-09-21,1998,356,W,4,3+,30534,23935083,24205904,19156,21495925,21658845
1998-09-22,1998,357,W,4,3+,29669,23964752,24205904,18398,21514323,21658845
1998-09-23,1998,358,W,4,3+,30458,23995210,24205904,19191,21533514,21658845
1998-09-24,1998,359,W,4,3+,30362,24025572,24205904,19338,21552852,21658845
1998-09-25,1998,360,W,4,3+,30247,24055819,24205904,18146,21570998,21658845
1998-09-26,1998,361,W,4,3+,29918,24085737,24205904,17081,21588079,21658845
1998-09-27,1998,362,W,4,3+,30009,24115746,24205904,18015,21606094,21658845
1998-09-28,1998,363,W,4,3+,30049,24145795,24205904,17586,21623680,21658845
1998-09-29,1998,364,W,4,3+,29793,24175588,24205904,18023,21641703,21658845
1998-09-30,1998,365,W,4,3+,30316,24205904,24205904,17142,21658845,21658845
1998-10-01,1999,1,W,5,3+,30335,30335,14301366,18817,18817,11376810
1998-10-02,1999,2,W,5,3+,29831,60166,14301366,18388,37205,11376810
1998-10-03,1999,3,W,5,3+,29085,89251,14301366,17415,54620,11376810
1998-10-04,1999,4,W,5,3+,27556,116807,14301366,14695,69315,11376810
1998-10-05,1999,5,W,5,3+,27203,144010,14301366,15512,84827,11376810
1998-10-06,1999,6,W,5,3+,26154,170164,14301366,14491,99318,11376810
1998-10-07,1999,7,W,5,3+,25291,195455,14301366,13707,113025,11376810
1998-10-08,1999,8,W,5,3+,25141,220596,14301366,13737,126762,11376810
1998-10-09,1999,9,W,5,3+,24312,244908,14301366,12820,139582,11376810
1998-10-10,1999,10,W,5,3+,23857,268765,14301366,12935,152517,11376810
1998-10-11,1999,11,W,5,3+,23387,292152,14301366,11749,164266,11376810
1998-10-12,1999,12,W,5,3+,23391,315543,14301366,12430,176696,11376810
1998-10-13,1999,13,W,5,3+,23058,338601,14301366,11948,188644,11376810
1998-10-14,1999,14,W,5,3+,22205,360806,14301366,11083,199727,11376810
1998-10-15,1999,15,W,5,3+,21861,382667,14301366,10439,210166,11376810
1998-10-16,1999,16,W,5,3+,21541,404208,14301366,10584,220750,11376810
1998-10-17,1999,17,W,5,3+,21037,425245,14301366,9593,230343,11376810
1998-10-18,1999,18,W,5,3+,20526,445771,14301366,8104,238447,11376810
1998-10-19,1999,19,W,5,3+,19895,465666,14301366,8496,246943,11376810
1998-10-20,1999,20,W,5,3+,19422,485088,14301366,8059,255002,11376810
1998-10-21,1999,21,W,5,3+,18851,503939,14301366,7596,262598,11376810
1998-10-22,1999,22,W,5,3+,18252,522191,14301366,6899,269497,11376810
1998-10-23,1999,23,W,5,3+,18264,540455,14301366,7320,276817,11376810
1998-10-24,1999,24,W,5,3+,18855,559310,14301366,13122,289939,11376810
1998-10-25,1999,25,W,5,3+,19889,579199,14301366,12946,302885,11376810
1998-10-26,1999,26,W,5,3+,20184,599383,14301366,14799,317684,11376810
1998-10-27,1999,27,W,5,3+,20442,619825,14301366,15183,332867,11376810
1998-10-28,1999,28,W,5,3+,21634,641459,14301366,16725,349592,11376810
1998-10-29,1999,29,W,5,3+,20762,662221,14301366,10813,360405,11376810
1998-10-30,1999,30,W,5,3+,20824,683045,14301366,10595,371000,11376810
1998-10-31,1999,31,W,5,3+,20070,703115,14301366,10219,381219,11376810
1998-11-01,1999,32,W,5,3+,18783,721898,14301366,6886,388105,11376810
1998-11-02,1999,33,W,5,3+,19447,741345,14301366,8710,396815,11376810
1998-11-03,1999,34,W,5,3+,19022,760367,14301366,9336,406151,11376810
1998-11-04,1999,35,W,5,3+,18113,778480,14301366,9355,415506,11376810
1998-11-05,1999,36,W,5,3+,17912,796392,14301366,8534,424040,11376810
1998-11-06,1999,37,W,5,3+,17690,814082,14301366,8513,432553,11376810
1998-11-07,1999,38,W,5,3+,17626,831708,14301366,9881,442434,11376810
1998-11-08,1999,39,W,5,3+,18769,850477,14301366,10878,453312,11376810
1998-11-09,1999,40,W,5,3+,19103,869580,14301366,13126,466438,11376810
1998-11-10,1999,41,W,5,3+,19625,889205,14301366,14409,480847,11376810
1998-11-11,1999,42,W,5,3+,20361,909566,14301366,14561,495408,11376810
1998-11-12,1999,43,W,5,3+,20468,930034,14301366,13306,508714,11376810
1998-11-13,1999,44,W,5,3+,20658,950692,14301366,12475,521189,11376810
1998-11-14,1999,45,W,5,3+,20666,971358,14301366,13348,534537,11376810
1998-11-15,1999,46,W,5,3+,20778,992136,14301366,14363,548900,11376810
1998-11-16,1999,47,W,5,3+,21376,1013512,14301366,16561,565461,11376810
1998-11-17,1999,48,W,5,3+,21934,1035446,14301366,18324,583785,11376810
1998-11-18,1999,49,W,5,3+,22525,1057971,14301366,19455,603240,11376810
1998-11-19,1999,50,W,5,3+,23151,1081122,14301366,19775,623015,11376810
1998-11-20,1999,51,W,5,3+,25729,1106851,14301366,22258,645273,11376810
1998-11-21,1999,52,W,5,3+,26824,1133675,14301366,23580,668853,11376810
1998-11-22,1999,53,W,5,3+,27585,1161260,14301366,24208,693061,11376810
1998-11-23,1999,54,W,5,3+,27856,1189116,14301366,29911,722972,11376810
1998-11-24,1999,55,W,5,3+,32025,1221141,14301366,35092,758064,11376810
1998-11-25,1999,56,W,5,3+,36589,1257730,14301366,39696,797760,11376810
1998-11-26,1999,57,W,5,3+,39132,1296862,14301366,40742,838502,11376810
1998-11-27,1999,58,W,5,3+,38397,1335259,14301366,42887,881389,11376810
1998-11-28,1999,59,W,5,3+,37976,1373235,14301366,37255,918644,11376810
1998-11-29,1999,60,W,5,3+,38299,1411534,14301366,37995,956639,11376810
1998-11-30,1999,61,W,5,3+,38483,1450017,14301366,41673,998312,11376810
1998-12-01,1999,62,W,5,3+,42935,1492952,14301366,47052,1045364,11376810
1998-12-02,1999,63,W,5,3+,49629,1542581,14301366,49892,1095256,11376810
1998-12-03,1999,64,W,5,3+,55917,1598498,14301366,56718,1151974,11376810
1998-12-04,1999,65,W,5,3+,61495,1659993,14301366,61450,1213424,11376810
1998-12-05,1999,66,W,5,3+,65328,1725321,14301366,62934,1276358,11376810
1998-12-06,1999,67,W,5,3+,67906,1793227,14301366,65515,1341873,11376810
1998-12-07,1999,68,W,5,3+,69194,1862421,14301366,66751,1408624,11376810
1998-12-08,1999,69,W,5,3+,69997,1932418,14301366,66396,1475020,11376810
1998-12-09,1999,70,W,5,3+,69603,2002021,14301366,66009,1541029,11376810
1998-12-10,1999,71,W,5,3+,67970,2069991,14301366,63716,1604745,11376810
1998-12-11,1999,72,W,5,3+,65824,2135815,14301366,61586,1666331,11376810
1998-12-12,1999,73,W,5,3+,64313,2200128,14301366,59872,1726203,11376810
1998-12-13,1999,74,W,5,3+,62443,2262571,14301366,58445,1784648,11376810
1998-12-14,1999,75,W,5,3+,60876,2323447,14301366,56801,1841449,11376810
1998-12-15,1999,76,W,5,3+,59742,2383189,14301366,55659,1897108,11376810
1998-12-16,1999,77,W,5,3+,58553,2441742,14301366,54420,1951528,11376810
1998-12-17,1999,78,W,5,3+,56051,2497793,14301366,50338,2001866,11376810
1998-12-18,1999,79,W,5,3+,51977,2549770,14301366,44806,2046672,11376810
1998-12-19,1999,80,W,5,3+,48515,2598285,14301366,43216,2089888,11376810
1998-12-20,1999,81,W,5,3+,46113,2644398,14301366,42325,2132213,11376810
1998-12-21,1999,82,W,5,3+,44521,2688919,14301366,40375,2172588,11376810
1998-12-22,1999,83,W,5,3+,42823,2731742,14301366,39738,2212326,11376810
1998-12-23,1999,84,W,5,3+,40524,2772266,14301366,35124,2247450,11376810
1998-12-24,1999,85,W,5,3+,37776,2810042,14301366,32366,2279816,11376810
1998-12-25,1999,86,W,5,3+,34502,2844544,14301366,29982,2309798,11376810
1998-12-26,1999,87,W,5,3+,32123,2876667,14301366,29002,2338800,11376810
1998-12-27,1999,88,W,5,3+,30711,2907378,14301366,25743,2364543,11376810
1998-12-28,1999,89,W,5,3+,29901,2937279,14301366,25808,2390351,11376810
1998-12-29,1999,90,W,5,3+,29150,2966429,14301366,24946,2415297,11376810
1998-12-30,1999,91,W,5,3+,28315,2994744,14301366,24150,2439447,11376810
1998-12-31,1999,92,W,5,3+,27261,3022005,14301366,23345,2462792,11376810
1999-01-01,1999,93,W,5,3+,26467,3048472,14301366,22558,2485350,11376810
1999-01-02,1999,94,W,5,3+,25814,3074286,14301366,21934,2507284,11376810
1999-01-03,1999,95,W,5,3+,25648,3099934,14301366,21836,2529120,11376810
1999-01-04,1999,96,W,5,3+,25321,3125255,14301366,22402,2551522,11376810
1999-01-05,1999,97,W,5,3+,25192,3150447,14301366,22540,2574062,11376810
1999-01-06,1999,98,W,5,3+,24825,3175272,14301366,21429,2595491,11376810
1999-01-07,1999,99,W,5,3+,24424,3199696,14301366,20675,2616166,11376810
1999-01-08,1999,100,W,5,3+,23534,3223230,14301366,19731,2635897,11376810
1999-01-09,1999,101,W,5,3+,22828,3246058,14301366,19326,2655223,11376810
1999-01-10,1999,102,W,5,3+,21963,3268021,14301366,18345,2673568,11376810
1999-01-11,1999,103,W,5,3+,21566,3289587,14301366,17935,2691503,11376810
1999-01-12,1999,104,W,5,3+,21457,3311044,14301366,17898,2709401,11376810
1999-01-13,1999,105,W,5,3+,21447,3332491,14301366,16155,2725556,11376810
1999-01-14,1999,106,W,5,3+,21318,3353809,14301366,13189,2738745,11376810
1999-01-15,1999,107,W,5,3+,20905,3374714,14301366,15814,2754559,11376810
1999-01-16,1999,108,W,5,3+,21252,3395966,14301366,16564,2771123,11376810
1999-01-17,1999,109,W,5,3+,22275,3418241,14301366,17633,2788756,11376810
1999-01-18,1999,110,W,5,3+,24508,3442749,14301366,24259,2813015,11376810
1999-01-19,1999,111,W,5,3+,31036,3473785,14301366,33642,2846657,11376810
1999-01-20,1999,112,W,5,3+,46657,3520442,14301366,45891,2892548,11376810
1999-01-21,1999,113,W,5,3+,67918,3588360,14301366,67886,2960434,11376810
1999-01-22,1999,114,W,5,3+,73157,3661517,14301366,73077,3033511,11376810
1999-01-23,1999,115,W,5,3+,76300,3737817,14301366,72830,3106341,11376810
1999-01-24,1999,116,W,5,3+,81196,3819013,14301366,74510,3180851,11376810
1999-01-25,1999,117,W,5,3+,81494,3900507,14301366,74523,3255374,11376810
1999-01-26,1999,118,W,5,3+,78263,3978770,14301366,71028,3326402,11376810
1999-01-27,1999,119,W,5,3+,75495,4054265,14301366,71538,3397940,11376810
1999-01-28,1999,120,W,5,3+,71540,4125805,14301366,66580,3464520,11376810
1999-01-29,1999,121,W,5,3+,66851,4192656,14301366,62071,3526591,11376810
1999-01-30,1999,122,W,5,3+,62021,4254677,14301366,56904,3583495,11376810
1999-01-31,1999,123,W,5,3+,58879,4313556,14301366,57970,3641465,11376810
1999-02-01,1999,124,W,5,3+,55237,4368793,14301366,53984,3695449,11376810
1999-02-02,1999,125,W,5,3+,50826,4419619,14301366,49607,3745056,11376810
1999-02-03,1999,126,W,5,3+,46206,4465825,14301366,44934,3789990,11376810
1999-02-04,1999,127,W,5,3+,42927,4508752,14301366,41522,3831512,11376810
1999-02-05,1999,128,W,5,3+,42321,4551073,14301366,36702,3868214,11376810
1999-02-06,1999,129,W,5,3+,43879,4594952,14301366,41029,3909243,11376810
1999-02-07,1999,130,W,5,3+,62565,4657517,14301366,63910,3973153,11376810
1999-02-08,1999,131,W,5,3+,76140,4733657,14301366,78538,4051691,11376810
1999-02-09,1999,132,W,5,3+,96867,4830524,14301366,101954,4153645,11376810
1999-02-10,1999,133,W,5,3+,123036,4953560,14301366,128184,4281829,11376810
1999-02-11,1999,134,W,5,3+,141418,5094978,14301366,143179,4425008,11376810
1999-02-12,1999,135,W,5,3+,135450,5230428,14301366,133170,4558178,11376810
1999-02-13,1999,136,W,5,3+,126270,5356698,14301366,124294,4682472,11376810
1999-02-14,1999,137,W,5,3+,117551,5474249,14301366,111619,4794091,11376810
1999-02-15,1999,138,W,5,3+,109458,5583707,14301366,104093,4898184,11376810
1999-02-16,1999,139,W,5,3+,101246,5684953,14301366,97469,4995653,11376810
1999-02-17,1999,140,W,5,3+,105218,5790171,14301366,102499,5098152,11376810
1999-02-18,1999,141,W,5,3+,129081,5919252,14301366,126505,5224657,11376810
1999-02-19,1999,142,W,5,3+,137080,6056332,14301366,134562,5359219,11376810
1999-02-20,1999,143,W,5,3+,134170,6190502,14301366,135703,5494922,11376810
1999-02-21,1999,144,W,5,3+,135924,6326426,14301366,137023,5631945,11376810
1999-02-22,1999,145,W,5,3+,135740,6462166,14301366,135618,5767563,11376810
1999-02-23,1999,146,W,5,3+,130759,6592925,14301366,129116,5896679,11376810
1999-02-24,1999,147,W,5,3+,120224,6713149,14301366,117443,6014122,11376810
1999-02-25,1999,148,W,5,3+,112097,6825246,14301366,105250,6119372,11376810
1999-02-26,1999,149,W,5,3+,107601,6932847,14301366,99416,6218788,11376810
1999-02-27,1999,150,W,5,3+,103953,7036800,14301366,95144,6313932,11376810
1999-02-28,1999,151,W,5,3+,101251,7138051,14301366,94055,6407987,11376810
1999-03-01,1999,152,W,5,3+,102144,7240195,14301366,94931,6502918,11376810
1999-03-02,1999,153,W,5,3+,106715,7346910,14301366,99065,6601983,11376810
1999-03-03,1999,154,W,5,3+,110153,7457063,14301366,103401,6705384,11376810
1999-03-04,1999,155,W,5,3+,111792,7568855,14301366,103650,6809034,11376810
1999-03-05,1999,156,W,5,3+,110156,7679011,14301366,101673,6910707,11376810
1999-03-06,1999,157,W,5,3+,108406,7787417,14301366,99417,7010124,11376810
1999-03-07,1999,158,W,5,3+,104273,7891690,14301366,95019,7105143,11376810
1999-03-08,1999,159,W,5,3+,99845,7991535,14301366,92396,7197539,11376810
1999-03-09,1999,160,W,5,3+,97523,8089058,14301366,90730,7288269,11376810
1999-03-10,1999,161,W,5,3+,94269,8183327,14301366,88536,7376805,11376810
1999-03-11,1999,162,W,5,3+,90782,8274109,14301366,83683,7460488,11376810
1999-03-12,1999,163,W,5,3+,87493,8361602,14301366,80432,7540920,11376810
1999-03-13,1999,164,W,5,3+,83899,8445501,14301366,74216,7615136,11376810
1999-03-14,1999,165,W,5,3+,80925,8526426,14301366,70020,7685156,11376810
1999-03-15,1999,166,W,5,3+,77796,8604222,14301366,68675,7753831,11376810
1999-03-16,1999,167,W,5,3+,74903,8679125,14301366,65594,7819425,11376810
1999-03-17,1999,168,W,5,3+,71327,8750452,14301366,62467,7881892,11376810
1999-03-18,1999,169,W,5,3+,67298,8817750,14301366,58616,7940508,11376810
1999-03-19,1999,170,W,5,3+,63363,8881113,14301366,54510,7995018,11376810
1999-03-20,1999,171,W,5,3+,60310,8941423,14301366,52960,8047978,11376810
1999-03-21,1999,172,W,5,3+,56230,8997653,14301366,47964,8095942,11376810
1999-03-22,1999,173,W,5,3+,52982,9050635,14301366,45840,8141782,11376810
1999-03-23,1999,174,W,5,3+,49825,9100460,14301366,42412,8184194,11376810
1999-03-24,1999,175,W,5,3+,46688,9147148,14301366,39766,8223960,11376810
1999-03-25,1999,176,W,5,3+,45554,9192702,14301366,39888,8263848,11376810
1999-03-26,1999,177,W,5,3+,49675,9242377,14301366,44654,8308502,11376810
1999-03-27,1999,178,W,5,3+,55372,9297749,14301366,50708,8359210,11376810
1999-03-28,1999,179,W,5,3+,56949,9354698,14301366,51370,8410580,11376810
1999-03-29,1999,180,W,5,3+,56443,9411141,14301366,48779,8459359,11376810
1999-03-30,1999,181,W,5,3+,54151,9465292,14301366,46935,8506294,11376810
1999-03-31,1999,182,W,5,3+,50666,9515958,14301366,44014,8550308,11376810
1999-04-01,1999,183,W,5,3+,46429,9562387,14301366,39704,8590012,11376810
1999-04-02,1999,184,W,5,3+,42488,9604875,14301366,36409,8626421,11376810
1999-04-03,1999,185,W,5,3+,39799,9644674,14301366,32684,8659105,11376810
1999-04-04,1999,186,W,5,3+,38037,9682711,14301366,30684,8689789,11376810
1999-04-05,1999,187,W,5,3+,36646,9719357,14301366,31162,8720951,11376810
1999-04-06,1999,188,W,5,3+,37117,9756474,14301366,33555,8754506,11376810
1999-04-07,1999,189,W,5,3+,36554,9793028,14301366,33190,8787696,11376810
1999-04-08,1999,190,W,5,3+,37347,9830375,14301366,34028,8821724,11376810
1999-04-09,1999,191,W,5,3+,38719,9869094,14301366,34368,8856092,11376810
1999-04-10,1999,192,W,5,3+,38818,9907912,14301366,31154,8887246,11376810
1999-04-11,1999,193,W,5,3+,40288,9948200,14301366,32658,8919904,11376810
1999-04-12,1999,194,W,5,3+,42902,9991102,14301366,34970,8954874,11376810
1999-04-13,1999,195,W,5,3+,47779,10038881,14301366,40427,8995301,11376810
1999-04-14,1999,196,W,5,3+,49883,10088764,14301366,43753,9039054,11376810
1999-04-15,1999,197,W,5,3+,48346,10137110,14301366,40562,9079616,11376810
1999-04-16,1999,198,W,5,3+,46583,10183693,14301366,37685,9117301,11376810
1999-04-17,1999,199,W,5,3+,45885,10229578,14301366,40266,9157567,11376810
1999-04-18,1999,200,W,5,3+,45762,10275340,14301366,40115,9197682,11376810
1999-04-19,1999,201,W,5,3+,45848,10321188,14301366,41211,9238893,11376810
1999-04-20,1999,202,W,5,3+,45185,10366373,14301366,40495,9279388,11376810
1999-04-21,1999,203,W,5,3+,44531,10410904,14301366,39044,9318432,11376810
1999-04-22,1999,204,W,5,3+,43966,10454870,14301366,39109,9357541,11376810
1999-04-23,1999,205,W,5,3+,41472,10496342,14301366,36611,9394152,11376810
1999-04-24,1999,206,W,5,3+,39658,10536000,14301366,33846,9427998,11376810
1999-04-25,1999,207,W,5,3+,38355,10574355,14301366,32894,9460892,11376810
1999-04-26,1999,208,W,5,3+,37144,10611499,14301366,31767,9492659,11376810
1999-04-27,1999,209,W,5,3+,36335,10647834,14301366,30969,9523628,11376810
1999-04-28,1999,210,W,5,3+,36034,10683868,14301366,30891,9554519,11376810
1999-04-29,1999,211,W,5,3+,35712,10719580,14301366,30543,9585062,11376810
1999-04-30,1999,212,W,5,3+,35270,10754850,14301366,30060,9615122,11376810
1999-05-01,1999,213,W,5,3+,34468,10789318,14301366,28326,9643448,11376810
1999-05-02,1999,214,W,5,3+,34183,10823501,14301366,28358,9671806,11376810
1999-05-03,1999,215,W,5,3+,34335,10857836,14301366,30377,9702183,11376810
1999-05-04,1999,216,W,5,3+,34925,10892761,14301366,29984,9732167,11376810
1999-05-05,1999,217,W,5,3+,34331,10927092,14301366,29980,9762147,11376810
1999-05-06,1999,218,W,5,3+,33602,10960694,14301366,28788,9790935,11376810
1999-05-07,1999,219,W,5,3+,32234,10992928,14301366,27551,9818486,11376810
1999-05-08,1999,220,W,5,3+,30904,11023832,14301366,25786,9844272,11376810
1999-05-09,1999,221,W,5,3+,31295,11055127,14301366,25511,9869783,11376810
1999-05-10,1999,222,W,5,3+,31061,11086188,14301366,24989,9894772,11376810
1999-05-11,1999,223,W,5,3+,30148,11116336,14301366,25082,9919854,11376810
1999-05-12,1999,224,W,5,3+,28730,11145066,14301366,22572,9942426,11376810
1999-05-13,1999,225,W,5,3+,28246,11173312,14301366,22225,9964651,11376810
1999-05-14,1999,226,W,5,3+,27899,11201211,14301366,22579,9987230,11376810
1999-05-15,1999,227,W,5,3+,28066,11229277,14301366,22789,10010019,11376810
1999-05-16,1999,228,W,5,3+,27110,11256387,14301366,21702,10031721,11376810
1999-05-17,1999,229,W,5,3+,25436,11281823,14301366,20021,10051742,11376810
1999-05-18,1999,230,W,5,3+,23914,11305737,14301366,18219,10069961,11376810
1999-05-19,1999,231,W,5,3+,23331,11329068,14301366,16956,10086917,11376810
1999-05-20,1999,232,W,5,3+,23465,11352533,14301366,16960,10103877,11376810
1999-05-21,1999,233,W,5,3+,23454,11375987,14301366,17474,10121351,11376810
1999-05-22,1999,234,W,5,3+,23065,11399052,14301366,17008,10138359,11376810
1999-05-23,1999,235,W,5,3+,23670,11422722,14301366,17568,10155927,11376810
1999-05-24,1999,236,W,5,3+,24652,11447374,14301366,18329,10174256,11376810
1999-05-25,1999,237,W,5,3+,24575,11471949,14301366,18207,10192463,11376810
1999-05-26,1999,238,W,5,3+,24105,11496054,14301366,17953,10210416,11376810
1999-05-27,1999,239,W,5,3+,23778,11519832,14301366,17937,10228353,11376810
1999-05-28,1999,240,W,5,3+,23770,11543602,14301366,17968,10246321,11376810
1999-05-29,1999,241,W,5,3+,24540,11568142,14301366,18701,10265022,11376810
1999-05-30,1999,242,W,5,3+,24529,11592671,14301366,19149,10284171,11376810
1999-05-31,1999,243,W,5,3+,25467,11618138,14301366,20059,10304230,11376810
1999-06-01,1999,244,W,5,3+,25194,11643332,14301366,19358,10323588,11376810
1999-06-02,1999,245,W,5,3+,24748,11668080,14301366,18239,10341827,11376810
1999-06-03,1999,246,W,5,3+,25455,11693535,14301366,17778,10359605,11376810
1999-06-04,1999,247,W,5,3+,25591,11719126,14301366,17440,10377045,11376810
1999-06-05,1999,248,W,5,3+,26497,11745623,14301366,18228,10395273,11376810
1999-06-06,1999,249,W,5,3+,27074,11772697,14301366,18750,10414023,11376810
1999-06-07,1999,250,W,5,3+,26795,11799492,14301366,18489,10432512,11376810
1999-06-08,1999,251,W,5,3+,25677,11825169,14301366,17864,10450376,11376810
1999-06-09,1999,252,W,5,3+,23967,11849136,14301366,16486,10466862,11376810
1999-06-10,1999,253,W,5,3+,22859,11871995,14301366,15439,10482301,11376810
1999-06-11,1999,254,W,5,3+,21617,11893612,14301366,14773,10497074,11376810
1999-06-12,1999,255,W,5,3+,21219,11914831,14301366,13716,10510790,11376810
1999-06-13,1999,256,W,5,3+,20655,11935486,14301366,13056,10523846,11376810
1999-06-14,1999,257,W,5,3+,20685,11956171,14301366,13276,10537122,11376810
1999-06-15,1999,258,W,5,3+,19986,11976157,14301366,12697,10549819,11376810
1999-06-16,1999,259,W,5,3+,20217,11996374,14301366,12752,10562571,11376810
1999-06-17,1999,260,W,5,3+,20030,12016404,14301366,12429,10575000,11376810
1999-06-18,1999,261,W,5,3+,20088,12036492,14301366,12409,10587409,11376810
1999-06-19,1999,262,W,5,3+,19981,12056473,14301366,12273,10599682,11376810
1999-06-20,1999,263,W,5,3+,19800,12076273,14301366,11995,10611677,11376810
1999-06-21,1999,264,W,5,3+,19992,12096265,14301366,11963,10623640,11376810
1999-06-22,1999,265,W,5,3+,19748,12116013,14301366,11209,10634849,11376810
1999-06-23,1999,266,W,5,3+,19529,12135542,14301366,10553,10645402,11376810
1999-06-24,1999,267,W,5,3+,19353,12154895,14301366,9909,10655311,11376810
1999-06-25,1999,268,W,5,3+,19398,12174293,14301366,10544,10665855,11376810
1999-06-26,1999,269,W,5,3+,19747,12194040,14301366,8449,10674304,11376810
1999-06-27,1999,270,W,5,3+,20056,12214096,14301366,8736,10683040,11376810
1999-06-28,1999,271,W,5,3+,21601,12235697,14301366,9818,10692858,11376810
1999-06-29,1999,272,W,5,3+,23420,12259117,14301366,11543,10704401,11376810
1999-06-30,1999,273,W,5,3+,24910,12284027,14301366,12881,10717282,11376810
1999-07-01,1999,274,W,5,3+,25014,12309041,14301366,9491,10726773,11376810
1999-07-02,1999,275,W,5,3+,24818,12333859,14301366,10978,10737751,11376810
1999-07-03,1999,276,W,5,3+,24333,12358192,14301366,9256,10747007,11376810
1999-07-04,1999,277,W,5,3+,24745,12382937,14301366,9819,10756826,11376810
1999-07-05,1999,278,W,5,3+,24505,12407442,14301366,9534,10766360,11376810
1999-07-06,1999,279,W,5,3+,24412,12431854,14301366,8813,10775173,11376810
1999-07-07,1999,280,W,5,3+,24617,12456471,14301366,9480,10784653,11376810
1999-07-08,1999,281,W,5,3+,24373,12480844,14301366,9296,10793949,11376810
1999-07-09,1999,282,W,5,3+,24773,12505617,14301366,9567,10803516,11376810
1999-07-10,1999,283,W,5,3+,25147,12530764,14301366,9886,10813402,11376810
1999-07-11,1999,284,W,5,3+,24941,12555705,14301366,9316,10822718,11376810
1999-07-12,1999,285,W,5,3+,25126,12580831,14301366,9918,10832636,11376810
1999-07-13,1999,286,W,5,3+,25004,12605835,14301366,9303,10841939,11376810
1999-07-14,1999,287,W,5,3+,24964,12630799,14301366,9366,10851305,11376810
1999-07-15,1999,288,W,5,3+,25506,12656305,14301366,9760,10861065,11376810
1999-07-16,1999,289,W,5,3+,25561,12681866,14301366,10918,10871983,11376810
1999-07-17,1999,290,W,5,3+,25941,12707807,14301366,11508,10883491,11376810
1999-07-18,1999,291,W,5,3+,26358,12734165,14301366,11488,10894979,11376810
1999-07-19,1999,292,W,5,3+,26638,12760803,14301366,10933,10905912,11376810
1999-07-20,1999,293,W,5,3+,27348,12788151,14301366,11743,10917655,11376810
1999-07-21,1999,294,W,5,3+,27354,12815505,14301366,11750,10929405,11376810
1999-07-22,1999,295,W,5,3+,27285,12842790,14301366,11643,10941048,11376810
1999-07-23,1999,296,W,5,3+,26635,12869425,14301366,10966,10952014,11376810
1999-07-24,1999,297,W,5,3+,26759,12896184,14301366,11100,10963114,11376810
1999-07-25,1999,298,W,5,3+,26782,12922966,14301366,11176,10974290,11376810
1999-07-26,1999,299,W,5,3+,27021,12949987,14301366,11291,10985581,11376810
1999-07-27,1999,300,W,5,3+,27037,12977024,14301366,11352,10996933,11376810
1999-07-28,1999,301,W,5,3+,27141,13004165,14301366,12207,11009140,11376810
1999-07-29,1999,302,W,5,3+,27299,13031464,14301366,12851,11021991,11376810
1999-07-30,1999,303,W,5,3+,27126,13058590,14301366,12043,11034034,11376810
1999-07-31,1999,304,W,5,3+,26557,13085147,14301366,11197,11045231,11376810
1999-08-01,1999,305,W,5,3+,26489,13111636,14301366,12031,11057262,11376810
1999-08-02,1999,306,W,5,3+,26853,13138489,14301366,12903,11070165,11376810
1999-08-03,1999,307,W,5,3+,26675,13165164,14301366,12764,11082929,11376810
1999-08-04,1999,308,W,5,3+,25788,13190952,14301366,11472,11094401,11376810
1999-08-05,1999,309,W,5,3+,24686,13215638,14301366,9324,11103725,11376810
1999-08-06,1999,310,W,5,3+,24488,13240126,14301366,8628,11112353,11376810
1999-08-07,1999,311,W,5,3+,23707,13263833,14301366,7887,11120240,11376810
1999-08-08,1999,312,W,5,3+,22927,13286760,14301366,7125,11127365,11376810
1999-08-09,1999,313,W,5,3+,22185,13308945,14301366,6438,11133803,11376810
1999-08-10,1999,314,W,5,3+,20922,13329867,14301366,5228,11139031,11376810
1999-08-11,1999,315,W,5,3+,20523,13350390,14301366,4824,11143855,11376810
1999-08-12,1999,316,W,5,3+,20183,13370573,14301366,4412,11148267,11376810
1999-08-13,1999,317,W,5,3+,20296,13390869,14301366,4717,11152984,11376810
1999-08-14,1999,318,W,5,3+,20204,13411073,14301366,4719,11157703,11376810
1999-08-15,1999,319,W,5,3+,20264,13431337,14301366,7328,11165031,11376810
1999-08-16,1999,320,W,5,3+,20150,13451487,14301366,5375,11170406,11376810
1999-08-17,1999,321,W,5,3+,19598,13471085,14301366,3806,11174212,11376810
1999-08-18,1999,322,W,5,3+,18600,13489685,14301366,2834,11177046,11376810
1999-08-19,1999,323,W,5,3+,18607,13508292,14301366,2881,11179927,11376810
1999-08-20,1999,324,W,5,3+,17826,13526118,14301366,2174,11182101,11376810
1999-08-21,1999,325,W,5,3+,18068,13544186,14301366,2389,11184490,11376810
1999-08-22,1999,326,W,5,3+,18439,13562625,14301366,2861,11187351,11376810
1999-08-23,1999,327,W,5,3+,18805,13581430,14301366,4355,11191706,11376810
1999-08-24,1999,328,W,5,3+,19225,13600655,14301366,4549,11196255,11376810
1999-08-25,1999,329,W,5,3+,19195,13619850,14301366,3808,11200063,11376810
1999-08-26,1999,330,W,5,3+,19363,13639213,14301366,4172,11204235,11376810
1999-08-27,1999,331,W,5,3+,19522,13658735,14301366,4327,11208562,11376810
1999-08-28,1999,332,W,5,3+,20460,13679195,14301366,5278,11213840,11376810
1999-08-29,1999,333,W,5,3+,20890,13700085,14301366,6448,11220288,11376810
1999-08-30,1999,334,W,5,3+,21065,13721150,14301366,5993,11226281,11376810
1999-08-31,1999,335,W,5,3+,20706,13741856,14301366,5581,11231862,11376810
1999-09-01,1999,336,W,5,3+,20079,13761935,14301366,5056,11236918,11376810
1999-09-02,1999,337,W,5,3+,19408,13781343,14301366,5035,11241953,11376810
1999-09-03,1999,338,W,5,3+,19283,13800626,14301366,4449,11246402,11376810
1999-09-04,1999,339,W,5,3+,19306,13819932,14301366,4577,11250979,11376810
1999-09-05,1999,340,W,5,3+,19453,13839385,14301366,4815,11255794,11376810
1999-09-06,1999,341,W,5,3+,19234,13858619,14301366,4626,11260420,11376810
1999-09-07,1999,342,W,5,3+,19291,13877910,14301366,4597,11265017,11376810
1999-09-08,1999,343,W,5,3+,19100,13897010,14301366,4402,11269419,11376810
1999-09-09,1999,344,W,5,3+,18914,13915924,14301366,4257,11273676,11376810
1999-09-10,1999,345,W,5,3+,18982,13934906,14301366,4353,11278029,11376810
1999-09-11,1999,346,W,5,3+,19338,13954244,14301366,4741,11282770,11376810
1999-09-12,1999,347,W,5,3+,19902,13974146,14301366,5856,11288626,11376810
1999-09-13,1999,348,W,5,3+,19246,13993392,14301366,4786,11293412,11376810
1999-09-14,1999,349,W,5,3+,17998,14011390,14301366,3625,11297037,11376810
1999-09-15,1999,350,W,5,3+,18086,14029476,14301366,3869,11300906,11376810
1999-09-16,1999,351,W,5,3+,18181,14047657,14301366,3920,11304826,11376810
1999-09-17,1999,352,W,5,3+,17740,14065397,14301366,3566,11308392,11376810
1999-09-18,1999,353,W,5,3+,18808,14084205,14301366,4696,11313088,11376810
1999-09-19,1999,354,W,5,3+,19251,14103456,14301366,5251,11318339,11376810
1999-09-20,1999,355,W,5,3+,19763,14123219,14301366,5745,11324084,11376810
1999-09-21,1999,356,W,5,3+,18873,14142092,14301366,5154,11329238,11376810
1999-09-22,1999,357,W,5,3+,18177,14160269,14301366,5809,11335047,11376810
1999-09-23,1999,358,W,5,3+,18183,14178452,14301366,6173,11341220,11376810
1999-09-24,1999,359,W,5,3+,17700,14196152,14301366,5755,11346975,11376810
1999-09-25,1999,360,W,5,3+,17418,14213570,14301366,5533,11352508,11376810
1999-09-26,1999,361,W,5,3+,17291,14230861,14301366,5412,11357920,11376810
1999-09-27,1999,362,W,5,3+,17251,14248112,14301366,4405,11362325,11376810
1999-09-28,1999,363,W,5,3+,17313,14265425,14301366,4278,11366603,11376810
1999-09-29,1999,364,W,5,3+,17847,14283272,14301366,5094,11371697,11376810
1999-09-30,1999,365,W,5,3+,18094,14301366,14301366,5113,11376810,11376810
1999-10-01,2000,1,W,6,3+,17632,17632,12727625,4493,4493,9169266
1999-10-02,2000,2,W,6,3+,17623,35255,12727625,4638,9131,9169266
1999-10-03,2000,3,W,6,3+,17690,52945,12727625,4712,13843,9169266
1999-10-04,2000,4,W,6,3+,17298,70243,12727625,4351,18194,9169266
1999-10-05,2000,5,W,6,3+,17151,87394,12727625,4785,22979,9169266
1999-10-06,2000,6,W,6,3+,16892,104286,12727625,3768,26747,9169266
1999-10-07,2000,7,W,6,3+,17079,121365,12727625,4198,30945,9169266
1999-10-08,2000,8,W,6,3+,17308,138673,12727625,4386,35331,9169266
1999-10-09,2000,9,W,6,3+,17353,156026,12727625,4280,39611,9169266
1999-10-10,2000,10,W,6,3+,17302,173328,12727625,4277,43888,9169266
1999-10-11,2000,11,W,6,3+,17154,190482,12727625,4140,48028,9169266
1999-10-12,2000,12,W,6,3+,16936,207418,12727625,6278,54306,9169266
1999-10-13,2000,13,W,6,3+,16129,223547,12727625,3816,58122,9169266
1999-10-14,2000,14,W,6,3+,15095,238642,12727625,2389,60511,9169266
1999-10-15,2000,15,W,6,3+,14504,253146,12727625,1521,62032,9169266
1999-10-16,2000,16,W,6,3+,14125,267271,12727625,1821,63853,9169266
1999-10-17,2000,17,W,6,3+,13757,281028,12727625,2471,66324,9169266
1999-10-18,2000,18,W,6,3+,14036,295064,12727625,4781,71105,9169266
1999-10-19,2000,19,W,6,3+,13987,309051,12727625,4767,75872,9169266
1999-10-20,2000,20,W,6,3+,13865,322916,12727625,4124,79996,9169266
1999-10-21,2000,21,W,6,3+,13857,336773,12727625,4175,84171,9169266
1999-10-22,2000,22,W,6,3+,13635,350408,12727625,3904,88075,9169266
1999-10-23,2000,23,W,6,3+,13413,363821,12727625,3223,91298,9169266
1999-10-24,2000,24,W,6,3+,13739,377560,12727625,4109,95407,9169266
1999-10-25,2000,25,W,6,3+,13702,391262,12727625,4056,99463,9169266
1999-10-26,2000,26,W,6,3+,13799,405061,12727625,4150,103613,9169266
1999-10-27,2000,27,W,6,3+,13955,419016,12727625,4350,107963,9169266
1999-10-28,2000,28,W,6,3+,14126,433142,12727625,5429,113392,9169266
1999-10-29,2000,29,W,6,3+,14741,447883,12727625,6088,119480,9169266
1999-10-30,2000,30,W,6,3+,15060,462943,12727625,6645,126125,9169266
1999-10-31,2000,31,W,6,3+,15004,477947,12727625,6558,132683,9169266
1999-11-01,2000,32,W,6,3+,15478,493425,12727625,7693,140376,9169266
1999-11-02,2000,33,W,6,3+,14824,508249,12727625,5660,146036,9169266
1999-11-03,2000,34,W,6,3+,14349,522598,12727625,4200,150236,9169266
1999-11-04,2000,35,W,6,3+,14157,536755,12727625,3996,154232,9169266
1999-11-05,2000,36,W,6,3+,14571,551326,12727625,4434,158666,9169266
1999-11-06,2000,37,W,6,3+,14367,565693,12727625,4263,162929,9169266
1999-11-07,2000,38,W,6,3+,14090,579783,12727625,6593,169522,9169266
1999-11-08,2000,39,W,6,3+,14958,594741,12727625,9233,178755,9169266
1999-11-09,2000,40,W,6,3+,15436,610177,12727625,9113,187868,9169266
1999-11-10,2000,41,W,6,3+,15602,625779,12727625,8399,196267,9169266
1999-11-11,2000,42,W,6,3+,15965,641744,12727625,9715,205982,9169266
1999-11-12,2000,43,W,6,3+,16320,658064,12727625,7577,213559,9169266
1999-11-13,2000,44,W,6,3+,16710,674774,12727625,5031,218590,9169266
1999-11-14,2000,45,W,6,3+,16579,691353,12727625,5044,223634,9169266
1999-11-15,2000,46,W,6,3+,17054,708407,12727625,5796,229430,9169266
1999-11-16,2000,47,W,6,3+,16325,724732,12727625,8521,237951,9169266
1999-11-17,2000,48,W,6,3+,17116,741848,12727625,8121,246072,9169266
1999-11-18,2000,49,W,6,3+,16701,758549,12727625,7193,253265,9169266
1999-11-19,2000,50,W,6,3+,16943,775492,12727625,9496,262761,9169266
1999-11-20,2000,51,W,6,3+,18045,793537,12727625,9992,272753,9169266
1999-11-21,2000,52,W,6,3+,18099,811636,12727625,8611,281364,9169266
1999-11-22,2000,53,W,6,3+,18755,830391,12727625,9353,290717,9169266
1999-11-23,2000,54,W,6,3+,19300,849691,12727625,9355,300072,9169266
1999-11-24,2000,55,W,6,3+,18741,868432,12727625,6313,306385,9169266
1999-11-25,2000,56,W,6,3+,18130,886562,12727625,5945,312330,9169266
1999-11-26,2000,57,W,6,3+,17305,903867,12727625,4656,316986,9169266
1999-11-27,2000,58,W,6,3+,17070,920937,12727625,4328,321314,9169266
1999-11-28,2000,59,W,6,3+,16768,937705,12727625,4289,325603,9169266
1999-11-29,2000,60,W,6,3+,16771,954476,12727625,4616,330219,9169266
1999-11-30,2000,61,W,6,3+,17200,971676,12727625,6589,336808,9169266
1999-12-01,2000,62,W,6,3+,18337,990013,12727625,7806,344614,9169266
1999-12-02,2000,63,W,6,3+,19504,1009517,12727625,8577,353191,9169266
1999-12-03,2000,64,W,6,3+,21249,1030766,12727625,10616,363807,9169266
1999-12-04,2000,65,W,6,3+,20945,1051711,12727625,10348,374155,9169266
1999-12-05,2000,66,W,6,3+,20315,1072026,12727625,8539,382694,9169266
1999-12-06,2000,67,W,6,3+,19808,1091834,12727625,6889,389583,9169266
1999-12-07,2000,68,W,6,3+,19509,1111343,12727625,6560,396143,9169266
1999-12-08,2000,69,W,6,3+,19155,1130498,12727625,6185,402328,9169266
1999-12-09,2000,70,W,6,3+,18760,1149258,12727625,6942,409270,9169266
1999-12-10,2000,71,W,6,3+,19043,1168301,12727625,12859,422129,9169266
1999-12-11,2000,72,W,6,3+,19871,1188172,12727625,14588,436717,9169266
1999-12-12,2000,73,W,6,3+,19909,1208081,12727625,14620,451337,9169266
1999-12-13,2000,74,W,6,3+,19874,1227955,12727625,17236,468573,9169266
1999-12-14,2000,75,W,6,3+,19856,1247811,12727625,16041,484614,9169266
1999-12-15,2000,76,W,6,3+,19839,1267650,12727625,16010,500624,9169266
1999-12-16,2000,77,W,6,3+,19699,1287349,12727625,15877,516501,9169266
1999-12-17,2000,78,W,6,3+,19332,1306681,12727625,15502,532003,9169266
1999-12-18,2000,79,W,6,3+,18719,1325400,12727625,14942,546945,9169266
1999-12-19,2000,80,W,6,3+,18395,1343795,12727625,14610,561555,9169266
1999-12-20,2000,81,W,6,3+,17834,1361629,12727625,13566,575121,9169266
1999-12-21,2000,82,W,6,3+,17309,1378938,12727625,12102,587223,9169266
1999-12-22,2000,83,W,6,3+,17297,1396235,12727625,11113,598336,9169266
1999-12-23,2000,84,W,6,3+,17072,1413307,12727625,9940,608276,9169266
1999-12-24,2000,85,W,6,3+,17188,1430495,12727625,8803,617079,9169266
1999-12-25,2000,86,W,6,3+,17185,1447680,12727625,8173,625252,9169266
1999-12-26,2000,87,W,6,3+,17203,1464883,12727625,7222,632474,9169266
1999-12-27,2000,88,W,6,3+,17391,1482274,12727625,7433,639907,9169266
1999-12-28,2000,89,W,6,3+,17261,1499535,12727625,6690,646597,9169266
1999-12-29,2000,90,W,6,3+,16940,1516475,12727625,5625,652222,9169266
1999-12-30,2000,91,W,6,3+,16739,1533214,12727625,5445,657667,9169266
1999-12-31,2000,92,W,6,3+,16384,1549598,12727625,3627,661294,9169266
2000-01-01,2000,93,W,6,3+,16615,1566213,12727625,4077,665371,9169266
2000-01-02,2000,94,W,6,3+,16537,1582750,12727625,4108,669479,9169266
2000-01-03,2000,95,W,6,3+,16641,1599391,12727625,4500,673979,9169266
2000-01-04,2000,96,W,6,3+,16316,1615707,12727625,3796,677775,9169266
2000-01-05,2000,97,W,6,3+,16204,1631911,12727625,3715,681490,9169266
2000-01-06,2000,98,W,6,3+,16208,1648119,12727625,4045,685535,9169266
2000-01-07,2000,99,W,6,3+,16070,1664189,12727625,3555,689090,9169266
2000-01-08,2000,100,W,6,3+,15846,1680035,12727625,3824,692914,9169266
2000-01-09,2000,101,W,6,3+,15798,1695833,12727625,3523,696437,9169266
2000-01-10,2000,102,W,6,3+,15629,1711462,12727625,3507,699944,9169266
2000-01-11,2000,103,W,6,3+,15630,1727092,12727625,5933,705877,9169266
2000-01-12,2000,104,W,6,3+,16958,1744050,12727625,8042,713919,9169266
2000-01-13,2000,105,W,6,3+,17005,1761055,12727625,8285,722204,9169266
2000-01-14,2000,106,W,6,3+,18268,1779323,12727625,10077,732281,9169266
2000-01-15,2000,107,W,6,3+,18555,1797878,12727625,10231,742512,9169266
2000-01-16,2000,108,W,6,3+,18638,1816516,12727625,8440,750952,9169266
2000-01-17,2000,109,W,6,3+,22276,1838792,12727625,14777,765729,9169266
2000-01-18,2000,110,W,6,3+,26835,1865627,12727625,23935,789664,9169266
2000-01-19,2000,111,W,6,3+,28332,1893959,12727625,25160,814824,9169266
2000-01-20,2000,112,W,6,3+,26735,1920694,12727625,23690,838514,9169266
2000-01-21,2000,113,W,6,3+,27531,1948225,12727625,23908,862422,9169266
2000-01-22,2000,114,W,6,3+,30761,1978986,12727625,26438,888860,9169266
2000-01-23,2000,115,W,6,3+,29375,2008361,12727625,29214,918074,9169266
2000-01-24,2000,116,W,6,3+,38053,2046414,12727625,46144,964218,9169266
2000-01-25,2000,117,W,6,3+,57170,2103584,12727625,63246,1027464,9169266
2000-01-26,2000,118,W,6,3+,62182,2165766,12727625,67481,1094945,9169266
2000-01-27,2000,119,W,6,3+,59304,2225070,12727625,64830,1159775,9169266
2000-01-28,2000,120,W,6,3+,55153,2280223,12727625,53145,1212920,9169266
2000-01-29,2000,121,W,6,3+,52046,2332269,12727625,39530,1252450,9169266
2000-01-30,2000,122,W,6,3+,49219,2381488,12727625,37923,1290373,9169266
2000-01-31,2000,123,W,6,3+,49972,2431460,12727625,38834,1329207,9169266
2000-02-01,2000,124,W,6,3+,50992,2482452,12727625,39690,1368897,9169266
2000-02-02,2000,125,W,6,3+,50775,2533227,12727625,39437,1408334,9169266
2000-02-03,2000,126,W,6,3+,50044,2583271,12727625,39992,1448326,9169266
2000-02-04,2000,127,W,6,3+,50042,2633313,12727625,38800,1487126,9169266
2000-02-05,2000,128,W,6,3+,48117,2681430,12727625,36752,1523878,9169266
2000-02-06,2000,129,W,6,3+,45897,2727327,12727625,34774,1558652,9169266
2000-02-07,2000,130,W,6,3+,43926,2771253,12727625,33063,1591715,9169266
2000-02-08,2000,131,W,6,3+,42947,2814200,12727625,31267,1622982,9169266
2000-02-09,2000,132,W,6,3+,40054,2854254,12727625,29832,1652814,9169266
2000-02-10,2000,133,W,6,3+,38423,2892677,12727625,30937,1683751,9169266
2000-02-11,2000,134,W,6,3+,41878,2934555,12727625,39658,1723409,9169266
2000-02-12,2000,135,W,6,3+,56995,2991550,12727625,55574,1778983,9169266
2000-02-13,2000,136,W,6,3+,70643,3062193,12727625,75156,1854139,9169266
2000-02-14,2000,137,W,6,3+,98687,3160880,12727625,102185,1956324,9169266
2000-02-15,2000,138,W,6,3+,163897,3324777,12727625,163895,2120219,9169266
2000-02-16,2000,139,W,6,3+,164811,3489588,12727625,162606,2282825,9169266
2000-02-17,2000,140,W,6,3+,162667,3652255,12727625,159669,2442494,9169266
2000-02-18,2000,141,W,6,3+,153104,3805359,12727625,143481,2585975,9169266
2000-02-19,2000,142,W,6,3+,138844,3944203,12727625,129166,2715141,9169266
2000-02-20,2000,143,W,6,3+,126859,4071062,12727625,120471,2835612,9169266
2000-02-21,2000,144,W,6,3+,121910,4192972,12727625,110045,2945657,9169266
2000-02-22,2000,145,W,6,3+,114566,4307538,12727625,110836,3056493,9169266
2000-02-23,2000,146,W,6,3+,127080,4434618,12727625,126156,3182649,9169266
2000-02-24,2000,147,W,6,3+,140430,4575048,12727625,141578,3324227,9169266
2000-02-25,2000,148,W,6,3+,139102,4714150,12727625,137623,3461850,9169266
2000-02-26,2000,149,W,6,3+,135614,4849764,12727625,135197,3597047,9169266
2000-02-27,2000,150,W,6,3+,145327,4995091,12727625,138622,3735669,9169266
2000-02-28,2000,151,W,6,3+,168766,5163857,12727625,160452,3896121,9169266
2000-02-29,2000,152,W,6,3+,168305,5332162,12727625,161762,4057883,9169266
2000-03-01,2000,153,W,6,3+,166241,5498403,12727625,159701,4217584,9169266
2000-03-02,2000,154,W,6,3+,157957,5656360,12727625,150397,4367981,9169266
2000-03-03,2000,155,W,6,3+,148081,5804441,12727625,137309,4505290,9169266
2000-03-04,2000,156,W,6,3+,140437,5944878,12727625,128909,4634199,9169266
2000-03-05,2000,157,W,6,3+,138656,6083534,12727625,126464,4760663,9169266
2000-03-06,2000,158,W,6,3+,143500,6227034,12727625,132329,4892992,9169266
2000-03-07,2000,159,W,6,3+,142336,6369370,12727625,132524,5025516,9169266
2000-03-08,2000,160,W,6,3+,145420,6514790,12727625,136273,5161789,9169266
2000-03-09,2000,161,W,6,3+,147627,6662417,12727625,143204,5304993,9169266
2000-03-10,2000,162,W,6,3+,143941,6806358,12727625,138556,5443549,9169266
2000-03-11,2000,163,W,6,3+,137979,6944337,12727625,133743,5577292,9169266
2000-03-12,2000,164,W,6,3+,131149,7075486,12727625,122694,5699986,9169266
2000-03-13,2000,165,W,6,3+,123183,7198669,12727625,113256,5813242,9169266
2000-03-14,2000,166,W,6,3+,114799,7313468,12727625,106683,5919925,9169266
2000-03-15,2000,167,W,6,3+,105589,7419057,12727625,97970,6017895,9169266
2000-03-16,2000,168,W,6,3+,94713,7513770,12727625,86551,6104446,9169266
2000-03-17,2000,169,W,6,3+,86339,7600109,12727625,77901,6182347,9169266
2000-03-18,2000,170,W,6,3+,80809,7680918,12727625,70141,6252488,9169266
2000-03-19,2000,171,W,6,3+,74604,7755522,12727625,62639,6315127,9169266
2000-03-20,2000,172,W,6,3+,70349,7825871,12727625,58534,6373661,9169266
2000-03-21,2000,173,W,6,3+,64521,7890392,12727625,54401,6428062,9169266
2000-03-22,2000,174,W,6,3+,58894,7949286,12727625,47615,6475677,9169266
2000-03-23,2000,175,W,6,3+,54951,8004237,12727625,44861,6520538,9169266
2000-03-24,2000,176,W,6,3+,51378,8055615,12727625,42919,6563457,9169266
2000-03-25,2000,177,W,6,3+,48755,8104370,12727625,40731,6604188,9169266
2000-03-26,2000,178,W,6,3+,44754,8149124,12727625,36506,6640694,9169266
2000-03-27,2000,179,W,6,3+,42220,8191344,12727625,32755,6673449,9169266
2000-03-28,2000,180,W,6,3+,39997,8231341,12727625,30562,6704011,9169266
2000-03-29,2000,181,W,6,3+,37854,8269195,12727625,27846,6731857,9169266
2000-03-30,2000,182,W,6,3+,36102,8305297,12727625,25085,6756942,9169266
2000-03-31,2000,183,W,6,3+,34535,8339832,12727625,23930,6780872,9169266
2000-04-01,2000,184,W,6,3+,32954,8372786,12727625,21724,6802596,9169266
2000-04-02,2000,185,W,6,3+,31395,8404181,12727625,19933,6822529,9169266
2000-04-03,2000,186,W,6,3+,30485,8434666,12727625,19352,6841881,9169266
2000-04-04,2000,187,W,6,3+,29168,8463834,12727625,17545,6859426,9169266
2000-04-05,2000,188,W,6,3+,28562,8492396,12727625,19549,6878975,9169266
2000-04-06,2000,189,W,6,3+,28003,8520399,12727625,18246,6897221,9169266
2000-04-07,2000,190,W,6,3+,27463,8547862,12727625,17250,6914471,9169266
2000-04-08,2000,191,W,6,3+,26783,8574645,12727625,15514,6929985,9169266
2000-04-09,2000,192,W,6,3+,27332,8601977,12727625,15836,6945821,9169266
2000-04-10,2000,193,W,6,3+,27685,8629662,12727625,16625,6962446,9169266
2000-04-11,2000,194,W,6,3+,28715,8658377,12727625,17514,6979960,9169266
2000-04-12,2000,195,W,6,3+,30168,8688545,12727625,18789,6998749,9169266
2000-04-13,2000,196,W,6,3+,32003,8720548,12727625,21235,7019984,9169266
2000-04-14,2000,197,W,6,3+,34051,8754599,12727625,26665,7046649,9169266
2000-04-15,2000,198,W,6,3+,35580,8790179,12727625,31737,7078386,9169266
2000-04-16,2000,199,W,6,3+,36296,8826475,12727625,32745,7111131,9169266
2000-04-17,2000,200,W,6,3+,37954,8864429,12727625,40605,7151736,9169266
2000-04-18,2000,201,W,6,3+,39790,8904219,12727625,42003,7193739,9169266
2000-04-19,2000,202,W,6,3+,41538,8945757,12727625,43660,7237399,9169266
2000-04-20,2000,203,W,6,3+,43293,8989050,12727625,45349,7282748,9169266
2000-04-21,2000,204,W,6,3+,42539,9031589,12727625,44412,7327160,9169266
2000-04-22,2000,205,W,6,3+,40724,9072313,12727625,36379,7363539,9169266
2000-04-23,2000,206,W,6,3+,39010,9111323,12727625,34631,7398170,9169266
2000-04-24,2000,207,W,6,3+,36412,9147735,12727625,31613,7429783,9169266
2000-04-25,2000,208,W,6,3+,35005,9182740,12727625,30706,7460489,9169266
2000-04-26,2000,209,W,6,3+,33865,9216605,12727625,29568,7490057,9169266
2000-04-27,2000,210,W,6,3+,32116,9248721,12727625,27889,7517946,9169266
2000-04-28,2000,211,W,6,3+,31118,9279839,12727625,26930,7544876,9169266
2000-04-29,2000,212,W,6,3+,31311,9311150,12727625,27134,7572010,9169266
2000-04-30,2000,213,W,6,3+,31960,9343110,12727625,27691,7599701,9169266
2000-05-01,2000,214,W,6,3+,32188,9375298,12727625,27937,7627638,9169266
2000-05-02,2000,215,W,6,3+,32576,9407874,12727625,28510,7656148,9169266
2000-05-03,2000,216,W,6,3+,32462,9440336,12727625,28136,7684284,9169266
2000-05-04,2000,217,W,6,3+,32835,9473171,12727625,28981,7713265,9169266
2000-05-05,2000,218,W,6,3+,33586,9506757,12727625,29224,7742489,9169266
2000-05-06,2000,219,W,6,3+,33571,9540328,12727625,31015,7773504,9169266
2000-05-07,2000,220,W,6,3+,34224,9574552,12727625,33238,7806742,9169266
2000-05-08,2000,221,W,6,3+,35606,9610158,12727625,34881,7841623,9169266
2000-05-09,2000,222,W,6,3+,35064,9645222,12727625,34354,7875977,9169266
2000-05-10,2000,223,W,6,3+,33809,9679031,12727625,33135,7909112,9169266
2000-05-11,2000,224,W,6,3+,31874,9710905,12727625,29186,7938298,9169266
2000-05-12,2000,225,W,6,3+,28828,9739733,12727625,24473,7962771,9169266
2000-05-13,2000,226,W,6,3+,25424,9765157,12727625,20828,7983599,9169266
2000-05-14,2000,227,W,6,3+,23176,9788333,12727625,18498,8002097,9169266
2000-05-15,2000,228,W,6,3+,22008,9810341,12727625,17795,8019892,9169266
2000-05-16,2000,229,W,6,3+,23220,9833561,12727625,18968,8038860,9169266
2000-05-17,2000,230,W,6,3+,24650,9858211,12727625,20371,8059231,9169266
2000-05-18,2000,231,W,6,3+,25646,9883857,12727625,20873,8080104,9169266
2000-05-19,2000,232,W,6,3+,25403,9909260,12727625,20818,8100922,9169266
2000-05-20,2000,233,W,6,3+,23855,9933115,12727625,18505,8119427,9169266
2000-05-21,2000,234,W,6,3+,22862,9955977,12727625,16948,8136375,9169266
2000-05-22,2000,235,W,6,3+,22872,9978849,12727625,16459,8152834,9169266
2000-05-23,2000,236,W,6,3+,22934,10001783,12727625,16099,8168933,9169266
2000-05-24,2000,237,W,6,3+,22793,10024576,12727625,15258,8184191,9169266
2000-05-25,2000,238,W,6,3+,23053,10047629,12727625,18432,8202623,9169266
2000-05-26,2000,239,W,6,3+,22892,10070521,12727625,17228,8219851,9169266
2000-05-27,2000,240,W,6,3+,22533,10093054,12727625,16804,8236655,9169266
2000-05-28,2000,241,W,6,3+,21675,10114729,12727625,15877,8252532,9169266
2000-05-29,2000,242,W,6,3+,21194,10135923,12727625,10367,8262899,9169266
2000-05-30,2000,243,W,6,3+,21143,10157066,12727625,12012,8274911,9169266
2000-05-31,2000,244,W,6,3+,20991,10178057,12727625,11320,8286231,9169266
2000-06-01,2000,245,W,6,3+,20536,10198593,12727625,9643,8295874,9169266
2000-06-02,2000,246,W,6,3+,20286,10218879,12727625,9896,8305770,9169266
2000-06-03,2000,247,W,6,3+,20264,10239143,12727625,9870,8315640,9169266
2000-06-04,2000,248,W,6,3+,19818,10258961,12727625,9318,8324958,9169266
2000-06-05,2000,249,W,6,3+,20227,10279188,12727625,9211,8334169,9169266
2000-06-06,2000,250,W,6,3+,20456,10299644,12727625,9698,8343867,9169266
2000-06-07,2000,251,W,6,3+,19808,10319452,12727625,9082,8352949,9169266
2000-06-08,2000,252,W,6,3+,20079,10339531,12727625,9697,8362646,9169266
2000-06-09,2000,253,W,6,3+,20280,10359811,12727625,9669,8372315,9169266
2000-06-10,2000,254,W,6,3+,21299,10381110,12727625,10906,8383221,9169266
2000-06-11,2000,255,W,6,3+,21939,10403049,12727625,11365,8394586,9169266
2000-06-12,2000,256,W,6,3+,22189,10425238,12727625,11339,8405925,9169266
2000-06-13,2000,257,W,6,3+,21955,10447193,12727625,10365,8416290,9169266
2000-06-14,2000,258,W,6,3+,20799,10467992,12727625,9606,8425896,9169266
2000-06-15,2000,259,W,6,3+,20590,10488582,12727625,9077,8434973,9169266
2000-06-16,2000,260,W,6,3+,20806,10509388,12727625,8944,8443917,9169266
2000-06-17,2000,261,W,6,3+,20148,10529536,12727625,8235,8452152,9169266
2000-06-18,2000,262,W,6,3+,19798,10549334,12727625,8320,8460472,9169266
2000-06-19,2000,263,W,6,3+,19471,10568805,12727625,7985,8468457,9169266
2000-06-20,2000,264,W,6,3+,18448,10587253,12727625,6989,8475446,9169266
2000-06-21,2000,265,W,6,3+,17621,10604874,12727625,6538,8481984,9169266
2000-06-22,2000,266,W,6,3+,17150,10622024,12727625,5905,8487889,9169266
2000-06-23,2000,267,W,6,3+,18205,10640229,12727625,6465,8494354,9169266
2000-06-24,2000,268,W,6,3+,19689,10659918,12727625,7793,8502147,9169266
2000-06-25,2000,269,W,6,3+,20938,10680856,12727625,10118,8512265,9169266
2000-06-26,2000,270,W,6,3+,21312,10702168,12727625,7842,8520107,9169266
2000-06-27,2000,271,W,6,3+,21518,10723686,12727625,8752,8528859,9169266
2000-06-28,2000,272,W,6,3+,21926,10745612,12727625,9138,8537997,9169266
2000-06-29,2000,273,W,6,3+,21838,10767450,12727625,8449,8546446,9169266
2000-06-30,2000,274,W,6,3+,22428,10789878,12727625,8057,8554503,9169266
2000-07-01,2000,275,W,6,3+,23165,10813043,12727625,7605,8562108,9169266
2000-07-02,2000,276,W,6,3+,23216,10836259,12727625,7851,8569959,9169266
2000-07-03,2000,277,W,6,3+,23273,10859532,12727625,8732,8578691,9169266
2000-07-04,2000,278,W,6,3+,23206,10882738,12727625,7846,8586537,9169266
2000-07-05,2000,279,W,6,3+,23557,10906295,12727625,8545,8595082,9169266
2000-07-06,2000,280,W,6,3+,24060,10930355,12727625,11009,8606091,9169266
2000-07-07,2000,281,W,6,3+,24143,10954498,12727625,8567,8614658,9169266
2000-07-08,2000,282,W,6,3+,24396,10978894,12727625,9041,8623699,9169266
2000-07-09,2000,283,W,6,3+,24167,11003061,12727625,8594,8632293,9169266
2000-07-10,2000,284,W,6,3+,24048,11027109,12727625,8365,8640658,9169266
2000-07-11,2000,285,W,6,3+,23819,11050928,12727625,8147,8648805,9169266
2000-07-12,2000,286,W,6,3+,22784,11073712,12727625,6536,8655341,9169266
2000-07-13,2000,287,W,6,3+,22969,11096681,12727625,6669,8662010,9169266
2000-07-14,2000,288,W,6,3+,23618,11120299,12727625,7418,8669428,9169266
2000-07-15,2000,289,W,6,3+,23395,11143694,12727625,7259,8676687,9169266
2000-07-16,2000,290,W,6,3+,23539,11167233,12727625,7406,8684093,9169266
2000-07-17,2000,291,W,6,3+,23797,11191030,12727625,7678,8691771,9169266
2000-07-18,2000,292,W,6,3+,23708,11214738,12727625,7550,8699321,9169266
2000-07-19,2000,293,W,6,3+,23816,11238554,12727625,8268,8707589,9169266
2000-07-20,2000,294,W,6,3+,23712,11262266,12727625,9526,8717115,9169266
2000-07-21,2000,295,W,6,3+,23622,11285888,12727625,9705,8726820,9169266
2000-07-22,2000,296,W,6,3+,24426,11310314,12727625,10480,8737300,9169266
2000-07-23,2000,297,W,6,3+,25115,11335429,12727625,11159,8748459,9169266
2000-07-24,2000,298,W,6,3+,25382,11360811,12727625,11405,8759864,9169266
2000-07-25,2000,299,W,6,3+,25169,11385980,12727625,11282,8771146,9169266
2000-07-26,2000,300,W,6,3+,24973,11410953,12727625,11074,8782220,9169266
2000-07-27,2000,301,W,6,3+,24858,11435811,12727625,10962,8793182,9169266
2000-07-28,2000,302,W,6,3+,24515,11460326,12727625,10636,8803818,9169266
2000-07-29,2000,303,W,6,3+,24631,11484957,12727625,10725,8814543,9169266
2000-07-30,2000,304,W,6,3+,24616,11509573,12727625,10744,8825287,9169266
2000-07-31,2000,305,W,6,3+,24624,11534197,12727625,15056,8840343,9169266
2000-08-01,2000,306,W,6,3+,24050,11558247,12727625,12366,8852709,9169266
2000-08-02,2000,307,W,6,3+,23973,11582220,12727625,8933,8861642,9169266
2000-08-03,2000,308,W,6,3+,23659,11605879,12727625,10602,8872244,9169266
2000-08-04,2000,309,W,6,3+,23982,11629861,12727625,8239,8880483,9169266
2000-08-05,2000,310,W,6,3+,23647,11653508,12727625,8351,8888834,9169266
2000-08-06,2000,311,W,6,3+,23039,11676547,12727625,7196,8896030,9169266
2000-08-07,2000,312,W,6,3+,22138,11698685,12727625,6315,8902345,9169266
2000-08-08,2000,313,W,6,3+,21551,11720236,12727625,8006,8910351,9169266
2000-08-09,2000,314,W,6,3+,20867,11741103,12727625,8003,8918354,9169266
2000-08-10,2000,315,W,6,3+,20545,11761648,12727625,6873,8925227,9169266
2000-08-11,2000,316,W,6,3+,20110,11781758,12727625,6104,8931331,9169266
2000-08-12,2000,317,W,6,3+,19413,11801171,12727625,3623,8934954,9169266
2000-08-13,2000,318,W,6,3+,19312,11820483,12727625,3567,8938521,9169266
2000-08-14,2000,319,W,6,3+,19624,11840107,12727625,4030,8942551,9169266
2000-08-15,2000,320,W,6,3+,19513,11859620,12727625,4131,8946682,9169266
2000-08-16,2000,321,W,6,3+,19466,11879086,12727625,4857,8951539,9169266
2000-08-17,2000,322,W,6,3+,19563,11898649,12727625,5956,8957495,9169266
2000-08-18,2000,323,W,6,3+,19777,11918426,12727625,4224,8961719,9169266
2000-08-19,2000,324,W,6,3+,19854,11938280,12727625,5241,8966960,9169266
2000-08-20,2000,325,W,6,3+,19790,11958070,12727625,4716,8971676,9169266
2000-08-21,2000,326,W,6,3+,19358,11977428,12727625,3744,8975420,9169266
2000-08-22,2000,327,W,6,3+,19152,11996580,12727625,3963,8979383,9169266
2000-08-23,2000,328,W,6,3+,19589,12016169,12727625,4621,8984004,9169266
2000-08-24,2000,329,W,6,3+,20528,12036697,12727625,6545,8990549,9169266
2000-08-25,2000,330,W,6,3+,20450,12057147,12727625,6658,8997207,9169266
2000-08-26,2000,331,W,6,3+,20343,12077490,12727625,5184,9002391,9169266
2000-08-27,2000,332,W,6,3+,20297,12097787,12727625,4975,9007366,9169266
2000-08-28,2000,333,W,6,3+,20325,12118112,12727625,5106,9012472,9169266
2000-08-29,2000,334,W,6,3+,20202,12138314,12727625,5036,9017508,9169266
2000-08-30,2000,335,W,6,3+,20548,12158862,12727625,5732,9023240,9169266
2000-08-31,2000,336,W,6,3+,20425,12179287,12727625,6147,9029387,9169266
2000-09-01,2000,337,W,6,3+,20734,12200021,12727625,8140,9037527,9169266
2000-09-02,2000,338,W,6,3+,21273,12221294,12727625,7275,9044802,9169266
2000-09-03,2000,339,W,6,3+,21511,12242805,12727625,7077,9051879,9169266
2000-09-04,2000,340,W,6,3+,21899,12264704,12727625,7851,9059730,9169266
2000-09-05,2000,341,W,6,3+,21548,12286252,12727625,8292,9068022,9169266
2000-09-06,2000,342,W,6,3+,21134,12307386,12727625,6273,9074295,9169266
2000-09-07,2000,343,W,6,3+,20559,12327945,12727625,6161,9080456,9169266
2000-09-08,2000,344,W,6,3+,19680,12347625,12727625,4849,9085305,9169266
2000-09-09,2000,345,W,6,3+,19101,12366726,12727625,4797,9090102,9169266
2000-09-10,2000,346,W,6,3+,18662,12385388,12727625,4407,9094509,9169266
2000-09-11,2000,347,W,6,3+,18331,12403719,12727625,4054,9098563,9169266
2000-09-12,2000,348,W,6,3+,17884,12421603,12727625,3580,9102143,9169266
2000-09-13,2000,349,W,6,3+,17807,12439410,12727625,3450,9105593,9169266
2000-09-14,2000,350,W,6,3+,17822,12457232,12727625,4372,9109965,9169266
2000-09-15,2000,351,W,6,3+,17743,12474975,12727625,3512,9113477,9169266
2000-09-16,2000,352,W,6,3+,18166,12493141,12727625,3929,9117406,9169266
2000-09-17,2000,353,W,6,3+,17560,12510701,12727625,3272,9120678,9169266
2000-09-18,2000,354,W,6,3+,17338,12528039,12727625,3088,9123766,9169266
2000-09-19,2000,355,W,6,3+,16515,12544554,12727625,2298,9126064,9169266
2000-09-20,2000,356,W,6,3+,16266,12560820,12727625,1657,9127721,9169266
2000-09-21,2000,357,W,6,3+,16567,12577387,12727625,3045,9130766,9169266
2000-09-22,2000,358,W,6,3+,17699,12595086,12727625,5787,9136553,9169266
2000-09-23,2000,359,W,6,3+,17994,12613080,12727625,7230,9143783,9169266
2000-09-24,2000,360,W,6,3+,17743,12630823,12727625,5527,9149310,9169266
2000-09-25,2000,361,W,6,3+,17275,12648098,12727625,3510,9152820,9169266
2000-09-26,2000,362,W,6,3+,16443,12664541,12727625,3605,9156425,9169266
2000-09-27,2000,363,W,6,3+,16009,12680550,12727625,2941,9159366,9169266
2000-09-28,2000,364,W,6,3+,16382,12696932,12727625,4881,9164247,9169266
2000-09-29,2000,365,W,6,3+,15615,12712547,12727625,2468,9166715,9169266
2000-09-30,2000,366,W,6,3+,15078,12727625,12727625,2551,9169266,9169266
2000-10-01,2001,1,D,1,1,14485,14485,6548036,1940,1940,3515878
2000-10-02,2001,2,D,1,1,14621,29106,6548036,2803,4743,3515878
2000-10-03,2001,3,D,1,1,14622,43728,6548036,3340,8083,3515878
2000-10-04,2001,4,D,1,1,14650,58378,6548036,3206,11289,3515878
2000-10-05,2001,5,D,1,1,14830,73208,6548036,3485,14774,3515878
2000-10-06,2001,6,D,1,1,14120,87328,6548036,3231,18005,3515878
2000-10-07,2001,7,D,1,1,14173,101501,6548036,3357,21362,3515878
2000-10-08,2001,8,D,1,1,14239,115740,6548036,3919,25281,3515878
2000-10-09,2001,9,D,1,1,13594,129334,6548036,3292,28573,3515878
2000-10-10,2001,10,D,1,1,14001,143335,6548036,4944,33517,3515878
2000-10-11,2001,11,D,1,1,14389,157724,6548036,7376,40893,3515878
2000-10-12,2001,12,D,1,1,15138,172862,6548036,6414,47307,3515878
2000-10-13,2001,13,D,1,1,14976,187838,6548036,5749,53056,3515878
2000-10-14,2001,14,D,1,1,14816,202654,6548036,6173,59229,3515878
2000-10-15,2001,15,D,1,1,14954,217608,6548036,5121,64350,3515878
2000-10-16,2001,16,D,1,1,14776,232384,6548036,2782,67132,3515878
2000-10-17,2001,17,D,1,1,14953,247337,6548036,3275,70407,3515878
2000-10-18,2001,18,D,1,1,15162,262499,6548036,3556,73963,3515878
2000-10-19,2001,19,D,1,1,15533,278032,6548036,4745,78708,3515878
2000-10-20,2001,20,D,1,1,15258,293290,6548036,3685,82393,3515878
2000-10-21,2001,21,D,1,1,16091,309381,6548036,4553,86946,3515878
2000-10-22,2001,22,D,1,1,15392,324773,6548036,5187,92133,3515878
2000-10-23,2001,23,D,1,1,14290,339063,6548036,3113,95246,3515878
2000-10-24,2001,24,D,1,1,14315,353378,6548036,3250,98496,3515878
2000-10-25,2001,25,D,1,1,13958,367336,6548036,4092,102588,3515878
2000-10-26,2001,26,D,1,1,14219,381555,6548036,7384,109972,3515878
2000-10-27,2001,27,D,1,1,15256,396811,6548036,9414,119386,3515878
2000-10-28,2001,28,D,1,1,15683,412494,6548036,13064,132450,3515878
2000-10-29,2001,29,D,1,1,17483,429977,6548036,15239,147689,3515878
2000-10-30,2001,30,D,1,1,17988,447965,6548036,17127,164816,3515878
2000-10-31,2001,31,D,1,1,18114,466079,6548036,13018,177834,3515878
2000-11-01,2001,32,D,1,1,18052,484131,6548036,12631,190465,3515878
2000-11-02,2001,33,D,1,1,17430,501561,6548036,8462,198927,3515878
2000-11-03,2001,34,D,1,1,17073,518634,6548036,6739,205666,3515878
2000-11-04,2001,35,D,1,1,15738,534372,6548036,5173,210839,3515878
2000-11-05,2001,36,D,1,1,15297,549669,6548036,3637,214476,3515878
2000-11-06,2001,37,D,1,1,15555,565224,6548036,3727,218203,3515878
2000-11-07,2001,38,D,1,1,14897,580121,6548036,4212,222415,3515878
2000-11-08,2001,39,D,1,1,14120,594241,6548036,2536,224951,3515878
2000-11-09,2001,40,D,1,1,14061,608302,6548036,3134,228085,3515878
2000-11-10,2001,41,D,1,1,13625,621927,6548036,2731,230816,3515878
2000-11-11,2001,42,D,1,1,13888,635815,6548036,3080,233896,3515878
2000-11-12,2001,43,D,1,1,13862,649677,6548036,3078,236974,3515878
2000-11-13,2001,44,D,1,1,13743,663420,6548036,3174,240148,3515878
2000-11-14,2001,45,D,1,1,14198,677618,6548036,3597,243745,3515878
2000-11-15,2001,46,D,1,1,14290,691908,6548036,3725,247470,3515878
2000-11-16,2001,47,D,1,1,14471,706379,6548036,3327,250797,3515878
2000-11-17,2001,48,D,1,1,15344,721723,6548036,4171,254968,3515878
2000-11-18,2001,49,D,1,1,15306,737029,6548036,3969,258937,3515878
2000-11-19,2001,50,D,1,1,15173,752202,6548036,3801,262738,3515878
2000-11-20,2001,51,D,1,1,15260,767462,6548036,3790,266528,3515878
2000-11-21,2001,52,D,1,1,15179,782641,6548036,5662,272190,3515878
2000-11-22,2001,53,D,1,1,15404,798045,6548036,5332,277522,3515878
2000-11-23,2001,54,D,1,1,15692,813737,6548036,5611,283133,3515878
2000-11-24,2001,55,D,1,1,15657,829394,6548036,5563,288696,3515878
2000-11-25,2001,56,D,1,1,15540,844934,6548036,5445,294141,3515878
2000-11-26,2001,57,D,1,1,15744,860678,6548036,4248,298389,3515878
2000-11-27,2001,58,D,1,1,15692,876370,6548036,4200,302589,3515878
2000-11-28,2001,59,D,1,1,15509,891879,6548036,4232,306821,3515878
2000-11-29,2001,60,D,1,1,15376,907255,6548036,3247,310068,3515878
2000-11-30,2001,61,D,1,1,16416,923671,6548036,10053,320121,3515878
2000-12-01,2001,62,D,1,1,16358,940029,6548036,8387,328508,3515878
2000-12-02,2001,63,D,1,1,16927,956956,6548036,8996,337504,3515878
2000-12-03,2001,64,D,1,1,17077,974033,6548036,8683,346187,3515878
2000-12-04,2001,65,D,1,1,16863,990896,6548036,6265,352452,3515878
2000-12-05,2001,66,D,1,1,16741,1007637,6548036,5034,357486,3515878
2000-12-06,2001,67,D,1,1,16423,1024060,6548036,4858,362344,3515878
2000-12-07,2001,68,D,1,1,16004,1040064,6548036,4267,366611,3515878
2000-12-08,2001,69,D,1,1,15901,1055965,6548036,4591,371202,3515878
2000-12-09,2001,70,D,1,1,15796,1071761,6548036,5003,376205,3515878
2000-12-10,2001,71,D,1,1,15581,1087342,6548036,5227,381432,3515878
2000-12-11,2001,72,D,1,1,15665,1103007,6548036,6914,388346,3515878
2000-12-12,2001,73,D,1,1,15743,1118750,6548036,6940,395286,3515878
2000-12-13,2001,74,D,1,1,15858,1134608,6548036,7554,402840,3515878
2000-12-14,2001,75,D,1,1,16463,1151071,6548036,8537,411377,3515878
2000-12-15,2001,76,D,1,1,16895,1167966,6548036,8473,419850,3515878
2000-12-16,2001,77,D,1,1,17629,1185595,6548036,7104,426954,3515878
2000-12-17,2001,78,D,1,1,18559,1204154,6548036,7657,434611,3515878
2000-12-18,2001,79,D,1,1,18237,1222391,6548036,7100,441711,3515878
2000-12-19,2001,80,D,1,1,17229,1239620,6548036,5216,446927,3515878
2000-12-20,2001,81,D,1,1,16537,1256157,6548036,3735,450662,3515878
2000-12-21,2001,82,D,1,1,16161,1272318,6548036,2836,453498,3515878
2000-12-22,2001,83,D,1,1,15970,1288288,6548036,5160,458658,3515878
2000-12-23,2001,84,D,1,1,15952,1304240,6548036,6144,464802,3515878
2000-12-24,2001,85,D,1,1,15935,1320175,6548036,6330,471132,3515878
2000-12-25,2001,86,D,1,1,16015,1336190,6548036,6462,477594,3515878
2000-12-26,2001,87,D,1,1,16006,1352196,6548036,6330,483924,3515878
2000-12-27,2001,88,D,1,1,15815,1368011,6548036,5259,489183,3515878
2000-12-28,2001,89,D,1,1,15708,1383719,6548036,4662,493845,3515878
2000-12-29,2001,90,D,1,1,15584,1399303,6548036,4201,498046,3515878
2000-12-30,2001,91,D,1,1,15462,1414765,6548036,3934,501980,3515878
2000-12-31,2001,92,D,1,1,15532,1430297,6548036,4036,506016,3515878
2001-01-01,2001,93,D,1,1,15523,1445820,6548036,4149,510165,3515878
2001-01-02,2001,94,D,1,1,15598,1461418,6548036,4807,514972,3515878
2001-01-03,2001,95,D,1,1,15358,1476776,6548036,5133,520105,3515878
2001-01-04,2001,96,D,1,1,15140,1491916,6548036,3593,523698,3515878
2001-01-05,2001,97,D,1,1,14941,1506857,6548036,3300,526998,3515878
2001-01-06,2001,98,D,1,1,14431,1521288,6548036,3355,530353,3515878
2001-01-07,2001,99,D,1,1,14039,1535327,6548036,5993,536346,3515878
2001-01-08,2001,100,D,1,1,15199,1550526,6548036,15004,551350,3515878
2001-01-09,2001,101,D,1,1,16947,1567473,6548036,18158,569508,3515878
2001-01-10,2001,102,D,1,1,17811,1585284,6548036,24557,594065,3515878
2001-01-11,2001,103,D,1,1,21052,1606336,6548036,28717,622782,3515878
2001-01-12,2001,104,D,1,1,24013,1630349,6548036,30722,653504,3515878
2001-01-13,2001,105,D,1,1,28689,1659038,6548036,28214,681718,3515878
2001-01-14,2001,106,D,1,1,27778,1686816,6548036,25607,707325,3515878
2001-01-15,2001,107,D,1,1,24941,1711757,6548036,17425,724750,3515878
2001-01-16,2001,108,D,1,1,22746,1734503,6548036,13578,738328,3515878
2001-01-17,2001,109,D,1,1,21206,1755709,6548036,13768,752096,3515878
2001-01-18,2001,110,D,1,1,19631,1775340,6548036,15516,767612,3515878
2001-01-19,2001,111,D,1,1,18263,1793603,6548036,14143,781755,3515878
2001-01-20,2001,112,D,1,1,17185,1810788,6548036,13038,794793,3515878
2001-01-21,2001,113,D,1,1,16434,1827222,6548036,9648,804441,3515878
2001-01-22,2001,114,D,1,1,15850,1843072,6548036,5166,809607,3515878
2001-01-23,2001,115,D,1,1,15810,1858882,6548036,6619,816226,3515878
2001-01-24,2001,116,D,1,1,16905,1875787,6548036,6180,822406,3515878
2001-01-25,2001,117,D,1,1,17776,1893563,6548036,12368,834774,3515878
2001-01-26,2001,118,D,1,1,23211,1916774,6548036,16258,851032,3515878
2001-01-27,2001,119,D,1,1,29858,1946632,6548036,28633,879665,3515878
2001-01-28,2001,120,D,1,1,34295,1980927,6548036,32048,911713,3515878
2001-01-29,2001,121,D,1,1,31337,2012264,6548036,29477,941190,3515878
2001-01-30,2001,122,D,1,1,26606,2038870,6548036,20125,961315,3515878
2001-01-31,2001,123,D,1,1,22679,2061549,6548036,16256,977571,3515878
2001-02-01,2001,124,D,1,1,20702,2082251,6548036,12292,989863,3515878
2001-02-02,2001,125,D,1,1,19011,2101262,6548036,10597,1000460,3515878
2001-02-03,2001,126,D,1,1,17738,2119000,6548036,8864,1009324,3515878
2001-02-04,2001,127,D,1,1,16662,2135662,6548036,7769,1017093,3515878
2001-02-05,2001,128,D,1,1,15833,2151495,6548036,6906,1023999,3515878
2001-02-06,2001,129,D,1,1,15240,2166735,6548036,5838,1029837,3515878
2001-02-07,2001,130,D,1,1,15740,2182475,6548036,6746,1036583,3515878
2001-02-08,2001,131,D,1,1,14707,2197182,6548036,4973,1041556,3515878
2001-02-09,2001,132,D,1,1,14893,2212075,6548036,7249,1048805,3515878
2001-02-10,2001,133,D,1,1,15684,2227759,6548036,7915,1056720,3515878
2001-02-11,2001,134,D,1,1,17563,2245322,6548036,14157,1070877,3515878
2001-02-12,2001,135,D,1,1,23301,2268623,6548036,19050,1089927,3515878
2001-02-13,2001,136,D,1,1,27612,2296235,6548036,22572,1112499,3515878
2001-02-14,2001,137,D,1,1,27503,2323738,6548036,21194,1133693,3515878
2001-02-15,2001,138,D,1,1,25245,2348983,6548036,17992,1151685,3515878
2001-02-16,2001,139,D,1,1,22034,2371017,6548036,14330,1166015,3515878
2001-02-17,2001,140,D,1,1,19619,2390636,6548036,11669,1177684,3515878
2001-02-18,2001,141,D,1,1,18593,2409229,6548036,11112,1188796,3515878
2001-02-19,2001,142,D,1,1,18123,2427352,6548036,13167,1201963,3515878
2001-02-20,2001,143,D,1,1,21113,2448465,6548036,16849,1218812,3515878
2001-02-21,2001,144,D,1,1,25296,2473761,6548036,21735,1240547,3515878
2001-02-22,2001,145,D,1,1,33141,2506902,6548036,32113,1272660,3515878
2001-02-23,2001,146,D,1,1,41245,2548147,6548036,40907,1313567,3515878
2001-02-24,2001,147,D,1,1,44708,2592855,6548036,40892,1354459,3515878
2001-02-25,2001,148,D,1,1,47496,2640351,6548036,43266,1397725,3515878
2001-02-26,2001,149,D,1,1,46831,2687182,6548036,41974,1439699,3515878
2001-02-27,2001,150,D,1,1,48112,2735294,6548036,44585,1484284,3515878
2001-02-28,2001,151,D,1,1,46547,2781841,6548036,41189,1525473,3515878
2001-03-01,2001,152,D,1,1,41282,2823123,6548036,31396,1556869,3515878
2001-03-02,2001,153,D,1,1,36648,2859771,6548036,29137,1586006,3515878
2001-03-03,2001,154,D,1,1,32882,2892653,6548036,26605,1612611,3515878
2001-03-04,2001,155,D,1,1,30309,2922962,6548036,26119,1638730,3515878
2001-03-05,2001,156,D,1,1,37028,2959990,6548036,36125,1674855,3515878
2001-03-06,2001,157,D,1,1,48728,3008718,6548036,46796,1721651,3515878
2001-03-07,2001,158,D,1,1,54323,3063041,6548036,55337,1776988,3515878
2001-03-08,2001,159,D,1,1,57122,3120163,6548036,56518,1833506,3515878
2001-03-09,2001,160,D,1,1,57684,3177847,6548036,54245,1887751,3515878
2001-03-10,2001,161,D,1,1,52521,3230368,6548036,44701,1932452,3515878
2001-03-11,2001,162,D,1,1,45557,3275925,6548036,37925,1970377,3515878
2001-03-12,2001,163,D,1,1,40593,3316518,6548036,29972,2000349,3515878
2001-03-13,2001,164,D,1,1,37098,3353616,6548036,27073,2027422,3515878
2001-03-14,2001,165,D,1,1,33590,3387206,6548036,23964,2051386,3515878
2001-03-15,2001,166,D,1,1,30235,3417441,6548036,20898,2072284,3515878
2001-03-16,2001,167,D,1,1,27186,3444627,6548036,18339,2090623,3515878
2001-03-17,2001,168,D,1,1,24899,3469526,6548036,16432,2107055,3515878
2001-03-18,2001,169,D,1,1,22231,3491757,6548036,13505,2120560,3515878
2001-03-19,2001,170,D,1,1,21189,3512946,6548036,12270,2132830,3515878
2001-03-20,2001,171,D,1,1,20480,3533426,6548036,11386,2144216,3515878
2001-03-21,2001,172,D,1,1,20166,3553592,6548036,11023,2155239,3515878
2001-03-22,2001,173,D,1,1,19983,3573575,6548036,10814,2166053,3515878
2001-03-23,2001,174,D,1,1,19884,3593459,6548036,10032,2176085,3515878
2001-03-24,2001,175,D,1,1,19235,3612694,6548036,9047,2185132,3515878
2001-03-25,2001,176,D,1,1,19466,3632160,6548036,9717,2194849,3515878
2001-03-26,2001,177,D,1,1,19203,3651363,6548036,9531,2204380,3515878
2001-03-27,2001,178,D,1,1,18947,3670310,6548036,10056,2214436,3515878
2001-03-28,2001,179,D,1,1,19102,3689412,6548036,10090,2224526,3515878
2001-03-29,2001,180,D,1,1,18613,3708025,6548036,9651,2234177,3515878
2001-03-30,2001,181,D,1,1,18107,3726132,6548036,9072,2243249,3515878
2001-03-31,2001,182,D,1,1,17500,3743632,6548036,8473,2251722,3515878
2001-04-01,2001,183,D,1,1,16950,3760582,6548036,8229,2259951,3515878
2001-04-02,2001,184,D,1,1,17228,3777810,6548036,8598,2268549,3515878
2001-04-03,2001,185,D,1,1,16787,3794597,6548036,8139,2276688,3515878
2001-04-04,2001,186,D,1,1,16235,3810832,6548036,7613,2284301,3515878
2001-04-05,2001,187,D,1,1,15575,3826407,6548036,9061,2293362,3515878
2001-04-06,2001,188,D,1,1,16233,3842640,6548036,13410,2306772,3515878
2001-04-07,2001,189,D,1,1,17369,3860009,6548036,15454,2322226,3515878
2001-04-08,2001,190,D,1,1,17400,3877409,6548036,16559,2338785,3515878
2001-04-09,2001,191,D,1,1,17249,3894658,6548036,16682,2355467,3515878
2001-04-10,2001,192,D,1,1,16974,3911632,6548036,14757,2370224,3515878
2001-04-11,2001,193,D,1,1,16419,3928051,6548036,10768,2380992,3515878
2001-04-12,2001,194,D,1,1,16670,3944721,6548036,10427,2391419,3515878
2001-04-13,2001,195,D,1,1,16066,3960787,6548036,8276,2399695,3515878
2001-04-14,2001,196,D,1,1,16061,3976848,6548036,8088,2407783,3515878
2001-04-15,2001,197,D,1,1,15688,3992536,6548036,7799,2415582,3515878
2001-04-16,2001,198,D,1,1,15128,4007664,6548036,6999,2422581,3515878
2001-04-17,2001,199,D,1,1,14581,4022245,6548036,6934,2429515,3515878
2001-04-18,2001,200,D,1,1,13250,4035495,6548036,6360,2435875,3515878
2001-04-19,2001,201,D,1,1,13139,4048634,6548036,6928,2442803,3515878
2001-04-20,2001,202,D,1,1,15198,4063832,6548036,17752,2460555,3515878
2001-04-21,2001,203,D,1,1,18418,4082250,6548036,20564,2481119,3515878
2001-04-22,2001,204,D,1,1,18567,4100817,6548036,20692,2501811,3515878
2001-04-23,2001,205,D,1,1,18303,4119120,6548036,20502,2522313,3515878
2001-04-24,2001,206,D,1,1,18028,4137148,6548036,20012,2542325,3515878
2001-04-25,2001,207,D,1,1,17607,4154755,6548036,13794,2556119,3515878
2001-04-26,2001,208,D,1,1,16658,4171413,6548036,12937,2569056,3515878
2001-04-27,2001,209,D,1,1,16511,4187924,6548036,12784,2581840,3515878
2001-04-28,2001,210,D,1,1,16747,4204671,6548036,12877,2594717,3515878
2001-04-29,2001,211,D,1,1,16122,4220793,6548036,12259,2606976,3515878
2001-04-30,2001,212,D,1,1,15190,4235983,6548036,11318,2618294,3515878
2001-05-01,2001,213,D,1,1,14718,4250701,6548036,10959,2629253,3515878
2001-05-02,2001,214,D,1,1,14880,4265581,6548036,11162,2640415,3515878
2001-05-03,2001,215,D,1,1,13904,4279485,6548036,10127,2650542,3515878
2001-05-04,2001,216,D,1,1,13525,4293010,6548036,9673,2660215,3515878
2001-05-05,2001,217,D,1,1,13069,4306079,6548036,9161,2669376,3515878
2001-05-06,2001,218,D,1,1,12421,4318500,6548036,8506,2677882,3515878
2001-05-07,2001,219,D,1,1,12187,4330687,6548036,8275,2686157,3515878
2001-05-08,2001,220,D,1,1,12400,4343087,6548036,8547,2694704,3515878
2001-05-09,2001,221,D,1,1,12591,4355678,6548036,8523,2703227,3515878
2001-05-10,2001,222,D,1,1,12795,4368473,6548036,8853,2712080,3515878
2001-05-11,2001,223,D,1,1,12677,4381150,6548036,8732,2720812,3515878
2001-05-12,2001,224,D,1,1,12744,4393894,6548036,8776,2729588,3515878
2001-05-13,2001,225,D,1,1,14105,4407999,6548036,10123,2739711,3515878
2001-05-14,2001,226,D,1,1,14339,4422338,6548036,10209,2749920,3515878
2001-05-15,2001,227,D,1,1,14309,4436647,6548036,10303,2760223,3515878
2001-05-16,2001,228,D,1,1,14279,4450926,6548036,10158,2770381,3515878
2001-05-17,2001,229,D,1,1,14796,4465722,6548036,10670,2781051,3515878
2001-05-18,2001,230,D,1,1,15508,4481230,6548036,11402,2792453,3515878
2001-05-19,2001,231,D,1,1,15444,4496674,6548036,11245,2803698,3515878
2001-05-20,2001,232,D,1,1,15525,4512199,6548036,11273,2814971,3515878
2001-05-21,2001,233,D,1,1,14958,4527157,6548036,10707,2825678,3515878
2001-05-22,2001,234,D,1,1,14083,4541240,6548036,9760,2835438,3515878
2001-05-23,2001,235,D,1,1,13379,4554619,6548036,9074,2844512,3515878
2001-05-24,2001,236,D,1,1,12818,4567437,6548036,8467,2852979,3515878
2001-05-25,2001,237,D,1,1,12343,4579780,6548036,7950,2860929,3515878
2001-05-26,2001,238,D,1,1,12291,4592071,6548036,7880,2868809,3515878
2001-05-27,2001,239,D,1,1,12294,4604365,6548036,7760,2876569,3515878
2001-05-28,2001,240,D,1,1,13811,4618176,6548036,9366,2885935,3515878
2001-05-29,2001,241,D,1,1,14888,4633064,6548036,10942,2896877,3515878
2001-05-30,2001,242,D,1,1,15417,4648481,6548036,11458,2908335,3515878
2001-05-31,2001,243,D,1,1,15249,4663730,6548036,10871,2919206,3515878
2001-06-01,2001,244,D,1,1,14624,4678354,6548036,8982,2928188,3515878
2001-06-02,2001,245,D,1,1,15066,4693420,6548036,8376,2936564,3515878
2001-06-03,2001,246,D,1,1,15362,4708782,6548036,8257,2944821,3515878
2001-06-04,2001,247,D,1,1,15190,4723972,6548036,7975,2952796,3515878
2001-06-05,2001,248,D,1,1,15032,4739004,6548036,7848,2960644,3515878
2001-06-06,2001,249,D,1,1,14945,4753949,6548036,8381,2969025,3515878
2001-06-07,2001,250,D,1,1,14373,4768322,6548036,6824,2975849,3515878
2001-06-08,2001,251,D,1,1,14280,4782602,6548036,6835,2982684,3515878
2001-06-09,2001,252,D,1,1,15442,4798044,6548036,8420,2991104,3515878
2001-06-10,2001,253,D,1,1,15103,4813147,6548036,8043,2999147,3515878
2001-06-11,2001,254,D,1,1,14138,4827285,6548036,6912,3006059,3515878
2001-06-12,2001,255,D,1,1,14692,4841977,6548036,7586,3013645,3515878
2001-06-13,2001,256,D,1,1,14799,4856776,6548036,7642,3021287,3515878
2001-06-14,2001,257,D,1,1,14768,4871544,6548036,6912,3028199,3515878
2001-06-15,2001,258,D,1,1,14149,4885693,6548036,5343,3033542,3515878
2001-06-16,2001,259,D,1,1,14001,4899694,6548036,5520,3039062,3515878
2001-06-17,2001,260,D,1,1,14031,4913725,6548036,5485,3044547,3515878
2001-06-18,2001,261,D,1,1,14195,4927920,6548036,7189,3051736,3515878
2001-06-19,2001,262,D,1,1,13977,4941897,6548036,7100,3058836,3515878
2001-06-20,2001,263,D,1,1,13950,4955847,6548036,6448,3065284,3515878
2001-06-21,2001,264,D,1,1,14374,4970221,6548036,7228,3072512,3515878
2001-06-22,2001,265,D,1,1,14192,4984413,6548036,7313,3079825,3515878
2001-06-23,2001,266,D,1,1,14062,4998475,6548036,7141,3086966,3515878
2001-06-24,2001,267,D,1,1,14729,5013204,6548036,7743,3094709,3515878
2001-06-25,2001,268,D,1,1,14979,5028183,6548036,8312,3103021,3515878
2001-06-26,2001,269,D,1,1,14753,5042936,6548036,7581,3110602,3515878
2001-06-27,2001,270,D,1,1,15394,5058330,6548036,7822,3118424,3515878
2001-06-28,2001,271,D,1,1,16085,5074415,6548036,8532,3126956,3515878
2001-06-29,2001,272,D,1,1,17023,5091438,6548036,8803,3135759,3515878
2001-06-30,2001,273,D,1,1,17593,5109031,6548036,8723,3144482,3515878
2001-07-01,2001,274,D,1,1,17487,5126518,6548036,7034,3151516,3515878
2001-07-02,2001,275,D,1,1,17201,5143719,6548036,6778,3158294,3515878
2001-07-03,2001,276,D,1,1,16690,5160409,6548036,6668,3164962,3515878
2001-07-04,2001,277,D,1,1,16347,5176756,6548036,5694,3170656,3515878
2001-07-05,2001,278,D,1,1,15877,5192633,6548036,5196,3175852,3515878
2001-07-06,2001,279,D,1,1,16157,5208790,6548036,5342,3181194,3515878
2001-07-07,2001,280,D,1,1,16831,5225621,6548036,5553,3186747,3515878
2001-07-08,2001,281,D,1,1,16886,5242507,6548036,4988,3191735,3515878
2001-07-09,2001,282,D,1,1,17026,5259533,6548036,4397,3196132,3515878
2001-07-10,2001,283,D,1,1,17077,5276610,6548036,3632,3199764,3515878
2001-07-11,2001,284,D,1,1,16875,5293485,6548036,3497,3203261,3515878
2001-07-12,2001,285,D,1,1,17120,5310605,6548036,3742,3207003,3515878
2001-07-13,2001,286,D,1,1,16933,5327538,6548036,3757,3210760,3515878
2001-07-14,2001,287,D,1,1,16748,5344286,6548036,3887,3214647,3515878
2001-07-15,2001,288,D,1,1,16717,5361003,6548036,4240,3218887,3515878
2001-07-16,2001,289,D,1,1,16998,5378001,6548036,4533,3223420,3515878
2001-07-17,2001,290,D,1,1,17243,5395244,6548036,4749,3228169,3515878
2001-07-18,2001,291,D,1,1,17066,5412310,6548036,4180,3232349,3515878
2001-07-19,2001,292,D,1,1,16459,5428769,6548036,3570,3235919,3515878
2001-07-20,2001,293,D,1,1,16866,5445635,6548036,4038,3239957,3515878
2001-07-21,2001,294,D,1,1,17129,5462764,6548036,4324,3244281,3515878
2001-07-22,2001,295,D,1,1,17373,5480137,6548036,4823,3249104,3515878
2001-07-23,2001,296,D,1,1,17547,5497684,6548036,4987,3254091,3515878
2001-07-24,2001,297,D,1,1,17411,5515095,6548036,4801,3258892,3515878
2001-07-25,2001,298,D,1,1,17439,5532534,6548036,4085,3262977,3515878
2001-07-26,2001,299,D,1,1,17855,5550389,6548036,4824,3267801,3515878
2001-07-27,2001,300,D,1,1,17956,5568345,6548036,4663,3272464,3515878
2001-07-28,2001,301,D,1,1,18106,5586451,6548036,4866,3277330,3515878
2001-07-29,2001,302,D,1,1,18037,5604488,6548036,4803,3282133,3515878
2001-07-30,2001,303,D,1,1,18436,5622924,6548036,4688,3286821,3515878
2001-07-31,2001,304,D,1,1,18168,5641092,6548036,4067,3290888,3515878
2001-08-01,2001,305,D,1,1,16946,5658038,6548036,2975,3293863,3515878
2001-08-02,2001,306,D,1,1,16936,5674974,6548036,3821,3297684,3515878
2001-08-03,2001,307,D,1,1,16519,5691493,6548036,3415,3301099,3515878
2001-08-04,2001,308,D,1,1,16280,5707773,6548036,3029,3304128,3515878
2001-08-05,2001,309,D,1,1,16006,5723779,6548036,2826,3306954,3515878
2001-08-06,2001,310,D,1,1,15827,5739606,6548036,3461,3310415,3515878
2001-08-07,2001,311,D,1,1,15519,5755125,6548036,3674,3314089,3515878
2001-08-08,2001,312,D,1,1,15277,5770402,6548036,3170,3317259,3515878
2001-08-09,2001,313,D,1,1,15178,5785580,6548036,3369,3320628,3515878
2001-08-10,2001,314,D,1,1,15581,5801161,6548036,4215,3324843,3515878
2001-08-11,2001,315,D,1,1,16040,5817201,6548036,4658,3329501,3515878
2001-08-12,2001,316,D,1,1,15304,5832505,6548036,3964,3333465,3515878
2001-08-13,2001,317,D,1,1,16158,5848663,6548036,4513,3337978,3515878
2001-08-14,2001,318,D,1,1,15693,5864356,6548036,3111,3341089,3515878
2001-08-15,2001,319,D,1,1,15469,5879825,6548036,2708,3343797,3515878
2001-08-16,2001,320,D,1,1,15589,5895414,6548036,3487,3347284,3515878
2001-08-17,2001,321,D,1,1,15466,5910880,6548036,2873,3350157,3515878
2001-08-18,2001,322,D,1,1,15447,5926327,6548036,2809,3352966,3515878
2001-08-19,2001,323,D,1,1,15458,5941785,6548036,2725,3355691,3515878
2001-08-20,2001,324,D,1,1,15029,5956814,6548036,2494,3358185,3515878
2001-08-21,2001,325,D,1,1,15103,5971917,6548036,3681,3361866,3515878
2001-08-22,2001,326,D,1,1,14655,5986572,6548036,2640,3364506,3515878
2001-08-23,2001,327,D,1,1,14960,6001532,6548036,3105,3367611,3515878
2001-08-24,2001,328,D,1,1,14572,6016104,6548036,1986,3369597,3515878
2001-08-25,2001,329,D,1,1,14133,6030237,6548036,1969,3371566,3515878
2001-08-26,2001,330,D,1,1,14419,6044656,6548036,3017,3374583,3515878
2001-08-27,2001,331,D,1,1,14553,6059209,6548036,3338,3377921,3515878
2001-08-28,2001,332,D,1,1,14180,6073389,6548036,3007,3380928,3515878
2001-08-29,2001,333,D,1,1,14101,6087490,6548036,3010,3383938,3515878
2001-08-30,2001,334,D,1,1,14428,6101918,6548036,3300,3387238,3515878
2001-08-31,2001,335,D,1,1,14329,6116247,6548036,3682,3390920,3515878
2001-09-01,2001,336,D,1,1,14077,6130324,6548036,4039,3394959,3515878
2001-09-02,2001,337,D,1,1,14257,6144581,6548036,4267,3399226,3515878
2001-09-03,2001,338,D,1,1,14585,6159166,6548036,4664,3403890,3515878
2001-09-04,2001,339,D,1,1,14422,6173588,6548036,3502,3407392,3515878
2001-09-05,2001,340,D,1,1,14609,6188197,6548036,3819,3411211,3515878
2001-09-06,2001,341,D,1,1,14640,6202837,6548036,3368,3414579,3515878
2001-09-07,2001,342,D,1,1,14644,6217481,6548036,3416,3417995,3515878
2001-09-08,2001,343,D,1,1,14723,6232204,6548036,3515,3421510,3515878
2001-09-09,2001,344,D,1,1,14749,6246953,6548036,3995,3425505,3515878
2001-09-10,2001,345,D,1,1,15249,6262202,6548036,5122,3430627,3515878
2001-09-11,2001,346,D,1,1,14990,6277192,6548036,3846,3434473,3515878
2001-09-12,2001,347,D,1,1,15046,6292238,6548036,4052,3438525,3515878
2001-09-13,2001,348,D,1,1,15439,6307677,6548036,5463,3443988,3515878
2001-09-14,2001,349,D,1,1,14971,6322648,6548036,4982,3448970,3515878
2001-09-15,2001,350,D,1,1,14355,6337003,6548036,4107,3453077,3515878
2001-09-16,2001,351,D,1,1,14291,6351294,6548036,4050,3457127,3515878
2001-09-17,2001,352,D,1,1,14516,6365810,6548036,3999,3461126,3515878
2001-09-18,2001,353,D,1,1,14374,6380184,6548036,3701,3464827,3515878
2001-09-19,2001,354,D,1,1,14007,6394191,6548036,3248,3468075,3515878
2001-09-20,2001,355,D,1,1,13672,6407863,6548036,3471,3471546,3515878
2001-09-21,2001,356,D,1,1,13940,6421803,6548036,4048,3475594,3515878
2001-09-22,2001,357,D,1,1,14041,6435844,6548036,4362,3479956,3515878
2001-09-23,2001,358,D,1,1,13650,6449494,6548036,3570,3483526,3515878
2001-09-24,2001,359,D,1,1,14117,6463611,6548036,5270,3488796,3515878
2001-09-25,2001,360,D,1,1,14601,6478212,6548036,5640,3494436,3515878
2001-09-26,2001,361,D,1,1,14112,6492324,6548036,5619,3500055,3515878
2001-09-27,2001,362,D,1,1,13940,6506264,6548036,4168,3504223,3515878
2001-09-28,2001,363,D,1,1,14186,6520450,6548036,4986,3509209,3515878
2001-09-29,2001,364,D,1,1,13937,6534387,6548036,3459,3512668,3515878
2001-09-30,2001,365,D,1,1,13649,6548036,6548036,3210,3515878,3515878
2001-10-01,2002,1,D,2,2,13452,13452,7900894,2995,2995,4634131
2001-10-02,2002,2,D,2,2,12441,25893,7900894,2039,5034,4634131
2001-10-03,2002,3,D,2,2,12176,38069,7900894,2197,7231,4634131
2001-10-04,2002,4,D,2,2,11113,49182,7900894,2293,9524,4634131
2001-10-05,2002,5,D,2,2,11544,60726,7900894,3173,12697,4634131
2001-10-06,2002,6,D,2,2,11591,72317,7900894,4783,17480,4634131
2001-10-07,2002,7,D,2,2,11160,83477,7900894,4410,21890,4634131
2001-10-08,2002,8,D,2,2,10897,94374,7900894,4138,26028,4634131
2001-10-09,2002,9,D,2,2,10317,104691,7900894,3582,29610,4634131
2001-10-10,2002,10,D,2,2,10442,115133,7900894,3694,33304,4634131
2001-10-11,2002,11,D,2,2,9895,125028,7900894,3388,36692,4634131
2001-10-12,2002,12,D,2,2,10060,135088,7900894,3598,40290,4634131
2001-10-13,2002,13,D,2,2,9645,144733,7900894,3198,43488,4634131
2001-10-14,2002,14,D,2,2,9042,153775,7900894,2654,46142,4634131
2001-10-15,2002,15,D,2,2,9787,163562,7900894,3244,49386,4634131
2001-10-16,2002,16,D,2,2,9754,173316,7900894,3770,53156,4634131
2001-10-17,2002,17,D,2,2,8952,182268,7900894,3120,56276,4634131
2001-10-18,2002,18,D,2,2,9025,191293,7900894,3330,59606,4634131
2001-10-19,2002,19,D,2,2,9121,200414,7900894,3500,63106,4634131
2001-10-20,2002,20,D,2,2,9146,209560,7900894,3522,66628,4634131
2001-10-21,2002,21,D,2,2,9489,219049,7900894,3494,70122,4634131
2001-10-22,2002,22,D,2,2,10992,230041,7900894,5019,75141,4634131
2001-10-23,2002,23,D,2,2,11657,241698,7900894,6447,81588,4634131
2001-10-24,2002,24,D,2,2,11275,252973,7900894,6329,87917,4634131
2001-10-25,2002,25,D,2,2,11566,264539,7900894,6589,94506,4634131
2001-10-26,2002,26,D,2,2,11293,275832,7900894,6352,100858,4634131
2001-10-27,2002,27,D,2,2,11256,287088,7900894,6342,107200,4634131
2001-10-28,2002,28,D,2,2,11602,298690,7900894,6594,113794,4634131
2001-10-29,2002,29,D,2,2,11146,309836,7900894,5383,119177,4634131
2001-10-30,2002,30,D,2,2,11286,321122,7900894,7091,126268,4634131
2001-10-31,2002,31,D,2,2,11889,333011,7900894,6275,132543,4634131
2001-11-01,2002,32,D,2,2,12045,345056,7900894,6462,139005,4634131
2001-11-02,2002,33,D,2,2,12026,357082,7900894,5883,144888,4634131
2001-11-03,2002,34,D,2,2,11602,368684,7900894,4921,149809,4634131
2001-11-04,2002,35,D,2,2,11523,380207,7900894,3054,152863,4634131
2001-11-05,2002,36,D,2,2,12407,392614,7900894,4443,157306,4634131
2001-11-06,2002,37,D,2,2,12184,404798,7900894,2810,160116,4634131
2001-11-07,2002,38,D,2,2,11808,416606,7900894,3884,164000,4634131
2001-11-08,2002,39,D,2,2,11696,428302,7900894,4589,168589,4634131
2001-11-09,2002,40,D,2,2,11636,439938,7900894,4476,173065,4634131
2001-11-10,2002,41,D,2,2,11259,451197,7900894,3151,176216,4634131
2001-11-11,2002,42,D,2,2,11289,462486,7900894,3870,180086,4634131
2001-11-12,2002,43,D,2,2,11950,474436,7900894,8801,188887,4634131
2001-11-13,2002,44,D,2,2,14498,488934,7900894,12093,200980,4634131
2001-11-14,2002,45,D,2,2,15283,504217,7900894,11820,212800,4634131
2001-11-15,2002,46,D,2,2,15930,520147,7900894,11997,224797,4634131
2001-11-16,2002,47,D,2,2,15607,535754,7900894,11188,235985,4634131
2001-11-17,2002,48,D,2,2,14903,550657,7900894,3330,239315,4634131
2001-11-18,2002,49,D,2,2,14258,564915,7900894,3548,242863,4634131
2001-11-19,2002,50,D,2,2,13724,578639,7900894,3064,245927,4634131
2001-11-20,2002,51,D,2,2,13173,591812,7900894,2533,248460,4634131
2001-11-21,2002,52,D,2,2,12740,604552,7900894,4409,252869,4634131
2001-11-22,2002,53,D,2,2,13819,618371,7900894,5597,258466,4634131
2001-11-23,2002,54,D,2,2,14277,632648,7900894,5999,264465,4634131
2001-11-24,2002,55,D,2,2,16056,648704,7900894,10301,274766,4634131
2001-11-25,2002,56,D,2,2,20622,669326,7900894,15592,290358,4634131
2001-11-26,2002,57,D,2,2,23282,692608,7900894,18063,308421,4634131
2001-11-27,2002,58,D,2,2,24504,717112,7900894,18150,326571,4634131
2001-11-28,2002,59,D,2,2,21165,738277,7900894,16879,343450,4634131
2001-11-29,2002,60,D,2,2,19015,757292,7900894,17086,360536,4634131
2001-11-30,2002,61,D,2,2,18346,775638,7900894,18397,378933,4634131
2001-12-01,2002,62,D,2,2,21023,796661,7900894,23760,402693,4634131
2001-12-02,2002,63,D,2,2,26205,822866,7900894,32607,435300,4634131
2001-12-03,2002,64,D,2,2,34042,856908,7900894,39342,474642,4634131
2001-12-04,2002,65,D,2,2,39745,896653,7900894,40777,515419,4634131
2001-12-05,2002,66,D,2,2,38896,935549,7900894,36320,551739,4634131
2001-12-06,2002,67,D,2,2,35825,971374,7900894,27409,579148,4634131
2001-12-07,2002,68,D,2,2,32616,1003990,7900894,20619,599767,4634131
2001-12-08,2002,69,D,2,2,33396,1037386,7900894,20889,620656,4634131
2001-12-09,2002,70,D,2,2,32211,1069597,7900894,19917,640573,4634131
2001-12-10,2002,71,D,2,2,28628,1098225,7900894,16447,657020,4634131
2001-12-11,2002,72,D,2,2,24560,1122785,7900894,11963,668983,4634131
2001-12-12,2002,73,D,2,2,23114,1145899,7900894,10169,679152,4634131
2001-12-13,2002,74,D,2,2,21176,1167075,7900894,9543,688695,4634131
2001-12-14,2002,75,D,2,2,20069,1187144,7900894,10258,698953,4634131
2001-12-15,2002,76,D,2,2,21272,1208416,7900894,10941,709894,4634131
2001-12-16,2002,77,D,2,2,26339,1234755,7900894,15962,725856,4634131
2001-12-17,2002,78,D,2,2,27120,1261875,7900894,17853,743709,4634131
2001-12-18,2002,79,D,2,2,25726,1287601,7900894,15626,759335,4634131
2001-12-19,2002,80,D,2,2,26338,1313939,7900894,14375,773710,4634131
2001-12-20,2002,81,D,2,2,27179,1341118,7900894,17575,791285,4634131
2001-12-21,2002,82,D,2,2,29458,1370576,7900894,20605,811890,4634131
2001-12-22,2002,83,D,2,2,36678,1407254,7900894,27160,839050,4634131
2001-12-23,2002,84,D,2,2,41002,1448256,7900894,32820,871870,4634131
2001-12-24,2002,85,D,2,2,42178,1490434,7900894,33649,905519,4634131
2001-12-25,2002,86,D,2,2,42092,1532526,7900894,30559,936078,4634131
2001-12-26,2002,87,D,2,2,40313,1572839,7900894,28524,964602,4634131
2001-12-27,2002,88,D,2,2,36846,1609685,7900894,24638,989240,4634131
2001-12-28,2002,89,D,2,2,34065,1643750,7900894,28969,1018209,4634131
2001-12-29,2002,90,D,2,2,36014,1679764,7900894,35153,1053362,4634131
2001-12-30,2002,91,D,2,2,41294,1721058,7900894,42906,1096268,4634131
2001-12-31,2002,92,D,2,2,48343,1769401,7900894,49520,1145788,4634131
2002-01-01,2002,93,D,2,2,52124,1821525,7900894,52676,1198464,4634131
2002-01-02,2002,94,D,2,2,56955,1878480,7900894,54248,1252712,4634131
2002-01-03,2002,95,D,2,2,70450,1948930,7900894,64026,1316738,4634131
2002-01-04,2002,96,D,2,2,78179,2027109,7900894,69275,1386013,4634131
2002-01-05,2002,97,D,2,2,90496,2117605,7900894,88188,1474201,4634131
2002-01-06,2002,98,D,2,2,108391,2225996,7900894,105892,1580093,4634131
2002-01-07,2002,99,D,2,2,95277,2321273,7900894,88316,1668409,4634131
2002-01-08,2002,100,D,2,2,84991,2406264,7900894,77735,1746144,4634131
2002-01-09,2002,101,D,2,2,78465,2484729,7900894,71417,1817561,4634131
2002-01-10,2002,102,D,2,2,73172,2557901,7900894,59931,1877492,4634131
2002-01-11,2002,103,D,2,2,68658,2626559,7900894,55748,1933240,4634131
2002-01-12,2002,104,D,2,2,63221,2689780,7900894,50381,1983621,4634131
2002-01-13,2002,105,D,2,2,56935,2746715,7900894,44035,2027656,4634131
2002-01-14,2002,106,D,2,2,50520,2797235,7900894,37677,2065333,4634131
2002-01-15,2002,107,D,2,2,45335,2842570,7900894,32426,2097759,4634131
2002-01-16,2002,108,D,2,2,41387,2883957,7900894,28401,2126160,4634131
2002-01-17,2002,109,D,2,2,38502,2922459,7900894,25528,2151688,4634131
2002-01-18,2002,110,D,2,2,36066,2958525,7900894,23187,2174875,4634131
2002-01-19,2002,111,D,2,2,33646,2992171,7900894,20822,2195697,4634131
2002-01-20,2002,112,D,2,2,31437,3023608,7900894,19036,2214733,4634131
2002-01-21,2002,113,D,2,2,28936,3052544,7900894,16189,2230922,4634131
2002-01-22,2002,114,D,2,2,27353,3079897,7900894,14897,2245819,4634131
2002-01-23,2002,115,D,2,2,25931,3105828,7900894,13561,2259380,4634131
2002-01-24,2002,116,D,2,2,23951,3129779,7900894,11221,2270601,4634131
2002-01-25,2002,117,D,2,2,22936,3152715,7900894,10194,2280795,4634131
2002-01-26,2002,118,D,2,2,22179,3174894,7900894,10841,2291636,4634131
2002-01-27,2002,119,D,2,2,23046,3197940,7900894,11760,2303396,4634131
2002-01-28,2002,120,D,2,2,22929,3220869,7900894,11631,2315027,4634131
2002-01-29,2002,121,D,2,2,22347,3243216,7900894,11288,2326315,4634131
2002-01-30,2002,122,D,2,2,21924,3265140,7900894,10903,2337218,4634131
2002-01-31,2002,123,D,2,2,21592,3286732,7900894,9244,2346462,4634131
2002-02-01,2002,124,D,2,2,20986,3307718,7900894,10377,2356839,4634131
2002-02-02,2002,125,D,2,2,20670,3328388,7900894,10140,2366979,4634131
2002-02-03,2002,126,D,2,2,20426,3348814,7900894,9506,2376485,4634131
2002-02-04,2002,127,D,2,2,19883,3368697,7900894,9129,2385614,4634131
2002-02-05,2002,128,D,2,2,19201,3387898,7900894,8312,2393926,4634131
2002-02-06,2002,129,D,2,2,18854,3406752,7900894,8401,2402327,4634131
2002-02-07,2002,130,D,2,2,18264,3425016,7900894,9576,2411903,4634131
2002-02-08,2002,131,D,2,2,18486,3443502,7900894,9781,2421684,4634131
2002-02-09,2002,132,D,2,2,18205,3461707,7900894,9506,2431190,4634131
2002-02-10,2002,133,D,2,2,18116,3479823,7900894,9501,2440691,4634131
2002-02-11,2002,134,D,2,2,18206,3498029,7900894,9618,2450309,4634131
2002-02-12,2002,135,D,2,2,17705,3515734,7900894,7821,2458130,4634131
2002-02-13,2002,136,D,2,2,17511,3533245,7900894,7703,2465833,4634131
2002-02-14,2002,137,D,2,2,17176,3550421,7900894,7650,2473483,4634131
2002-02-15,2002,138,D,2,2,17055,3567476,7900894,8726,2482209,4634131
2002-02-16,2002,139,D,2,2,16762,3584238,7900894,9857,2492066,4634131
2002-02-17,2002,140,D,2,2,17747,3601985,7900894,12728,2504794,4634131
2002-02-18,2002,141,D,2,2,18050,3620035,7900894,13073,2517867,4634131
2002-02-19,2002,142,D,2,2,18212,3638247,7900894,12126,2529993,4634131
2002-02-20,2002,143,D,2,2,19925,3658172,7900894,13688,2543681,4634131
2002-02-21,2002,144,D,2,2,23358,3681530,7900894,16098,2559779,4634131
2002-02-22,2002,145,D,2,2,32062,3713592,7900894,22811,2582590,4634131
2002-02-23,2002,146,D,2,2,34342,3747934,7900894,24965,2607555,4634131
2002-02-24,2002,147,D,2,2,30503,3778437,7900894,19509,2627064,4634131
2002-02-25,2002,148,D,2,2,26487,3804924,7900894,15609,2642673,4634131
2002-02-26,2002,149,D,2,2,24099,3829023,7900894,14682,2657355,4634131
2002-02-27,2002,150,D,2,2,22292,3851315,7900894,13506,2670861,4634131
2002-02-28,2002,151,D,2,2,21348,3872663,7900894,12432,2683293,4634131
2002-03-01,2002,152,D,2,2,20695,3893358,7900894,11734,2695027,4634131
2002-03-02,2002,153,D,2,2,20575,3913933,7900894,11575,2706602,4634131
2002-03-03,2002,154,D,2,2,21150,3935083,7900894,11949,2718551,4634131
2002-03-04,2002,155,D,2,2,20963,3956046,7900894,11367,2729918,4634131
2002-03-05,2002,156,D,2,2,20527,3976573,7900894,11062,2740980,4634131
2002-03-06,2002,157,D,2,2,20926,3997499,7900894,14905,2755885,4634131
2002-03-07,2002,158,D,2,2,24656,4022155,7900894,19298,2775183,4634131
2002-03-08,2002,159,D,2,2,28248,4050403,7900894,22749,2797932,4634131
2002-03-09,2002,160,D,2,2,30146,4080549,7900894,24723,2822655,4634131
2002-03-10,2002,161,D,2,2,31508,4112057,7900894,27474,2850129,4634131
2002-03-11,2002,162,D,2,2,31775,4143832,7900894,24236,2874365,4634131
2002-03-12,2002,163,D,2,2,32347,4176179,7900894,23707,2898072,4634131
2002-03-13,2002,164,D,2,2,31198,4207377,7900894,22576,2920648,4634131
2002-03-14,2002,165,D,2,2,28970,4236347,7900894,19767,2940415,4634131
2002-03-15,2002,166,D,2,2,26990,4263337,7900894,16431,2956846,4634131
2002-03-16,2002,167,D,2,2,25724,4289061,7900894,15115,2971961,4634131
2002-03-17,2002,168,D,2,2,24576,4313637,7900894,15003,2986964,4634131
2002-03-18,2002,169,D,2,2,24032,4337669,7900894,14784,3001748,4634131
2002-03-19,2002,170,D,2,2,22846,4360515,7900894,13456,3015204,4634131
2002-03-20,2002,171,D,2,2,21932,4382447,7900894,12394,3027598,4634131
2002-03-21,2002,172,D,2,2,21136,4403583,7900894,11442,3039040,4634131
2002-03-22,2002,173,D,2,2,20928,4424511,7900894,11647,3050687,4634131
2002-03-23,2002,174,D,2,2,22178,4446689,7900894,18986,3069673,4634131
2002-03-24,2002,175,D,2,2,25234,4471923,7900894,22058,3091731,4634131
2002-03-25,2002,176,D,2,2,27780,4499703,7900894,24678,3116409,4634131
2002-03-26,2002,177,D,2,2,27086,4526789,7900894,24431,3140840,4634131
2002-03-27,2002,178,D,2,2,24791,4551580,7900894,19697,3160537,4634131
2002-03-28,2002,179,D,2,2,22717,4574297,7900894,14826,3175363,4634131
2002-03-29,2002,180,D,2,2,21179,4595476,7900894,13252,3188615,4634131
2002-03-30,2002,181,D,2,2,20561,4616037,7900894,11139,3199754,4634131
2002-03-31,2002,182,D,2,2,20431,4636468,7900894,9985,3209739,4634131
2002-04-01,2002,183,D,2,2,20028,4656496,7900894,9876,3219615,4634131
2002-04-02,2002,184,D,2,2,19369,4675865,7900894,9607,3229222,4634131
2002-04-03,2002,185,D,2,2,19509,4695374,7900894,9472,3238694,4634131
2002-04-04,2002,186,D,2,2,19896,4715270,7900894,9810,3248504,4634131
2002-04-05,2002,187,D,2,2,19528,4734798,7900894,9830,3258334,4634131
2002-04-06,2002,188,D,2,2,18910,4753708,7900894,9053,3267387,4634131
2002-04-07,2002,189,D,2,2,19073,4772781,7900894,9681,3277068,4634131
2002-04-08,2002,190,D,2,2,18676,4791457,7900894,9226,3286294,4634131
2002-04-09,2002,191,D,2,2,19051,4810508,7900894,9795,3296089,4634131
2002-04-10,2002,192,D,2,2,19284,4829792,7900894,10229,3306318,4634131
2002-04-11,2002,193,D,2,2,18977,4848769,7900894,9833,3316151,4634131
2002-04-12,2002,194,D,2,2,19043,4867812,7900894,9972,3326123,4634131
2002-04-13,2002,195,D,2,2,19022,4886834,7900894,10182,3336305,4634131
2002-04-14,2002,196,D,2,2,18367,4905201,7900894,9279,3345584,4634131
2002-04-15,2002,197,D,2,2,19759,4924960,7900894,15372,3360956,4634131
2002-04-16,2002,198,D,2,2,19440,4944400,7900894,16044,3377000,4634131
2002-04-17,2002,199,D,2,2,19208,4963608,7900894,16037,3393037,4634131
2002-04-18,2002,200,D,2,2,19816,4983424,7900894,16833,3409870,4634131
2002-04-19,2002,201,D,2,2,19194,5002618,7900894,16055,3425925,4634131
2002-04-20,2002,202,D,2,2,18471,5021089,7900894,15325,3441250,4634131
2002-04-21,2002,203,D,2,2,18214,5039303,7900894,14601,3455851,4634131
2002-04-22,2002,204,D,2,2,17650,5056953,7900894,14070,3469921,4634131
2002-04-23,2002,205,D,2,2,16697,5073650,7900894,13105,3483026,4634131
2002-04-24,2002,206,D,2,2,15199,5088849,7900894,11526,3494552,4634131
2002-04-25,2002,207,D,2,2,15501,5104350,7900894,11865,3506417,4634131
2002-04-26,2002,208,D,2,2,15549,5119899,7900894,11899,3518316,4634131
2002-04-27,2002,209,D,2,2,15532,5135431,7900894,11910,3530226,4634131
2002-04-28,2002,210,D,2,2,16119,5151550,7900894,12455,3542681,4634131
2002-04-29,2002,211,D,2,2,15996,5167546,7900894,12360,3555041,4634131
2002-04-30,2002,212,D,2,2,16605,5184151,7900894,12995,3568036,4634131
2002-05-01,2002,213,D,2,2,16699,5200850,7900894,13093,3581129,4634131
2002-05-02,2002,214,D,2,2,15885,5216735,7900894,12269,3593398,4634131
2002-05-03,2002,215,D,2,2,16192,5232927,7900894,12531,3605929,4634131
2002-05-04,2002,216,D,2,2,15610,5248537,7900894,11878,3617807,4634131
2002-05-05,2002,217,D,2,2,15038,5263575,7900894,11278,3629085,4634131
2002-05-06,2002,218,D,2,2,14411,5277986,7900894,10729,3639814,4634131
2002-05-07,2002,219,D,2,2,14795,5292781,7900894,11019,3650833,4634131
2002-05-08,2002,220,D,2,2,14551,5307332,7900894,10902,3661735,4634131
2002-05-09,2002,221,D,2,2,14508,5321840,7900894,10805,3672540,4634131
2002-05-10,2002,222,D,2,2,14321,5336161,7900894,10563,3683103,4634131
2002-05-11,2002,223,D,2,2,14235,5350396,7900894,10418,3693521,4634131
2002-05-12,2002,224,D,2,2,14465,5364861,7900894,10593,3704114,4634131
2002-05-13,2002,225,D,2,2,14234,5379095,7900894,10413,3714527,4634131
2002-05-14,2002,226,D,2,2,14454,5393549,7900894,10569,3725096,4634131
2002-05-15,2002,227,D,2,2,14474,5408023,7900894,10580,3735676,4634131
2002-05-16,2002,228,D,2,2,14422,5422445,7900894,10455,3746131,4634131
2002-05-17,2002,229,D,2,2,14621,5437066,7900894,10611,3756742,4634131
2002-05-18,2002,230,D,2,2,15546,5452612,7900894,11533,3768275,4634131
2002-05-19,2002,231,D,2,2,17084,5469696,7900894,13245,3781520,4634131
2002-05-20,2002,232,D,2,2,18425,5488121,7900894,18219,3799739,4634131
2002-05-21,2002,233,D,2,2,22551,5510672,7900894,23282,3823021,4634131
2002-05-22,2002,234,D,2,2,23562,5534234,7900894,24211,3847232,4634131
2002-05-23,2002,235,D,2,2,23443,5557677,7900894,23793,3871025,4634131
2002-05-24,2002,236,D,2,2,22915,5580592,7900894,22939,3893964,4634131
2002-05-25,2002,237,D,2,2,21034,5601626,7900894,17332,3911296,4634131
2002-05-26,2002,238,D,2,2,19595,5621221,7900894,14968,3926264,4634131
2002-05-27,2002,239,D,2,2,18571,5639792,7900894,13909,3940173,4634131
2002-05-28,2002,240,D,2,2,17602,5657394,7900894,13028,3953201,4634131
2002-05-29,2002,241,D,2,2,17298,5674692,7900894,12417,3965618,4634131
2002-05-30,2002,242,D,2,2,16576,5691268,7900894,11609,3977227,4634131
2002-05-31,2002,243,D,2,2,15985,5707253,7900894,10990,3988217,4634131
2002-06-01,2002,244,D,2,2,15529,5722782,7900894,9526,3997743,4634131
2002-06-02,2002,245,D,2,2,16002,5738784,7900894,8742,4006485,4634131
2002-06-03,2002,246,D,2,2,15745,5754529,7900894,7484,4013969,4634131
2002-06-04,2002,247,D,2,2,15580,5770109,7900894,6440,4020409,4634131
2002-06-05,2002,248,D,2,2,15543,5785652,7900894,6725,4027134,4634131
2002-06-06,2002,249,D,2,2,15411,5801063,7900894,6701,4033835,4634131
2002-06-07,2002,250,D,2,2,15096,5816159,7900894,6118,4039953,4634131
2002-06-08,2002,251,D,2,2,14748,5830907,7900894,5598,4045551,4634131
2002-06-09,2002,252,D,2,2,14568,5845475,7900894,6301,4051852,4634131
2002-06-10,2002,253,D,2,2,14082,5859557,7900894,5139,4056991,4634131
2002-06-11,2002,254,D,2,2,13752,5873309,7900894,4867,4061858,4634131
2002-06-12,2002,255,D,2,2,13407,5886716,7900894,5031,4066889,4634131
2002-06-13,2002,256,D,2,2,13986,5900702,7900894,5581,4072470,4634131
2002-06-14,2002,257,D,2,2,15101,5915803,7900894,7406,4079876,4634131
2002-06-15,2002,258,D,2,2,15390,5931193,7900894,7504,4087380,4634131
2002-06-16,2002,259,D,2,2,15838,5947031,7900894,7993,4095373,4634131
2002-06-17,2002,260,D,2,2,16726,5963757,7900894,8709,4104082,4634131
2002-06-18,2002,261,D,2,2,16996,5980753,7900894,8008,4112090,4634131
2002-06-19,2002,262,D,2,2,17035,5997788,7900894,7376,4119466,4634131
2002-06-20,2002,263,D,2,2,17158,6014946,7900894,7386,4126852,4634131
2002-06-21,2002,264,D,2,2,17712,6032658,7900894,7951,4134803,4634131
2002-06-22,2002,265,D,2,2,17887,6050545,7900894,9149,4143952,4634131
2002-06-23,2002,266,D,2,2,17608,6068153,7900894,7420,4151372,4634131
2002-06-24,2002,267,D,2,2,18143,6086296,7900894,9272,4160644,4634131
2002-06-25,2002,268,D,2,2,18508,6104804,7900894,9500,4170144,4634131
2002-06-26,2002,269,D,2,2,18069,6122873,7900894,7275,4177419,4634131
2002-06-27,2002,270,D,2,2,18476,6141349,7900894,7892,4185311,4634131
2002-06-28,2002,271,D,2,2,18890,6160239,7900894,8012,4193323,4634131
2002-06-29,2002,272,D,2,2,19834,6180073,7900894,9141,4202464,4634131
2002-06-30,2002,273,D,2,2,20212,6200285,7900894,9606,4212070,4634131
2002-07-01,2002,274,D,2,2,19720,6220005,7900894,5357,4217427,4634131
2002-07-02,2002,275,D,2,2,19026,6239031,7900894,4403,4221830,4634131
2002-07-03,2002,276,D,2,2,19501,6258532,7900894,4818,4226648,4634131
2002-07-04,2002,277,D,2,2,19505,6278037,7900894,5336,4231984,4634131
2002-07-05,2002,278,D,2,2,19375,6297412,7900894,5165,4237149,4634131
2002-07-06,2002,279,D,2,2,19565,6316977,7900894,5387,4242536,4634131
2002-07-07,2002,280,D,2,2,19901,6336878,7900894,5975,4248511,4634131
2002-07-08,2002,281,D,2,2,20514,6357392,7900894,6389,4254900,4634131
2002-07-09,2002,282,D,2,2,20149,6377541,7900894,5459,4260359,4634131
2002-07-10,2002,283,D,2,2,20209,6397750,7900894,4980,4265339,4634131
2002-07-11,2002,284,D,2,2,20457,6418207,7900894,5162,4270501,4634131
2002-07-12,2002,285,D,2,2,21004,6439211,7900894,5250,4275751,4634131
2002-07-13,2002,286,D,2,2,20994,6460205,7900894,5264,4281015,4634131
2002-07-14,2002,287,D,2,2,21157,6481362,7900894,5398,4286413,4634131
2002-07-15,2002,288,D,2,2,21314,6502676,7900894,5573,4291986,4634131
2002-07-16,2002,289,D,2,2,21480,6524156,7900894,6225,4298211,4634131
2002-07-17,2002,290,D,2,2,21529,6545685,7900894,6075,4304286,4634131
2002-07-18,2002,291,D,2,2,21685,6567370,7900894,6142,4310428,4634131
2002-07-19,2002,292,D,2,2,21651,6589021,7900894,6035,4316463,4634131
2002-07-20,2002,293,D,2,2,20989,6610010,7900894,5404,4321867,4634131
2002-07-21,2002,294,D,2,2,20948,6630958,7900894,4709,4326576,4634131
2002-07-22,2002,295,D,2,2,21837,6652795,7900894,5584,4332160,4634131
2002-07-23,2002,296,D,2,2,22071,6674866,7900894,5867,4338027,4634131
2002-07-24,2002,297,D,2,2,22423,6697289,7900894,6306,4344333,4634131
2002-07-25,2002,298,D,2,2,22679,6719968,7900894,6582,4350915,4634131
2002-07-26,2002,299,D,2,2,22623,6742591,7900894,6533,4357448,4634131
2002-07-27,2002,300,D,2,2,22292,6764883,7900894,6247,4363695,4634131
2002-07-28,2002,301,D,2,2,22208,6787091,7900894,6242,4369937,4634131
2002-07-29,2002,302,D,2,2,22397,6809488,7900894,6452,4376389,4634131
2002-07-30,2002,303,D,2,2,21700,6831188,7900894,6508,4382897,4634131
2002-07-31,2002,304,D,2,2,21262,6852450,7900894,6860,4389757,4634131
2002-08-01,2002,305,D,2,2,21086,6873536,7900894,5228,4394985,4634131
2002-08-02,2002,306,D,2,2,20521,6894057,7900894,4614,4399599,4634131
2002-08-03,2002,307,D,2,2,20015,6914072,7900894,4119,4403718,4634131
2002-08-04,2002,308,D,2,2,20712,6934784,7900894,4876,4408594,4634131
2002-08-05,2002,309,D,2,2,20365,6955149,7900894,4647,4413241,4634131
2002-08-06,2002,310,D,2,2,20627,6975776,7900894,4826,4418067,4634131
2002-08-07,2002,311,D,2,2,20535,6996311,7900894,4828,4422895,4634131
2002-08-08,2002,312,D,2,2,20006,7016317,7900894,4263,4427158,4634131
2002-08-09,2002,313,D,2,2,19699,7036016,7900894,4018,4431176,4634131
2002-08-10,2002,314,D,2,2,19506,7055522,7900894,3823,4434999,4634131
2002-08-11,2002,315,D,2,2,19190,7074712,7900894,3573,4438572,4634131
2002-08-12,2002,316,D,2,2,18936,7093648,7900894,3391,4441963,4634131
2002-08-13,2002,317,D,2,2,18848,7112496,7900894,3855,4445818,4634131
2002-08-14,2002,318,D,2,2,19160,7131656,7900894,4345,4450163,4634131
2002-08-15,2002,319,D,2,2,19058,7150714,7900894,3558,4453721,4634131
2002-08-16,2002,320,D,2,2,19179,7169893,7900894,4046,4457767,4634131
2002-08-17,2002,321,D,2,2,19318,7189211,7900894,3992,4461759,4634131
2002-08-18,2002,322,D,2,2,19204,7208415,7900894,3883,4465642,4634131
2002-08-19,2002,323,D,2,2,18682,7227097,7900894,3514,4469156,4634131
2002-08-20,2002,324,D,2,2,19445,7246542,7900894,4186,4473342,4634131
2002-08-21,2002,325,D,2,2,19590,7266132,7900894,4472,4477814,4634131
2002-08-22,2002,326,D,2,2,19289,7285421,7900894,4062,4481876,4634131
2002-08-23,2002,327,D,2,2,19340,7304761,7900894,4156,4486032,4634131
2002-08-24,2002,328,D,2,2,18500,7323261,7900894,3416,4489448,4634131
2002-08-25,2002,329,D,2,2,17804,7341065,7900894,2758,4492206,4634131
2002-08-26,2002,330,D,2,2,17144,7358209,7900894,2213,4494419,4634131
2002-08-27,2002,331,D,2,2,16033,7374242,7900894,1789,4496208,4634131
2002-08-28,2002,332,D,2,2,15352,7389594,7900894,2387,4498595,4634131
2002-08-29,2002,333,D,2,2,16240,7405834,7900894,3913,4502508,4634131
2002-08-30,2002,334,D,2,2,16660,7422494,7900894,3478,4505986,4634131
2002-08-31,2002,335,D,2,2,16707,7439201,7900894,3077,4509063,4634131
2002-09-01,2002,336,D,2,2,16716,7455917,7900894,3143,4512206,4634131
2002-09-02,2002,337,D,2,2,16069,7471986,7900894,2654,4514860,4634131
2002-09-03,2002,338,D,2,2,15327,7487313,7900894,2915,4517775,4634131
2002-09-04,2002,339,D,2,2,15173,7502486,7900894,3454,4521229,4634131
2002-09-05,2002,340,D,2,2,15314,7517800,7900894,3893,4525122,4634131
2002-09-06,2002,341,D,2,2,15372,7533172,7900894,4217,4529339,4634131
2002-09-07,2002,342,D,2,2,15494,7548666,7900894,4101,4533440,4634131
2002-09-08,2002,343,D,2,2,15396,7564062,7900894,4051,4537491,4634131
2002-09-09,2002,344,D,2,2,15753,7579815,7900894,3685,4541176,4634131
2002-09-10,2002,345,D,2,2,15621,7595436,7900894,3651,4544827,4634131
2002-09-11,2002,346,D,2,2,15801,7611237,7900894,3075,4547902,4634131
2002-09-12,2002,347,D,2,2,16248,7627485,7900894,3481,4551383,4634131
2002-09-13,2002,348,D,2,2,16460,7643945,7900894,3701,4555084,4634131
2002-09-14,2002,349,D,2,2,16259,7660204,7900894,3982,4559066,4634131
2002-09-15,2002,350,D,2,2,15703,7675907,7900894,3167,4562233,4634131
2002-09-16,2002,351,D,2,2,15965,7691872,7900894,4127,4566360,4634131
2002-09-17,2002,352,D,2,2,15476,7707348,7900894,3919,4570279,4634131
2002-09-18,2002,353,D,2,2,15783,7723131,7900894,4187,4574466,4634131
2002-09-19,2002,354,D,2,2,15647,7738778,7900894,3715,4578181,4634131
2002-09-20,2002,355,D,2,2,15512,7754290,7900894,4580,4582761,4634131
2002-09-21,2002,356,D,2,2,15276,7769566,7900894,5403,4588164,4634131
2002-09-22,2002,357,D,2,2,15111,7784677,7900894,5260,4593424,4634131
2002-09-23,2002,358,D,2,2,15132,7799809,7900894,5362,4598786,4634131
2002-09-24,2002,359,D,2,2,14893,7814702,7900894,5077,4603863,4634131
2002-09-25,2002,360,D,2,2,14582,7829284,7900894,4742,4608605,4634131
2002-09-26,2002,361,D,2,2,13800,7843084,7900894,4332,4612937,4634131
2002-09-27,2002,362,D,2,2,14455,7857539,7900894,5082,4618019,4634131
2002-09-28,2002,363,D,2,2,14498,7872037,7900894,5025,4623044,4634131
2002-09-29,2002,364,D,2,2,14168,7886205,7900894,5534,4628578,4634131
2002-09-30,2002,365,D,2,2,14689,7900894,7900894,5553,4634131,4634131
2002-10-01,2003,1,N,1,1,14220,14220,10751690,5105,5105,7094948
2002-10-02,2003,2,N,1,1,13774,27994,10751690,4716,9821,7094948
2002-10-03,2003,3,N,1,1,13161,41155,10751690,4670,14491,7094948
2002-10-04,2003,4,N,1,1,12822,53977,10751690,4373,18864,7094948
2002-10-05,2003,5,N,1,1,12635,66612,10751690,4898,23762,7094948
2002-10-06,2003,6,N,1,1,12165,78777,10751690,4441,28203,7094948
2002-10-07,2003,7,N,1,1,11840,90617,10751690,4528,32731,7094948
2002-10-08,2003,8,N,1,1,11340,101957,10751690,4000,36731,7094948
2002-10-09,2003,9,N,1,1,11034,112991,10751690,3512,40243,7094948
2002-10-10,2003,10,N,1,1,10884,123875,10751690,3519,43762,7094948
2002-10-11,2003,11,N,1,1,11995,135870,10751690,4753,48515,7094948
2002-10-12,2003,12,N,1,1,11757,147627,10751690,4427,52942,7094948
2002-10-13,2003,13,N,1,1,11791,159418,10751690,4507,57449,7094948
2002-10-14,2003,14,N,1,1,11604,171022,10751690,4333,61782,7094948
2002-10-15,2003,15,N,1,1,11289,182311,10751690,3997,65779,7094948
2002-10-16,2003,16,N,1,1,11365,193676,10751690,4201,69980,7094948
2002-10-17,2003,17,N,1,1,11195,204871,10751690,4037,74017,7094948
2002-10-18,2003,18,N,1,1,11383,216254,10751690,4118,78135,7094948
2002-10-19,2003,19,N,1,1,11439,227693,10751690,4249,82384,7094948
2002-10-20,2003,20,N,1,1,11429,239122,10751690,4255,86639,7094948
2002-10-21,2003,21,N,1,1,11548,250670,10751690,3822,90461,7094948
2002-10-22,2003,22,N,1,1,11344,262014,10751690,3341,93802,7094948
2002-10-23,2003,23,N,1,1,12038,274052,10751690,3674,97476,7094948
2002-10-24,2003,24,N,1,1,11886,285938,10751690,3786,101262,7094948
2002-10-25,2003,25,N,1,1,11860,297798,10751690,3931,105193,7094948
2002-10-26,2003,26,N,1,1,11998,309796,10751690,4026,109219,7094948
2002-10-27,2003,27,N,1,1,12533,322329,10751690,3979,113198,7094948
2002-10-28,2003,28,N,1,1,12405,334734,10751690,3329,116527,7094948
2002-10-29,2003,29,N,1,1,12552,347286,10751690,4053,120580,7094948
2002-10-30,2003,30,N,1,1,12889,360175,10751690,4882,125462,7094948
2002-10-31,2003,31,N,1,1,12764,372939,10751690,4839,130301,7094948
2002-11-01,2003,32,N,1,1,12386,385325,10751690,4494,134795,7094948
2002-11-02,2003,33,N,1,1,12286,397611,10751690,4618,139413,7094948
2002-11-03,2003,34,N,1,1,12073,409684,10751690,4004,143417,7094948
2002-11-04,2003,35,N,1,1,12528,422212,10751690,5120,148537,7094948
2002-11-05,2003,36,N,1,1,12683,434895,10751690,5749,154286,7094948
2002-11-06,2003,37,N,1,1,13131,448026,10751690,7406,161692,7094948
2002-11-07,2003,38,N,1,1,13240,461266,10751690,11168,172860,7094948
2002-11-08,2003,39,N,1,1,16015,477281,10751690,22478,195338,7094948
2002-11-09,2003,40,N,1,1,17836,495117,10751690,26017,221355,7094948
2002-11-10,2003,41,N,1,1,17792,512909,10751690,26539,247894,7094948
2002-11-11,2003,42,N,1,1,17822,530731,10751690,22974,270868,7094948
2002-11-12,2003,43,N,1,1,17347,548078,10751690,14794,285662,7094948
2002-11-13,2003,44,N,1,1,16986,565064,10751690,6426,292088,7094948
2002-11-14,2003,45,N,1,1,16413,581477,10751690,5094,297182,7094948
2002-11-15,2003,46,N,1,1,15676,597153,10751690,3864,301046,7094948
2002-11-16,2003,47,N,1,1,14915,612068,10751690,3108,304154,7094948
2002-11-17,2003,48,N,1,1,14237,626305,10751690,2646,306800,7094948
2002-11-18,2003,49,N,1,1,13795,640100,10751690,2794,309594,7094948
2002-11-19,2003,50,N,1,1,13361,653461,10751690,3513,313107,7094948
2002-11-20,2003,51,N,1,1,12869,666330,10751690,1903,315010,7094948
2002-11-21,2003,52,N,1,1,12613,678943,10751690,2774,317784,7094948
2002-11-22,2003,53,N,1,1,11872,690815,10751690,2729,320513,7094948
2002-11-23,2003,54,N,1,1,12441,703256,10751690,4302,324815,7094948
2002-11-24,2003,55,N,1,1,12405,715661,10751690,3813,328628,7094948
2002-11-25,2003,56,N,1,1,12185,727846,10751690,3511,332139,7094948
2002-11-26,2003,57,N,1,1,11941,739787,10751690,3435,335574,7094948
2002-11-27,2003,58,N,1,1,12141,751928,10751690,3839,339413,7094948
2002-11-28,2003,59,N,1,1,12192,764120,10751690,3836,343249,7094948
2002-11-29,2003,60,N,1,1,11993,776113,10751690,3712,346961,7094948
2002-11-30,2003,61,N,1,1,11699,787812,10751690,3333,350294,7094948
2002-12-01,2003,62,N,1,1,11725,799537,10751690,3812,354106,7094948
2002-12-02,2003,63,N,1,1,11780,811317,10751690,3361,357467,7094948
2002-12-03,2003,64,N,1,1,11970,823287,10751690,3539,361006,7094948
2002-12-04,2003,65,N,1,1,12063,835350,10751690,3582,364588,7094948
2002-12-05,2003,66,N,1,1,12260,847610,10751690,4348,368936,7094948
2002-12-06,2003,67,N,1,1,12475,860085,10751690,4822,373758,7094948
2002-12-07,2003,68,N,1,1,12781,872866,10751690,5591,379349,7094948
2002-12-08,2003,69,N,1,1,13074,885940,10751690,6047,385396,7094948
2002-12-09,2003,70,N,1,1,13099,899039,10751690,6113,391509,7094948
2002-12-10,2003,71,N,1,1,13809,912848,10751690,7213,398722,7094948
2002-12-11,2003,72,N,1,1,13946,926794,10751690,7418,406140,7094948
2002-12-12,2003,73,N,1,1,14050,940844,10751690,7533,413673,7094948
2002-12-13,2003,74,N,1,1,13981,954825,10751690,10609,424282,7094948
2002-12-14,2003,75,N,1,1,16551,971376,10751690,14945,439227,7094948
2002-12-15,2003,76,N,1,1,22032,993408,10751690,19613,458840,7094948
2002-12-16,2003,77,N,1,1,39704,1033112,10751690,45794,504634,7094948
2002-12-17,2003,78,N,1,1,58048,1091160,10751690,66313,570947,7094948
2002-12-18,2003,79,N,1,1,57824,1148984,10751690,57254,628201,7094948
2002-12-19,2003,80,N,1,1,61482,1210466,10751690,60942,689143,7094948
2002-12-20,2003,81,N,1,1,61063,1271529,10751690,62471,751614,7094948
2002-12-21,2003,82,N,1,1,58525,1330054,10751690,51527,803141,7094948
2002-12-22,2003,83,N,1,1,59053,1389107,10751690,51793,854934,7094948
2002-12-23,2003,84,N,1,1,60332,1449439,10751690,53052,907986,7094948
2002-12-24,2003,85,N,1,1,59245,1508684,10751690,48620,956606,7094948
2002-12-25,2003,86,N,1,1,52843,1561527,10751690,40042,996648,7094948
2002-12-26,2003,87,N,1,1,44481,1606008,10751690,31111,1027759,7094948
2002-12-27,2003,88,N,1,1,38921,1644929,10751690,30389,1058148,7094948
2002-12-28,2003,89,N,1,1,38272,1683201,10751690,32058,1090206,7094948
2002-12-29,2003,90,N,1,1,47968,1731169,10751690,42717,1132923,7094948
2002-12-30,2003,91,N,1,1,57200,1788369,10751690,52258,1185181,7094948
2002-12-31,2003,92,N,1,1,65802,1854171,10751690,60573,1245754,7094948
2003-01-01,2003,93,N,1,1,77286,1931457,10751690,71565,1317319,7094948
2003-01-02,2003,94,N,1,1,85046,2016503,10751690,77549,1394868,7094948
2003-01-03,2003,95,N,1,1,93766,2110269,10751690,82979,1477847,7094948
2003-01-04,2003,96,N,1,1,86128,2196397,10751690,75284,1553131,7094948
2003-01-05,2003,97,N,1,1,73059,2269456,10751690,59918,1613049,7094948
2003-01-06,2003,98,N,1,1,65344,2334800,10751690,52272,1665321,7094948
2003-01-07,2003,99,N,1,1,58439,2393239,10751690,45364,1710685,7094948
2003-01-08,2003,100,N,1,1,51526,2444765,10751690,38286,1748971,7094948
2003-01-09,2003,101,N,1,1,45465,2490230,10751690,34260,1783231,7094948
2003-01-10,2003,102,N,1,1,41617,2531847,10751690,30615,1813846,7094948
2003-01-11,2003,103,N,1,1,40557,2572404,10751690,30302,1844148,7094948
2003-01-12,2003,104,N,1,1,42904,2615308,10751690,32136,1876284,7094948
2003-01-13,2003,105,N,1,1,47150,2662458,10751690,36275,1912559,7094948
2003-01-14,2003,106,N,1,1,50917,2713375,10751690,38524,1951083,7094948
2003-01-15,2003,107,N,1,1,58633,2772008,10751690,50563,2001646,7094948
2003-01-16,2003,108,N,1,1,68128,2840136,10751690,60135,2061781,7094948
2003-01-17,2003,109,N,1,1,84192,2924328,10751690,76197,2137978,7094948
2003-01-18,2003,110,N,1,1,84911,3009239,10751690,76980,2214958,7094948
2003-01-19,2003,111,N,1,1,73658,3082897,10751690,65725,2280683,7094948
2003-01-20,2003,112,N,1,1,67026,3149923,10751690,59364,2340047,7094948
2003-01-21,2003,113,N,1,1,61859,3211782,10751690,49550,2389597,7094948
2003-01-22,2003,114,N,1,1,57157,3268939,10751690,45106,2434703,7094948
2003-01-23,2003,115,N,1,1,54108,3323047,10751690,42237,2476940,7094948
2003-01-24,2003,116,N,1,1,54836,3377883,10751690,43029,2519969,7094948
2003-01-25,2003,117,N,1,1,56669,3434552,10751690,46852,2566821,7094948
2003-01-26,2003,118,N,1,1,58088,3492640,10751690,48049,2614870,7094948
2003-01-27,2003,119,N,1,1,58789,3551429,10751690,48570,2663440,7094948
2003-01-28,2003,120,N,1,1,58422,3609851,10751690,48214,2711654,7094948
2003-01-29,2003,121,N,1,1,57640,3667491,10751690,44803,2756457,7094948
2003-01-30,2003,122,N,1,1,55906,3723397,10751690,43077,2799534,7094948
2003-01-31,2003,123,N,1,1,53676,3777073,10751690,40889,2840423,7094948
2003-02-01,2003,124,N,1,1,50605,3827678,10751690,37826,2878249,7094948
2003-02-02,2003,125,N,1,1,48016,3875694,10751690,35229,2913478,7094948
2003-02-03,2003,126,N,1,1,45640,3921334,10751690,32859,2946337,7094948
2003-02-04,2003,127,N,1,1,43251,3964585,10751690,30718,2977055,7094948
2003-02-05,2003,128,N,1,1,40655,4005240,10751690,28259,3005314,7094948
2003-02-06,2003,129,N,1,1,37968,4043208,10751690,25343,3030657,7094948
2003-02-07,2003,130,N,1,1,35149,4078357,10751690,22842,3053499,7094948
2003-02-08,2003,131,N,1,1,32345,4110702,10751690,19599,3073098,7094948
2003-02-09,2003,132,N,1,1,29528,4140230,10751690,17059,3090157,7094948
2003-02-10,2003,133,N,1,1,28420,4168650,10751690,15886,3106043,7094948
2003-02-11,2003,134,N,1,1,28023,4196673,10751690,15279,3121322,7094948
2003-02-12,2003,135,N,1,1,29240,4225913,10751690,19338,3140660,7094948
2003-02-13,2003,136,N,1,1,33509,4259422,10751690,23538,3164198,7094948
2003-02-14,2003,137,N,1,1,37704,4297126,10751690,35007,3199205,7094948
2003-02-15,2003,138,N,1,1,40294,4337420,10751690,37818,3237023,7094948
2003-02-16,2003,139,N,1,1,42485,4379905,10751690,35381,3272404,7094948
2003-02-17,2003,140,N,1,1,46335,4426240,10751690,36319,3308723,7094948
2003-02-18,2003,141,N,1,1,50948,4477188,10751690,40949,3349672,7094948
2003-02-19,2003,142,N,1,1,50828,4528016,10751690,41236,3390908,7094948
2003-02-20,2003,143,N,1,1,48852,4576868,10751690,39413,3430321,7094948
2003-02-21,2003,144,N,1,1,47460,4624328,10751690,35241,3465562,7094948
2003-02-22,2003,145,N,1,1,45849,4670177,10751690,33685,3499247,7094948
2003-02-23,2003,146,N,1,1,44227,4714404,10751690,31871,3531118,7094948
2003-02-24,2003,147,N,1,1,42740,4757144,10751690,29910,3561028,7094948
2003-02-25,2003,148,N,1,1,41111,4798255,10751690,28490,3589518,7094948
2003-02-26,2003,149,N,1,1,38998,4837253,10751690,29666,3619184,7094948
2003-02-27,2003,150,N,1,1,36614,4873867,10751690,28526,3647710,7094948
2003-02-28,2003,151,N,1,1,32588,4906455,10751690,22153,3669863,7094948
2003-03-01,2003,152,N,1,1,29962,4936417,10751690,17568,3687431,7094948
2003-03-02,2003,153,N,1,1,27778,4964195,10751690,15383,3702814,7094948
2003-03-03,2003,154,N,1,1,25729,4989924,10751690,13095,3715909,7094948
2003-03-04,2003,155,N,1,1,24342,5014266,10751690,11494,3727403,7094948
2003-03-05,2003,156,N,1,1,23266,5037532,10751690,10274,3737677,7094948
2003-03-06,2003,157,N,1,1,22077,5059609,10751690,9369,3747046,7094948
2003-03-07,2003,158,N,1,1,21637,5081246,10751690,8689,3755735,7094948
2003-03-08,2003,159,N,1,1,21303,5102549,10751690,9715,3765450,7094948
2003-03-09,2003,160,N,1,1,20724,5123273,10751690,10133,3775583,7094948
2003-03-10,2003,161,N,1,1,20061,5143334,10751690,9207,3784790,7094948
2003-03-11,2003,162,N,1,1,19377,5162711,10751690,9292,3794082,7094948
2003-03-12,2003,163,N,1,1,18984,5181695,10751690,6876,3800958,7094948
2003-03-13,2003,164,N,1,1,18374,5200069,10751690,6503,3807461,7094948
2003-03-14,2003,165,N,1,1,18562,5218631,10751690,7701,3815162,7094948
2003-03-15,2003,166,N,1,1,21376,5240007,10751690,15906,3831068,7094948
2003-03-16,2003,167,N,1,1,31331,5271338,10751690,26944,3858012,7094948
2003-03-17,2003,168,N,1,1,44819,5316157,10751690,38631,3896643,7094948
2003-03-18,2003,169,N,1,1,47082,5363239,10751690,41082,3937725,7094948
2003-03-19,2003,170,N,1,1,42131,5405370,10751690,35426,3973151,7094948
2003-03-20,2003,171,N,1,1,36674,5442044,10751690,25010,3998161,7094948
2003-03-21,2003,172,N,1,1,32453,5474497,10751690,20425,4018586,7094948
2003-03-22,2003,173,N,1,1,29288,5503785,10751690,18469,4037055,7094948
2003-03-23,2003,174,N,1,1,27899,5531684,10751690,16959,4054014,7094948
2003-03-24,2003,175,N,1,1,26494,5558178,10751690,14998,4069012,7094948
2003-03-25,2003,176,N,1,1,26256,5584434,10751690,15055,4084067,7094948
2003-03-26,2003,177,N,1,1,25611,5610045,10751690,13860,4097927,7094948
2003-03-27,2003,178,N,1,1,24798,5634843,10751690,13154,4111081,7094948
2003-03-28,2003,179,N,1,1,25251,5660094,10751690,12548,4123629,7094948
2003-03-29,2003,180,N,1,1,25556,5685650,10751690,13012,4136641,7094948
2003-03-30,2003,181,N,1,1,24109,5709759,10751690,11578,4148219,7094948
2003-03-31,2003,182,N,1,1,22542,5732301,10751690,10812,4159031,7094948
2003-04-01,2003,183,N,1,1,21135,5753436,10751690,9979,4169010,7094948
2003-04-02,2003,184,N,1,1,20882,5774318,10751690,10875,4179885,7094948
2003-04-03,2003,185,N,1,1,20684,5795002,10751690,11587,4191472,7094948
2003-04-04,2003,186,N,1,1,21061,5816063,10751690,12602,4204074,7094948
2003-04-05,2003,187,N,1,1,21342,5837405,10751690,12946,4217020,7094948
2003-04-06,2003,188,N,1,1,20709,5858114,10751690,13015,4230035,7094948
2003-04-07,2003,189,N,1,1,20695,5878809,10751690,12201,4242236,7094948
2003-04-08,2003,190,N,1,1,19513,5898322,10751690,10649,4252885,7094948
2003-04-09,2003,191,N,1,1,18652,5916974,10751690,9298,4262183,7094948
2003-04-10,2003,192,N,1,1,18014,5934988,10751690,7865,4270048,7094948
2003-04-11,2003,193,N,1,1,18075,5953063,10751690,8581,4278629,7094948
2003-04-12,2003,194,N,1,1,17520,5970583,10751690,11635,4290264,7094948
2003-04-13,2003,195,N,1,1,21680,5992263,10751690,16452,4306716,7094948
2003-04-14,2003,196,N,1,1,25010,6017273,10751690,19458,4326174,7094948
2003-04-15,2003,197,N,1,1,31827,6049100,10751690,31434,4357608,7094948
2003-04-16,2003,198,N,1,1,33913,6083013,10751690,34282,4391890,7094948
2003-04-17,2003,199,N,1,1,31341,6114354,10751690,28961,4420851,7094948
2003-04-18,2003,200,N,1,1,29295,6143649,10751690,25551,4446402,7094948
2003-04-19,2003,201,N,1,1,26791,6170440,10751690,23049,4469451,7094948
2003-04-20,2003,202,N,1,1,25531,6195971,10751690,21915,4491366,7094948
2003-04-21,2003,203,N,1,1,23688,6219659,10751690,20642,4512008,7094948
2003-04-22,2003,204,N,1,1,23762,6243421,10751690,21030,4533038,7094948
2003-04-23,2003,205,N,1,1,22921,6266342,10751690,20217,4553255,7094948
2003-04-24,2003,206,N,1,1,22892,6289234,10751690,21056,4574311,7094948
2003-04-25,2003,207,N,1,1,26678,6315912,10751690,24836,4599147,7094948
2003-04-26,2003,208,N,1,1,35651,6351563,10751690,33061,4632208,7094948
2003-04-27,2003,209,N,1,1,43109,6394672,10751690,41227,4673435,7094948
2003-04-28,2003,210,N,1,1,46189,6440861,10751690,47749,4721184,7094948
2003-04-29,2003,211,N,1,1,47773,6488634,10751690,48414,4769598,7094948
2003-04-30,2003,212,N,1,1,50382,6539016,10751690,51049,4820647,7094948
2003-05-01,2003,213,N,1,1,51967,6590983,10751690,52596,4873243,7094948
2003-05-02,2003,214,N,1,1,54118,6645101,10751690,55405,4928648,7094948
2003-05-03,2003,215,N,1,1,58393,6703494,10751690,56410,4985058,7094948
2003-05-04,2003,216,N,1,1,63783,6767277,10751690,61782,5046840,7094948
2003-05-05,2003,217,N,1,1,67163,6834440,10751690,65139,5111979,7094948
2003-05-06,2003,218,N,1,1,69236,6903676,10751690,67246,5179225,7094948
2003-05-07,2003,219,N,1,1,71373,6975049,10751690,67665,5246890,7094948
2003-05-08,2003,220,N,1,1,71627,7046676,10751690,67682,5314572,7094948
2003-05-09,2003,221,N,1,1,69825,7116501,10751690,65813,5380385,7094948
2003-05-10,2003,222,N,1,1,66263,7182764,10751690,62253,5442638,7094948
2003-05-11,2003,223,N,1,1,62264,7245028,10751690,58217,5500855,7094948
2003-05-12,2003,224,N,1,1,57624,7302652,10751690,53632,5554487,7094948
2003-05-13,2003,225,N,1,1,51419,7354071,10751690,48137,5602624,7094948
2003-05-14,2003,226,N,1,1,45480,7399551,10751690,41325,5643949,7094948
2003-05-15,2003,227,N,1,1,41006,7440557,10751690,36878,5680827,7094948
2003-05-16,2003,228,N,1,1,39461,7480018,10751690,35255,5716082,7094948
2003-05-17,2003,229,N,1,1,38496,7518514,10751690,34168,5750250,7094948
2003-05-18,2003,230,N,1,1,37821,7556335,10751690,33487,5783737,7094948
2003-05-19,2003,231,N,1,1,37024,7593359,10751690,32154,5815891,7094948
2003-05-20,2003,232,N,1,1,35957,7629316,10751690,30836,5846727,7094948
2003-05-21,2003,233,N,1,1,34544,7663860,10751690,29395,5876122,7094948
2003-05-22,2003,234,N,1,1,33050,7696910,10751690,27840,5903962,7094948
2003-05-23,2003,235,N,1,1,32063,7728973,10751690,26885,5930847,7094948
2003-05-24,2003,236,N,1,1,30780,7759753,10751690,25630,5956477,7094948
2003-05-25,2003,237,N,1,1,31401,7791154,10751690,26167,5982644,7094948
2003-05-26,2003,238,N,1,1,31799,7822953,10751690,26437,6009081,7094948
2003-05-27,2003,239,N,1,1,30872,7853825,10751690,25624,6034705,7094948
2003-05-28,2003,240,N,1,1,30468,7884293,10751690,23713,6058418,7094948
2003-05-29,2003,241,N,1,1,31267,7915560,10751690,21838,6080256,7094948
2003-05-30,2003,242,N,1,1,32846,7948406,10751690,21657,6101913,7094948
2003-05-31,2003,243,N,1,1,33034,7981440,10751690,18804,6120717,7094948
2003-06-01,2003,244,N,1,1,33012,8014452,10751690,18740,6139457,7094948
2003-06-02,2003,245,N,1,1,32660,8047112,10751690,18353,6157810,7094948
2003-06-03,2003,246,N,1,1,32544,8079656,10751690,18153,6175963,7094948
2003-06-04,2003,247,N,1,1,31655,8111311,10751690,17119,6193082,7094948
2003-06-05,2003,248,N,1,1,31724,8143035,10751690,17127,6210209,7094948
2003-06-06,2003,249,N,1,1,31246,8174281,10751690,16609,6226818,7094948
2003-06-07,2003,250,N,1,1,30253,8204534,10751690,15840,6242658,7094948
2003-06-08,2003,251,N,1,1,29405,8233939,10751690,15332,6257990,7094948
2003-06-09,2003,252,N,1,1,29352,8263291,10751690,14588,6272578,7094948
2003-06-10,2003,253,N,1,1,29372,8292663,10751690,14556,6287134,7094948
2003-06-11,2003,254,N,1,1,28701,8321364,10751690,14305,6301439,7094948
2003-06-12,2003,255,N,1,1,27838,8349202,10751690,13254,6314693,7094948
2003-06-13,2003,256,N,1,1,27451,8376653,10751690,12895,6327588,7094948
2003-06-14,2003,257,N,1,1,26988,8403641,10751690,12931,6340519,7094948
2003-06-15,2003,258,N,1,1,26289,8429930,10751690,12178,6352697,7094948
2003-06-16,2003,259,N,1,1,26050,8455980,10751690,11019,6363716,7094948
2003-06-17,2003,260,N,1,1,25561,8481541,10751690,10479,6374195,7094948
2003-06-18,2003,261,N,1,1,24747,8506288,10751690,9646,6383841,7094948
2003-06-19,2003,262,N,1,1,24077,8530365,10751690,9837,6393678,7094948
2003-06-20,2003,263,N,1,1,23443,8553808,10751690,8290,6401968,7094948
2003-06-21,2003,264,N,1,1,23028,8576836,10751690,7944,6409912,7094948
2003-06-22,2003,265,N,1,1,22354,8599190,10751690,6921,6416833,7094948
2003-06-23,2003,266,N,1,1,21177,8620367,10751690,5785,6422618,7094948
2003-06-24,2003,267,N,1,1,20646,8641013,10751690,6193,6428811,7094948
2003-06-25,2003,268,N,1,1,20119,8661132,10751690,7295,6436106,7094948
2003-06-26,2003,269,N,1,1,18918,8680050,10751690,6525,6442631,7094948
2003-06-27,2003,270,N,1,1,19177,8699227,10751690,6724,6449355,7094948
2003-06-28,2003,271,N,1,1,21364,8720591,10751690,8895,6458250,7094948
2003-06-29,2003,272,N,1,1,22607,8743198,10751690,9114,6467364,7094948
2003-06-30,2003,273,N,1,1,23054,8766252,10751690,7413,6474777,7094948
2003-07-01,2003,274,N,1,1,23518,8789770,10751690,7868,6482645,7094948
2003-07-02,2003,275,N,1,1,23156,8812926,10751690,7549,6490194,7094948
2003-07-03,2003,276,N,1,1,22825,8835751,10751690,7170,6497364,7094948
2003-07-04,2003,277,N,1,1,23115,8858866,10751690,7431,6504795,7094948
2003-07-05,2003,278,N,1,1,22962,8881828,10751690,7187,6511982,7094948
2003-07-06,2003,279,N,1,1,23066,8904894,10751690,7282,6519264,7094948
2003-07-07,2003,280,N,1,1,23167,8928061,10751690,7497,6526761,7094948
2003-07-08,2003,281,N,1,1,23768,8951829,10751690,7588,6534349,7094948
2003-07-09,2003,282,N,1,1,24094,8975923,10751690,7977,6542326,7094948
2003-07-10,2003,283,N,1,1,24168,9000091,10751690,8052,6550378,7094948
2003-07-11,2003,284,N,1,1,24437,9024528,10751690,8308,6558686,7094948
2003-07-12,2003,285,N,1,1,24698,9049226,10751690,8580,6567266,7094948
2003-07-13,2003,286,N,1,1,25325,9074551,10751690,9141,6576407,7094948
2003-07-14,2003,287,N,1,1,25900,9100451,10751690,9689,6586096,7094948
2003-07-15,2003,288,N,1,1,25915,9126366,10751690,9709,6595805,7094948
2003-07-16,2003,289,N,1,1,26284,9152650,10751690,10204,6606009,7094948
2003-07-17,2003,290,N,1,1,26081,9178731,10751690,10432,6616441,7094948
2003-07-18,2003,291,N,1,1,25486,9204217,10751690,9935,6626376,7094948
2003-07-19,2003,292,N,1,1,25249,9229466,10751690,9546,6635922,7094948
2003-07-20,2003,293,N,1,1,25627,9255093,10751690,9948,6645870,7094948
2003-07-21,2003,294,N,1,1,25695,9280788,10751690,10072,6655942,7094948
2003-07-22,2003,295,N,1,1,25502,9306290,10751690,9956,6665898,7094948
2003-07-23,2003,296,N,1,1,25822,9332112,10751690,10076,6675974,7094948
2003-07-24,2003,297,N,1,1,25983,9358095,10751690,10251,6686225,7094948
2003-07-25,2003,298,N,1,1,25777,9383872,10751690,10096,6696321,7094948
2003-07-26,2003,299,N,1,1,26522,9410394,10751690,11410,6707731,7094948
2003-07-27,2003,300,N,1,1,27027,9437421,10751690,12184,6719915,7094948
2003-07-28,2003,301,N,1,1,27430,9464851,10751690,13341,6733256,7094948
2003-07-29,2003,302,N,1,1,27984,9492835,10751690,13943,6747199,7094948
2003-07-30,2003,303,N,1,1,28115,9520950,10751690,14129,6761328,7094948
2003-07-31,2003,304,N,1,1,28168,9549118,10751690,14247,6775575,7094948
2003-08-01,2003,305,N,1,1,27662,9576780,10751690,12431,6788006,7094948
2003-08-02,2003,306,N,1,1,27439,9604219,10751690,12050,6800056,7094948
2003-08-03,2003,307,N,1,1,27671,9631890,10751690,12924,6812980,7094948
2003-08-04,2003,308,N,1,1,28155,9660045,10751690,12793,6825773,7094948
2003-08-05,2003,309,N,1,1,28410,9688455,10751690,13124,6838897,7094948
2003-08-06,2003,310,N,1,1,28018,9716473,10751690,12331,6851228,7094948
2003-08-07,2003,311,N,1,1,27316,9743789,10751690,11617,6862845,7094948
2003-08-08,2003,312,N,1,1,25901,9769690,10751690,10162,6873007,7094948
2003-08-09,2003,313,N,1,1,24298,9793988,10751690,8726,6881733,7094948
2003-08-10,2003,314,N,1,1,22904,9816892,10751690,7215,6888948,7094948
2003-08-11,2003,315,N,1,1,21804,9838696,10751690,6138,6895086,7094948
2003-08-12,2003,316,N,1,1,20397,9859093,10751690,4756,6899842,7094948
2003-08-13,2003,317,N,1,1,19763,9878856,10751690,4279,6904121,7094948
2003-08-14,2003,318,N,1,1,19454,9898310,10751690,3973,6908094,7094948
2003-08-15,2003,319,N,1,1,19382,9917692,10751690,3930,6912024,7094948
2003-08-16,2003,320,N,1,1,19327,9937019,10751690,3931,6915955,7094948
2003-08-17,2003,321,N,1,1,19214,9956233,10751690,3823,6919778,7094948
2003-08-18,2003,322,N,1,1,19269,9975502,10751690,3752,6923530,7094948
2003-08-19,2003,323,N,1,1,18669,9994171,10751690,3195,6926725,7094948
2003-08-20,2003,324,N,1,1,18716,10012887,10751690,3256,6929981,7094948
2003-08-21,2003,325,N,1,1,18862,10031749,10751690,3421,6933402,7094948
2003-08-22,2003,326,N,1,1,20336,10052085,10751690,6832,6940234,7094948
2003-08-23,2003,327,N,1,1,20861,10072946,10751690,7340,6947574,7094948
2003-08-24,2003,328,N,1,1,20888,10093834,10751690,7428,6955002,7094948
2003-08-25,2003,329,N,1,1,20721,10114555,10751690,7363,6962365,7094948
2003-08-26,2003,330,N,1,1,20282,10134837,10751690,7322,6969687,7094948
2003-08-27,2003,331,N,1,1,19568,10154405,10751690,4412,6974099,7094948
2003-08-28,2003,332,N,1,1,19378,10173783,10751690,4282,6978381,7094948
2003-08-29,2003,333,N,1,1,19325,10193108,10751690,4329,6982710,7094948
2003-08-30,2003,334,N,1,1,18713,10211821,10751690,3684,6986394,7094948
2003-08-31,2003,335,N,1,1,18621,10230442,10751690,3956,6990350,7094948
2003-09-01,2003,336,N,1,1,18522,10248964,10751690,3712,6994062,7094948
2003-09-02,2003,337,N,1,1,18537,10267501,10751690,3555,6997617,7094948
2003-09-03,2003,338,N,1,1,18560,10286061,10751690,3585,7001202,7094948
2003-09-04,2003,339,N,1,1,19021,10305082,10751690,4168,7005370,7094948
2003-09-05,2003,340,N,1,1,19371,10324453,10751690,4646,7010016,7094948
2003-09-06,2003,341,N,1,1,19046,10343499,10751690,4384,7014400,7094948
2003-09-07,2003,342,N,1,1,18837,10362336,10751690,4224,7018624,7094948
2003-09-08,2003,343,N,1,1,18672,10381008,10751690,4808,7023432,7094948
2003-09-09,2003,344,N,1,1,18333,10399341,10751690,4030,7027462,7094948
2003-09-10,2003,345,N,1,1,18718,10418059,10751690,4303,7031765,7094948
2003-09-11,2003,346,N,1,1,18988,10437047,10751690,4602,7036367,7094948
2003-09-12,2003,347,N,1,1,18785,10455832,10751690,4324,7040691,7094948
2003-09-13,2003,348,N,1,1,18327,10474159,10751690,3870,7044561,7094948
2003-09-14,2003,349,N,1,1,17829,10491988,10751690,3496,7048057,7094948
2003-09-15,2003,350,N,1,1,17484,10509472,10751690,4152,7052209,7094948
2003-09-16,2003,351,N,1,1,17941,10527413,10751690,5198,7057407,7094948
2003-09-17,2003,352,N,1,1,18296,10545709,10751690,4909,7062316,7094948
2003-09-18,2003,353,N,1,1,18328,10564037,10751690,4070,7066386,7094948
2003-09-19,2003,354,N,1,1,17645,10581682,10751690,3461,7069847,7094948
2003-09-20,2003,355,N,1,1,17088,10598770,10751690,2935,7072782,7094948
2003-09-21,2003,356,N,1,1,16624,10615394,10751690,2583,7075365,7094948
2003-09-22,2003,357,N,1,1,16184,10631578,10751690,2311,7077676,7094948
2003-09-23,2003,358,N,1,1,15340,10646918,10751690,1223,7078899,7094948
2003-09-24,2003,359,N,1,1,15298,10662216,10751690,2054,7080953,7094948
2003-09-25,2003,360,N,1,1,15392,10677608,10751690,2701,7083654,7094948
2003-09-26,2003,361,N,1,1,15103,10692711,10751690,2322,7085976,7094948
2003-09-27,2003,362,N,1,1,14949,10707660,10751690,2060,7088036,7094948
2003-09-28,2003,363,N,1,1,14574,10722234,10751690,1846,7089882,7094948
2003-09-29,2003,364,N,1,1,14852,10737086,10751690,2543,7092425,7094948
2003-09-30,2003,365,N,1,1,14604,10751690,10751690,2523,7094948,7094948
2003-10-01,2004,1,N,2,2,14540,14540,11128871,4392,4392,7537716
2003-10-02,2004,2,N,2,2,14745,29285,11128871,4615,9007,7537716
2003-10-03,2004,3,N,2,2,14388,43673,11128871,3815,12822,7537716
2003-10-04,2004,4,N,2,2,14243,57916,11128871,4169,16991,7537716
2003-10-05,2004,5,N,2,2,14009,71925,11128871,4515,21506,7537716
2003-10-06,2004,6,N,2,2,13629,85554,11128871,4145,25651,7537716
2003-10-07,2004,7,N,2,2,13725,99279,11128871,4336,29987,7537716
2003-10-08,2004,8,N,2,2,13815,113094,11128871,4384,34371,7537716
2003-10-09,2004,9,N,2,2,14135,127229,11128871,4697,39068,7537716
2003-10-10,2004,10,N,2,2,13959,141188,11128871,4276,43344,7537716
2003-10-11,2004,11,N,2,2,13305,154493,11128871,3223,46567,7537716
2003-10-12,2004,12,N,2,2,13311,167804,11128871,3909,50476,7537716
2003-10-13,2004,13,N,2,2,12817,180621,11128871,3880,54356,7537716
2003-10-14,2004,14,N,2,2,12828,193449,11128871,3949,58305,7537716
2003-10-15,2004,15,N,2,2,12772,206221,11128871,4366,62671,7537716
2003-10-16,2004,16,N,2,2,13087,219308,11128871,4677,67348,7537716
2003-10-17,2004,17,N,2,2,12600,231908,11128871,3712,71060,7537716
2003-10-18,2004,18,N,2,2,12740,244648,11128871,3858,74918,7537716
2003-10-19,2004,19,N,2,2,13463,258111,11128871,5704,80622,7537716
2003-10-20,2004,20,N,2,2,13212,271323,11128871,3420,84042,7537716
2003-10-21,2004,21,N,2,2,13205,284528,11128871,3523,87565,7537716
2003-10-22,2004,22,N,2,2,13365,297893,11128871,3526,91091,7537716
2003-10-23,2004,23,N,2,2,14000,311893,11128871,3743,94834,7537716
2003-10-24,2004,24,N,2,2,13447,325340,11128871,3157,97991,7537716
2003-10-25,2004,25,N,2,2,13160,338500,11128871,2898,100889,7537716
2003-10-26,2004,26,N,2,2,13069,351569,11128871,3431,104320,7537716
2003-10-27,2004,27,N,2,2,13002,364571,11128871,2758,107078,7537716
2003-10-28,2004,28,N,2,2,13334,377905,11128871,4992,112070,7537716
2003-10-29,2004,29,N,2,2,12133,390038,11128871,4429,116499,7537716
2003-10-30,2004,30,N,2,2,13579,403617,11128871,7994,124493,7537716
2003-10-31,2004,31,N,2,2,13819,417436,11128871,8952,133445,7537716
2003-11-01,2004,32,N,2,2,13821,431257,11128871,8342,141787,7537716
2003-11-02,2004,33,N,2,2,13878,445135,11128871,8129,149916,7537716
2003-11-03,2004,34,N,2,2,14260,459395,11128871,5265,155181,7537716
2003-11-04,2004,35,N,2,2,14338,473733,11128871,4847,160028,7537716
2003-11-05,2004,36,N,2,2,14318,488051,11128871,4690,164718,7537716
2003-11-06,2004,37,N,2,2,14086,502137,11128871,4407,169125,7537716
2003-11-07,2004,38,N,2,2,14211,516348,11128871,5590,174715,7537716
2003-11-08,2004,39,N,2,2,13987,530335,11128871,13962,188677,7537716
2003-11-09,2004,40,N,2,2,15132,545467,11128871,15279,203956,7537716
2003-11-10,2004,41,N,2,2,15851,561318,11128871,14483,218439,7537716
2003-11-11,2004,42,N,2,2,16377,577695,11128871,14773,233212,7537716
2003-11-12,2004,43,N,2,2,16619,594314,11128871,12958,246170,7537716
2003-11-13,2004,44,N,2,2,16442,610756,11128871,3894,250064,7537716
2003-11-14,2004,45,N,2,2,15688,626444,11128871,3480,253544,7537716
2003-11-15,2004,46,N,2,2,15439,641883,11128871,4972,258516,7537716
2003-11-16,2004,47,N,2,2,15220,657103,11128871,4689,263205,7537716
2003-11-17,2004,48,N,2,2,15416,672519,11128871,5376,268581,7537716
2003-11-18,2004,49,N,2,2,15375,687894,11128871,5652,274233,7537716
2003-11-19,2004,50,N,2,2,14672,702566,11128871,4834,279067,7537716
2003-11-20,2004,51,N,2,2,14351,716917,11128871,4428,283495,7537716
2003-11-21,2004,52,N,2,2,14035,730952,11128871,4544,288039,7537716
2003-11-22,2004,53,N,2,2,13807,744759,11128871,4597,292636,7537716
2003-11-23,2004,54,N,2,2,13303,758062,11128871,4600,297236,7537716
2003-11-24,2004,55,N,2,2,13119,771181,11128871,4396,301632,7537716
2003-11-25,2004,56,N,2,2,13154,784335,11128871,4342,305974,7537716
2003-11-26,2004,57,N,2,2,13539,797874,11128871,4733,310707,7537716
2003-11-27,2004,58,N,2,2,13624,811498,11128871,5804,316511,7537716
2003-11-28,2004,59,N,2,2,13214,824712,11128871,5284,321795,7537716
2003-11-29,2004,60,N,2,2,13492,838204,11128871,4613,326408,7537716
2003-11-30,2004,61,N,2,2,13795,851999,11128871,5801,332209,7537716
2003-12-01,2004,62,N,2,2,14293,866292,11128871,6783,338992,7537716
2003-12-02,2004,63,N,2,2,15690,881982,11128871,9190,348182,7537716
2003-12-03,2004,64,N,2,2,16876,898858,11128871,9877,358059,7537716
2003-12-04,2004,65,N,2,2,18078,916936,11128871,10966,369025,7537716
2003-12-05,2004,66,N,2,2,18483,935419,11128871,10838,379863,7537716
2003-12-06,2004,67,N,2,2,17702,953121,11128871,11120,390983,7537716
2003-12-07,2004,68,N,2,2,18048,971169,11128871,11831,402814,7537716
2003-12-08,2004,69,N,2,2,21016,992185,11128871,17364,420178,7537716
2003-12-09,2004,70,N,2,2,25480,1017665,11128871,21951,442129,7537716
2003-12-10,2004,71,N,2,2,24494,1042159,11128871,25477,467606,7537716
2003-12-11,2004,72,N,2,2,23444,1065603,11128871,22728,490334,7537716
2003-12-12,2004,73,N,2,2,25954,1091557,11128871,23479,513813,7537716
2003-12-13,2004,74,N,2,2,28013,1119570,11128871,23886,537699,7537716
2003-12-14,2004,75,N,2,2,28475,1148045,11128871,25279,562978,7537716
2003-12-15,2004,76,N,2,2,33010,1181055,11128871,22647,585625,7537716
2003-12-16,2004,77,N,2,2,38428,1219483,11128871,28123,613748,7537716
2003-12-17,2004,78,N,2,2,38005,1257488,11128871,28010,641758,7537716
2003-12-18,2004,79,N,2,2,34483,1291971,11128871,25406,667164,7537716
2003-12-19,2004,80,N,2,2,31809,1323780,11128871,21915,689079,7537716
2003-12-20,2004,81,N,2,2,29372,1353152,11128871,19311,708390,7537716
2003-12-21,2004,82,N,2,2,28906,1382058,11128871,18092,726482,7537716
2003-12-22,2004,83,N,2,2,31642,1413700,11128871,20796,747278,7537716
2003-12-23,2004,84,N,2,2,32816,1446516,11128871,22361,769639,7537716
2003-12-24,2004,85,N,2,2,32668,1479184,11128871,22981,792620,7537716
2003-12-25,2004,86,N,2,2,38072,1517256,11128871,28253,820873,7537716
2003-12-26,2004,87,N,2,2,45604,1562860,11128871,35464,856337,7537716
2003-12-27,2004,88,N,2,2,47987,1610847,11128871,38567,894904,7537716
2003-12-28,2004,89,N,2,2,49572,1660419,11128871,39177,934081,7537716
2003-12-29,2004,90,N,2,2,48919,1709338,11128871,40843,974924,7537716
2003-12-30,2004,91,N,2,2,51871,1761209,11128871,45289,1020213,7537716
2003-12-31,2004,92,N,2,2,56602,1817811,11128871,51521,1071734,7537716
2004-01-01,2004,93,N,2,2,61781,1879592,11128871,61863,1133597,7537716
2004-01-02,2004,94,N,2,2,70058,1949650,11128871,69523,1203120,7537716
2004-01-03,2004,95,N,2,2,72275,2021925,11128871,66085,1269205,7537716
2004-01-04,2004,96,N,2,2,71886,2093811,11128871,65412,1334617,7537716
2004-01-05,2004,97,N,2,2,68583,2162394,11128871,62469,1397086,7537716
2004-01-06,2004,98,N,2,2,62881,2225275,11128871,51571,1448657,7537716
2004-01-07,2004,99,N,2,2,57084,2282359,11128871,45274,1493931,7537716
2004-01-08,2004,100,N,2,2,52543,2334902,11128871,40651,1534582,7537716
2004-01-09,2004,101,N,2,2,50627,2385529,11128871,38833,1573415,7537716
2004-01-10,2004,102,N,2,2,50833,2436362,11128871,39936,1613351,7537716
2004-01-11,2004,103,N,2,2,51922,2488284,11128871,39947,1653298,7537716
2004-01-12,2004,104,N,2,2,53584,2541868,11128871,41319,1694617,7537716
2004-01-13,2004,105,N,2,2,52581,2594449,11128871,40540,1735157,7537716
2004-01-14,2004,106,N,2,2,48459,2642908,11128871,36257,1771414,7537716
2004-01-15,2004,107,N,2,2,44360,2687268,11128871,31577,1802991,7537716
2004-01-16,2004,108,N,2,2,40986,2728254,11128871,28687,1831678,7537716
2004-01-17,2004,109,N,2,2,38098,2766352,11128871,25452,1857130,7537716
2004-01-18,2004,110,N,2,2,35527,2801879,11128871,22778,1879908,7537716
2004-01-19,2004,111,N,2,2,33146,2835025,11128871,20405,1900313,7537716
2004-01-20,2004,112,N,2,2,30934,2865959,11128871,18197,1918510,7537716
2004-01-21,2004,113,N,2,2,29065,2895024,11128871,16129,1934639,7537716
2004-01-22,2004,114,N,2,2,27441,2922465,11128871,14548,1949187,7537716
2004-01-23,2004,115,N,2,2,25152,2947617,11128871,12530,1961717,7537716
2004-01-24,2004,116,N,2,2,24565,2972182,11128871,12871,1974588,7537716
2004-01-25,2004,117,N,2,2,23877,2996059,11128871,12318,1986906,7537716
2004-01-26,2004,118,N,2,2,23262,3019321,11128871,12126,1999032,7537716
2004-01-27,2004,119,N,2,2,22729,3042050,11128871,12224,2011256,7537716
2004-01-28,2004,120,N,2,2,23698,3065748,11128871,12884,2024140,7537716
2004-01-29,2004,121,N,2,2,25701,3091449,11128871,14103,2038243,7537716
2004-01-30,2004,122,N,2,2,27137,3118586,11128871,15079,2053322,7537716
2004-01-31,2004,123,N,2,2,26618,3145204,11128871,14696,2068018,7537716
2004-02-01,2004,124,N,2,2,25691,3170895,11128871,15218,2083236,7537716
2004-02-02,2004,125,N,2,2,25109,3196004,11128871,19148,2102384,7537716
2004-02-03,2004,126,N,2,2,27128,3223132,11128871,22476,2124860,7537716
2004-02-04,2004,127,N,2,2,36912,3260044,11128871,32410,2157270,7537716
2004-02-05,2004,128,N,2,2,43550,3303594,11128871,37067,2194337,7537716
2004-02-06,2004,129,N,2,2,43419,3347013,11128871,37969,2232306,7537716
2004-02-07,2004,130,N,2,2,39852,3386865,11128871,30515,2262821,7537716
2004-02-08,2004,131,N,2,2,36424,3423289,11128871,25914,2288735,7537716
2004-02-09,2004,132,N,2,2,33952,3457241,11128871,23019,2311754,7537716
2004-02-10,2004,133,N,2,2,31674,3488915,11128871,20894,2332648,7537716
2004-02-11,2004,134,N,2,2,29381,3518296,11128871,18605,2351253,7537716
2004-02-12,2004,135,N,2,2,26953,3545249,11128871,15750,2367003,7537716
2004-02-13,2004,136,N,2,2,25663,3570912,11128871,14294,2381297,7537716
2004-02-14,2004,137,N,2,2,24601,3595513,11128871,13426,2394723,7537716
2004-02-15,2004,138,N,2,2,23607,3619120,11128871,12236,2406959,7537716
2004-02-16,2004,139,N,2,2,22781,3641901,11128871,16220,2423179,7537716
2004-02-17,2004,140,N,2,2,26979,3668880,11128871,22443,2445622,7537716
2004-02-18,2004,141,N,2,2,49077,3717957,11128871,47358,2492980,7537716
2004-02-19,2004,142,N,2,2,70079,3788036,11128871,68307,2561287,7537716
2004-02-20,2004,143,N,2,2,114998,3903034,11128871,113161,2674448,7537716
2004-02-21,2004,144,N,2,2,158588,4061622,11128871,152201,2826649,7537716
2004-02-22,2004,145,N,2,2,156981,4218603,11128871,148984,2975633,7537716
2004-02-23,2004,146,N,2,2,142977,4361580,11128871,131122,3106755,7537716
2004-02-24,2004,147,N,2,2,129551,4491131,11128871,117792,3224547,7537716
2004-02-25,2004,148,N,2,2,127527,4618658,11128871,119460,3344007,7537716
2004-02-26,2004,149,N,2,2,177809,4796467,11128871,172032,3516039,7537716
2004-02-27,2004,150,N,2,2,182680,4979147,11128871,176711,3692750,7537716
2004-02-28,2004,151,N,2,2,186184,5165331,11128871,179947,3872697,7537716
2004-02-29,2004,152,N,2,2,176253,5341584,11128871,169968,4042665,7537716
2004-03-01,2004,153,N,2,2,164506,5506090,11128871,155420,4198085,7537716
2004-03-02,2004,154,N,2,2,157174,5663264,11128871,145135,4343220,7537716
2004-03-03,2004,155,N,2,2,145426,5808690,11128871,134297,4477517,7537716
2004-03-04,2004,156,N,2,2,138020,5946710,11128871,125892,4603409,7537716
2004-03-05,2004,157,N,2,2,124919,6071629,11128871,112844,4716253,7537716
2004-03-06,2004,158,N,2,2,113302,6184931,11128871,100147,4816400,7537716
2004-03-07,2004,159,N,2,2,102232,6287163,11128871,89534,4905934,7537716
2004-03-08,2004,160,N,2,2,93335,6380498,11128871,80347,4986281,7537716
2004-03-09,2004,161,N,2,2,84765,6465263,11128871,71577,5057858,7537716
2004-03-10,2004,162,N,2,2,76575,6541838,11128871,63384,5121242,7537716
2004-03-11,2004,163,N,2,2,71067,6612905,11128871,58185,5179427,7537716
2004-03-12,2004,164,N,2,2,67664,6680569,11128871,54427,5233854,7537716
2004-03-13,2004,165,N,2,2,63457,6744026,11128871,50166,5284020,7537716
2004-03-14,2004,166,N,2,2,58234,6802260,11128871,45409,5329429,7537716
2004-03-15,2004,167,N,2,2,52805,6855065,11128871,39465,5368894,7537716
2004-03-16,2004,168,N,2,2,48381,6903446,11128871,36653,5405547,7537716
2004-03-17,2004,169,N,2,2,44947,6948393,11128871,33405,5438952,7537716
2004-03-18,2004,170,N,2,2,42308,6990701,11128871,30776,5469728,7537716
2004-03-19,2004,171,N,2,2,40771,7031472,11128871,29284,5499012,7537716
2004-03-20,2004,172,N,2,2,39564,7071036,11128871,28040,5527052,7537716
2004-03-21,2004,173,N,2,2,38656,7109692,11128871,27030,5554082,7537716
2004-03-22,2004,174,N,2,2,37439,7147131,11128871,25752,5579834,7537716
2004-03-23,2004,175,N,2,2,36378,7183509,11128871,25139,5604973,7537716
2004-03-24,2004,176,N,2,2,37856,7221365,11128871,27039,5632012,7537716
2004-03-25,2004,177,N,2,2,38307,7259672,11128871,27913,5659925,7537716
2004-03-26,2004,178,N,2,2,38338,7298010,11128871,27405,5687330,7537716
2004-03-27,2004,179,N,2,2,36196,7334206,11128871,26214,5713544,7537716
2004-03-28,2004,180,N,2,2,33397,7367603,11128871,22479,5736023,7537716
2004-03-29,2004,181,N,2,2,30720,7398323,11128871,19558,5755581,7537716
2004-03-30,2004,182,N,2,2,28760,7427083,11128871,16144,5771725,7537716
2004-03-31,2004,183,N,2,2,27254,7454337,11128871,16226,5787951,7537716
2004-04-01,2004,184,N,2,2,25669,7480006,11128871,14146,5802097,7537716
2004-04-02,2004,185,N,2,2,24876,7504882,11128871,14118,5816215,7537716
2004-04-03,2004,186,N,2,2,24497,7529379,11128871,14496,5830711,7537716
2004-04-04,2004,187,N,2,2,25014,7554393,11128871,15330,5846041,7537716
2004-04-05,2004,188,N,2,2,27585,7581978,11128871,16928,5862969,7537716
2004-04-06,2004,189,N,2,2,29859,7611837,11128871,18209,5881178,7537716
2004-04-07,2004,190,N,2,2,35057,7646894,11128871,25152,5906330,7537716
2004-04-08,2004,191,N,2,2,37104,7683998,11128871,31799,5938129,7537716
2004-04-09,2004,192,N,2,2,38379,7722377,11128871,31065,5969194,7537716
2004-04-10,2004,193,N,2,2,39538,7761915,11128871,31038,6000232,7537716
2004-04-11,2004,194,N,2,2,39277,7801192,11128871,30079,6030311,7537716
2004-04-12,2004,195,N,2,2,38310,7839502,11128871,28732,6059043,7537716
2004-04-13,2004,196,N,2,2,36518,7876020,11128871,28420,6087463,7537716
2004-04-14,2004,197,N,2,2,34972,7910992,11128871,27891,6115354,7537716
2004-04-15,2004,198,N,2,2,34018,7945010,11128871,30368,6145722,7537716
2004-04-16,2004,199,N,2,2,34270,7979280,11128871,30589,6176311,7537716
2004-04-17,2004,200,N,2,2,34154,8013434,11128871,30871,6207182,7537716
2004-04-18,2004,201,N,2,2,32841,8046275,11128871,31539,6238721,7537716
2004-04-19,2004,202,N,2,2,29105,8075380,11128871,28492,6267213,7537716
2004-04-20,2004,203,N,2,2,25888,8101268,11128871,25125,6292338,7537716
2004-04-21,2004,204,N,2,2,23290,8124558,11128871,22559,6314897,7537716
2004-04-22,2004,205,N,2,2,21862,8146420,11128871,20822,6335719,7537716
2004-04-23,2004,206,N,2,2,20372,8166792,11128871,17254,6352973,7537716
2004-04-24,2004,207,N,2,2,19534,8186326,11128871,15758,6368731,7537716
2004-04-25,2004,208,N,2,2,18807,8205133,11128871,15025,6383756,7537716
2004-04-26,2004,209,N,2,2,17826,8222959,11128871,14181,6397937,7537716
2004-04-27,2004,210,N,2,2,16572,8239531,11128871,12896,6410833,7537716
2004-04-28,2004,211,N,2,2,16191,8255722,11128871,12342,6423175,7537716
2004-04-29,2004,212,N,2,2,16338,8272060,11128871,12487,6435662,7537716
2004-04-30,2004,213,N,2,2,16273,8288333,11128871,12484,6448146,7537716
2004-05-01,2004,214,N,2,2,16307,8304640,11128871,12665,6460811,7537716
2004-05-02,2004,215,N,2,2,16210,8320850,11128871,12543,6473354,7537716
2004-05-03,2004,216,N,2,2,16377,8337227,11128871,12623,6485977,7537716
2004-05-04,2004,217,N,2,2,16163,8353390,11128871,12339,6498316,7537716
2004-05-05,2004,218,N,2,2,17090,8370480,11128871,13494,6511810,7537716
2004-05-06,2004,219,N,2,2,17951,8388431,11128871,14331,6526141,7537716
2004-05-07,2004,220,N,2,2,18266,8406697,11128871,14592,6540733,7537716
2004-05-08,2004,221,N,2,2,18017,8424714,11128871,14295,6555028,7537716
2004-05-09,2004,222,N,2,2,17912,8442626,11128871,14192,6569220,7537716
2004-05-10,2004,223,N,2,2,18693,8461319,11128871,14977,6584197,7537716
2004-05-11,2004,224,N,2,2,19038,8480357,11128871,15250,6599447,7537716
2004-05-12,2004,225,N,2,2,18798,8499155,11128871,15063,6614510,7537716
2004-05-13,2004,226,N,2,2,18452,8517607,11128871,14674,6629184,7537716
2004-05-14,2004,227,N,2,2,17410,8535017,11128871,13508,6642692,7537716
2004-05-15,2004,228,N,2,2,16285,8551302,11128871,12749,6655441,7537716
2004-05-16,2004,229,N,2,2,15691,8566993,11128871,11686,6667127,7537716
2004-05-17,2004,230,N,2,2,15420,8582413,11128871,11416,6678543,7537716
2004-05-18,2004,231,N,2,2,16377,8598790,11128871,12373,6690916,7537716
2004-05-19,2004,232,N,2,2,16113,8614903,11128871,12064,6702980,7537716
2004-05-20,2004,233,N,2,2,15903,8630806,11128871,11762,6714742,7537716
2004-05-21,2004,234,N,2,2,15385,8646191,11128871,11192,6725934,7537716
2004-05-22,2004,235,N,2,2,15056,8661247,11128871,10761,6736695,7537716
2004-05-23,2004,236,N,2,2,15462,8676709,11128871,11066,6747761,7537716
2004-05-24,2004,237,N,2,2,15507,8692216,11128871,11109,6758870,7537716
2004-05-25,2004,238,N,2,2,15503,8707719,11128871,11017,6769887,7537716
2004-05-26,2004,239,N,2,2,15301,8723020,11128871,10814,6780701,7537716
2004-05-27,2004,240,N,2,2,14815,8737835,11128871,10583,6791284,7537716
2004-05-28,2004,241,N,2,2,14946,8752781,11128871,10977,6802261,7537716
2004-05-29,2004,242,N,2,2,15533,8768314,11128871,10557,6812818,7537716
2004-05-30,2004,243,N,2,2,16307,8784621,11128871,10524,6823342,7537716
2004-05-31,2004,244,N,2,2,16860,8801481,11128871,9995,6833337,7537716
2004-06-01,2004,245,N,2,2,16753,8818234,11128871,8440,6841777,7537716
2004-06-02,2004,246,N,2,2,16228,8834462,11128871,6439,6848216,7537716
2004-06-03,2004,247,N,2,2,15579,8850041,11128871,-28982,6819234,7537716
2004-06-04,2004,248,N,2,2,14959,8865000,11128871,-15304,6803930,7537716
2004-06-05,2004,249,N,2,2,14990,8879990,11128871,-3248,6800682,7537716
2004-06-06,2004,250,N,2,2,14826,8894816,11128871,8433,6809115,7537716
2004-06-07,2004,251,N,2,2,15355,8910171,11128871,8345,6817460,7537716
2004-06-08,2004,252,N,2,2,17687,8927858,11128871,9673,6827133,7537716
2004-06-09,2004,253,N,2,2,18675,8946533,11128871,8997,6836130,7537716
2004-06-10,2004,254,N,2,2,19319,8965852,11128871,8801,6844931,7537716
2004-06-11,2004,255,N,2,2,18806,8984658,11128871,8345,6853276,7537716
2004-06-12,2004,256,N,2,2,18424,9003082,11128871,8009,6861285,7537716
2004-06-13,2004,257,N,2,2,18207,9021289,11128871,7750,6869035,7537716
2004-06-14,2004,258,N,2,2,18172,9039461,11128871,8410,6877445,7537716
2004-06-15,2004,259,N,2,2,17690,9057151,11128871,7402,6884847,7537716
2004-06-16,2004,260,N,2,2,17211,9074362,11128871,6595,6891442,7537716
2004-06-17,2004,261,N,2,2,17264,9091626,11128871,8035,6899477,7537716
2004-06-18,2004,262,N,2,2,17639,9109265,11128871,8013,6907490,7537716
2004-06-19,2004,263,N,2,2,18080,9127345,11128871,8773,6916263,7537716
2004-06-20,2004,264,N,2,2,18574,9145919,11128871,8128,6924391,7537716
2004-06-21,2004,265,N,2,2,18566,9164485,11128871,8387,6932778,7537716
2004-06-22,2004,266,N,2,2,18114,9182599,11128871,7789,6940567,7537716
2004-06-23,2004,267,N,2,2,18157,9200756,11128871,7662,6948229,7537716
2004-06-24,2004,268,N,2,2,18487,9219243,11128871,8340,6956569,7537716
2004-06-25,2004,269,N,2,2,18332,9237575,11128871,7979,6964548,7537716
2004-06-26,2004,270,N,2,2,18028,9255603,11128871,7651,6972199,7537716
2004-06-27,2004,271,N,2,2,17979,9273582,11128871,7584,6979783,7537716
2004-06-28,2004,272,N,2,2,18039,9291621,11128871,8026,6987809,7537716
2004-06-29,2004,273,N,2,2,18228,9309849,11128871,8373,6996182,7537716
2004-06-30,2004,274,N,2,2,19865,9329714,11128871,8954,7005136,7537716
2004-07-01,2004,275,N,2,2,20519,9350233,11128871,8665,7013801,7537716
2004-07-02,2004,276,N,2,2,20624,9370857,11128871,7694,7021495,7537716
2004-07-03,2004,277,N,2,2,20801,9391658,11128871,7834,7029329,7537716
2004-07-04,2004,278,N,2,2,21301,9412959,11128871,8409,7037738,7537716
2004-07-05,2004,279,N,2,2,21733,9434692,11128871,8181,7045919,7537716
2004-07-06,2004,280,N,2,2,21834,9456526,11128871,7651,7053570,7537716
2004-07-07,2004,281,N,2,2,21705,9478231,11128871,6859,7060429,7537716
2004-07-08,2004,282,N,2,2,21991,9500222,11128871,6351,7066780,7537716
2004-07-09,2004,283,N,2,2,22420,9522642,11128871,7489,7074269,7537716
2004-07-10,2004,284,N,2,2,23027,9545669,11128871,6808,7081077,7537716
2004-07-11,2004,285,N,2,2,23374,9569043,11128871,7232,7088309,7537716
2004-07-12,2004,286,N,2,2,23279,9592322,11128871,7116,7095425,7537716
2004-07-13,2004,287,N,2,2,23493,9615815,11128871,7412,7102837,7537716
2004-07-14,2004,288,N,2,2,23494,9639309,11128871,7426,7110263,7537716
2004-07-15,2004,289,N,2,2,23544,9662853,11128871,7422,7117685,7537716
2004-07-16,2004,290,N,2,2,23343,9686196,11128871,7248,7124933,7537716
2004-07-17,2004,291,N,2,2,23281,9709477,11128871,7255,7132188,7537716
2004-07-18,2004,292,N,2,2,23742,9733219,11128871,7911,7140099,7537716
2004-07-19,2004,293,N,2,2,23907,9757126,11128871,8164,7148263,7537716
2004-07-20,2004,294,N,2,2,23791,9780917,11128871,8105,7156368,7537716
2004-07-21,2004,295,N,2,2,23276,9804193,11128871,7957,7164325,7537716
2004-07-22,2004,296,N,2,2,22455,9826648,11128871,6568,7170893,7537716
2004-07-23,2004,297,N,2,2,22072,9848720,11128871,6474,7177367,7537716
2004-07-24,2004,298,N,2,2,22604,9871324,11128871,7239,7184606,7537716
2004-07-25,2004,299,N,2,2,23000,9894324,11128871,7196,7191802,7537716
2004-07-26,2004,300,N,2,2,22433,9916757,11128871,6734,7198536,7537716
2004-07-27,2004,301,N,2,2,22017,9938774,11128871,6347,7204883,7537716
2004-07-28,2004,302,N,2,2,22021,9960795,11128871,7082,7211965,7537716
2004-07-29,2004,303,N,2,2,22128,9982923,11128871,7209,7219174,7537716
2004-07-30,2004,304,N,2,2,21769,10004692,11128871,7594,7226768,7537716
2004-07-31,2004,305,N,2,2,21724,10026416,11128871,7091,7233859,7537716
2004-08-01,2004,306,N,2,2,21330,10047746,11128871,6525,7240384,7537716
2004-08-02,2004,307,N,2,2,21082,10068828,11128871,6654,7247038,7537716
2004-08-03,2004,308,N,2,2,21301,10090129,11128871,6294,7253332,7537716
2004-08-04,2004,309,N,2,2,21075,10111204,11128871,5619,7258951,7537716
2004-08-05,2004,310,N,2,2,21121,10132325,11128871,5765,7264716,7537716
2004-08-06,2004,311,N,2,2,21128,10153453,11128871,7316,7272032,7537716
2004-08-07,2004,312,N,2,2,20927,10174380,11128871,7082,7279114,7537716
2004-08-08,2004,313,N,2,2,20686,10195066,11128871,6897,7286011,7537716
2004-08-09,2004,314,N,2,2,20527,10215593,11128871,6743,7292754,7537716
2004-08-10,2004,315,N,2,2,20349,10235942,11128871,6482,7299236,7537716
2004-08-11,2004,316,N,2,2,20139,10256081,11128871,6271,7305507,7537716
2004-08-12,2004,317,N,2,2,19833,10275914,11128871,6018,7311525,7537716
2004-08-13,2004,318,N,2,2,19802,10295716,11128871,5195,7316720,7537716
2004-08-14,2004,319,N,2,2,19617,10315333,11128871,4484,7321204,7537716
2004-08-15,2004,320,N,2,2,19826,10335159,11128871,5171,7326375,7537716
2004-08-16,2004,321,N,2,2,19577,10354736,11128871,4787,7331162,7537716
2004-08-17,2004,322,N,2,2,19234,10373970,11128871,4232,7335394,7537716
2004-08-18,2004,323,N,2,2,19261,10393231,11128871,5661,7341055,7537716
2004-08-19,2004,324,N,2,2,19095,10412326,11128871,4069,7345124,7537716
2004-08-20,2004,325,N,2,2,18821,10431147,11128871,3796,7348920,7537716
2004-08-21,2004,326,N,2,2,18486,10449633,11128871,3503,7352423,7537716
2004-08-22,2004,327,N,2,2,18792,10468425,11128871,3857,7356280,7537716
2004-08-23,2004,328,N,2,2,19479,10487904,11128871,4571,7360851,7537716
2004-08-24,2004,329,N,2,2,19667,10507571,11128871,4832,7365683,7537716
2004-08-25,2004,330,N,2,2,20003,10527574,11128871,5187,7370870,7537716
2004-08-26,2004,331,N,2,2,19855,10547429,11128871,5652,7376522,7537716
2004-08-27,2004,332,N,2,2,19001,10566430,11128871,4413,7380935,7537716
2004-08-28,2004,333,N,2,2,18655,10585085,11128871,4035,7384970,7537716
2004-08-29,2004,334,N,2,2,18335,10603420,11128871,3657,7388627,7537716
2004-08-30,2004,335,N,2,2,18258,10621678,11128871,3762,7392389,7537716
2004-08-31,2004,336,N,2,2,17962,10639640,11128871,4298,7396687,7537716
2004-09-01,2004,337,N,2,2,17671,10657311,11128871,4117,7400804,7537716
2004-09-02,2004,338,N,2,2,17898,10675209,11128871,4570,7405374,7537716
2004-09-03,2004,339,N,2,2,17923,10693132,11128871,4494,7409868,7537716
2004-09-04,2004,340,N,2,2,17779,10710911,11128871,5575,7415443,7537716
2004-09-05,2004,341,N,2,2,17940,10728851,11128871,4970,7420413,7537716
2004-09-06,2004,342,N,2,2,17902,10746753,11128871,5167,7425580,7537716
2004-09-07,2004,343,N,2,2,17847,10764600,11128871,5583,7431163,7537716
2004-09-08,2004,344,N,2,2,18011,10782611,11128871,7230,7438393,7537716
2004-09-09,2004,345,N,2,2,17687,10800298,11128871,7702,7446095,7537716
2004-09-10,2004,346,N,2,2,17035,10817333,11128871,6719,7452814,7537716
2004-09-11,2004,347,N,2,2,17008,10834341,11128871,5646,7458460,7537716
2004-09-12,2004,348,N,2,2,16624,10850965,11128871,5151,7463611,7537716
2004-09-13,2004,349,N,2,2,17088,10868053,11128871,5637,7469248,7537716
2004-09-14,2004,350,N,2,2,16728,10884781,11128871,5054,7474302,7537716
2004-09-15,2004,351,N,2,2,16552,10901333,11128871,4735,7479037,7537716
2004-09-16,2004,352,N,2,2,16260,10917593,11128871,4585,7483622,7537716
2004-09-17,2004,353,N,2,2,15662,10933255,11128871,4020,7487642,7537716
2004-09-18,2004,354,N,2,2,16248,10949503,11128871,4596,7492238,7537716
2004-09-19,2004,355,N,2,2,16298,10965801,11128871,5155,7497393,7537716
2004-09-20,2004,356,N,2,2,16437,10982238,11128871,5236,7502629,7537716
2004-09-21,2004,357,N,2,2,16200,10998438,11128871,5047,7507676,7537716
2004-09-22,2004,358,N,2,2,16164,11014602,11128871,5258,7512934,7537716
2004-09-23,2004,359,N,2,2,15883,11030485,11128871,4940,7517874,7537716
2004-09-24,2004,360,N,2,2,15043,11045528,11128871,2840,7520714,7537716
2004-09-25,2004,361,N,2,2,14642,11060170,11128871,3456,7524170,7537716
2004-09-26,2004,362,N,2,2,14478,11074648,11128871,3739,7527909,7537716
2004-09-27,2004,363,N,2,2,13992,11088640,11128871,2580,7530489,7537716
2004-09-28,2004,364,N,2,2,13675,11102315,11128871,2137,7532626,7537716
2004-09-29,2004,365,N,2,2,13433,11115748,11128871,2444,7535070,7537716
2004-09-30,2004,366,N,2,2,13123,11128871,11128871,2646,7537716,7537716
2004-10-01,2005,1,W,1,1,13626,13626,11302044,4941,4941,7782942
2004-10-02,2005,2,W,1,1,13517,27143,11302044,5404,10345,7782942
2004-10-03,2005,3,W,1,1,13157,40300,11302044,5558,15903,7782942
2004-10-04,2005,4,W,1,1,12860,53160,11302044,5311,21214,7782942
2004-10-05,2005,5,W,1,1,13225,66385,11302044,5775,26989,7782942
2004-10-06,2005,6,W,1,1,12902,79287,11302044,4413,31402,7782942
2004-10-07,2005,7,W,1,1,12669,91956,11302044,4208,35610,7782942
2004-10-08,2005,8,W,1,1,12468,104424,11302044,4585,40195,7782942
2004-10-09,2005,9,W,1,1,12988,117412,11302044,5622,45817,7782942
2004-10-10,2005,10,W,1,1,12848,130260,11302044,5411,51228,7782942
2004-10-11,2005,11,W,1,1,12465,142725,11302044,5096,56324,7782942
2004-10-12,2005,12,W,1,1,12485,155210,11302044,4983,61307,7782942
2004-10-13,2005,13,W,1,1,12475,167685,11302044,4999,66306,7782942
2004-10-14,2005,14,W,1,1,12378,180063,11302044,4909,71215,7782942
2004-10-15,2005,15,W,1,1,12188,192251,11302044,4727,75942,7782942
2004-10-16,2005,16,W,1,1,12027,204278,11302044,4596,80538,7782942
2004-10-17,2005,17,W,1,1,11809,216087,11302044,5160,85698,7782942
2004-10-18,2005,18,W,1,1,13000,229087,11302044,6441,92139,7782942
2004-10-19,2005,19,W,1,1,13000,242087,11302044,14215,106354,7782942
2004-10-20,2005,20,W,1,1,16542,258629,11302044,18234,124588,7782942
2004-10-21,2005,21,W,1,1,17152,275781,11302044,17321,141909,7782942
2004-10-22,2005,22,W,1,1,18094,293875,11302044,17136,159045,7782942
2004-10-23,2005,23,W,1,1,17509,311384,11302044,17632,176677,7782942
2004-10-24,2005,24,W,1,1,16489,327873,11302044,8609,185286,7782942
2004-10-25,2005,25,W,1,1,15624,343497,11302044,7367,192653,7782942
2004-10-26,2005,26,W,1,1,16658,360155,11302044,12266,204919,7782942
2004-10-27,2005,27,W,1,1,17865,378020,11302044,13376,218295,7782942
2004-10-28,2005,28,W,1,1,19088,397108,11302044,12470,230765,7782942
2004-10-29,2005,29,W,1,1,20988,418096,11302044,13750,244515,7782942
2004-10-30,2005,30,W,1,1,19559,437655,11302044,12507,257022,7782942
2004-10-31,2005,31,W,1,1,17927,455582,11302044,7017,264039,7782942
2004-11-01,2005,32,W,1,1,16720,472302,11302044,6785,270824,7782942
2004-11-02,2005,33,W,1,1,15612,487914,11302044,5725,276549,7782942
2004-11-03,2005,34,W,1,1,15243,503157,11302044,8173,284722,7782942
2004-11-04,2005,35,W,1,1,15635,518792,11302044,9861,294583,7782942
2004-11-05,2005,36,W,1,1,14706,533498,11302044,7747,302330,7782942
2004-11-06,2005,37,W,1,1,14821,548319,11302044,8970,311300,7782942
2004-11-07,2005,38,W,1,1,14774,563093,11302044,9181,320481,7782942
2004-11-08,2005,39,W,1,1,14159,577252,11302044,4146,324627,7782942
2004-11-09,2005,40,W,1,1,13859,591111,11302044,3932,328559,7782942
2004-11-10,2005,41,W,1,1,13843,604954,11302044,4172,332731,7782942
2004-11-11,2005,42,W,1,1,14373,619327,11302044,10383,343114,7782942
2004-11-12,2005,43,W,1,1,14807,634134,11302044,10828,353942,7782942
2004-11-13,2005,44,W,1,1,15099,649233,11302044,11834,365776,7782942
2004-11-14,2005,45,W,1,1,15143,664376,11302044,11857,377633,7782942
2004-11-15,2005,46,W,1,1,14651,679027,11302044,10482,388115,7782942
2004-11-16,2005,47,W,1,1,14450,693477,11302044,4564,392679,7782942
2004-11-17,2005,48,W,1,1,14430,707907,11302044,4591,397270,7782942
2004-11-18,2005,49,W,1,1,14317,722224,11302044,4050,401320,7782942
2004-11-19,2005,50,W,1,1,13906,736130,11302044,4694,406014,7782942
2004-11-20,2005,51,W,1,1,13932,750062,11302044,5299,411313,7782942
2004-11-21,2005,52,W,1,1,13526,763588,11302044,4735,416048,7782942
2004-11-22,2005,53,W,1,1,12697,776285,11302044,3879,419927,7782942
2004-11-23,2005,54,W,1,1,12471,788756,11302044,4150,424077,7782942
2004-11-24,2005,55,W,1,1,12356,801112,11302044,4078,428155,7782942
2004-11-25,2005,56,W,1,1,12047,813159,11302044,4190,432345,7782942
2004-11-26,2005,57,W,1,1,12047,825206,11302044,4720,437065,7782942
2004-11-27,2005,58,W,1,1,13301,838507,11302044,7279,444344,7782942
2004-11-28,2005,59,W,1,1,15493,854000,11302044,8388,452732,7782942
2004-11-29,2005,60,W,1,1,14888,868888,11302044,6963,459695,7782942
2004-11-30,2005,61,W,1,1,14220,883108,11302044,5589,465284,7782942
2004-12-01,2005,62,W,1,1,14079,897187,11302044,5408,470692,7782942
2004-12-02,2005,63,W,1,1,14084,911271,11302044,3977,474669,7782942
2004-12-03,2005,64,W,1,1,13783,925054,11302044,3686,478355,7782942
2004-12-04,2005,65,W,1,1,13479,938533,11302044,3399,481754,7782942
2004-12-05,2005,66,W,1,1,13087,951620,11302044,3012,484766,7782942
2004-12-06,2005,67,W,1,1,12693,964313,11302044,4711,489477,7782942
2004-12-07,2005,68,W,1,1,13553,977866,11302044,8828,498305,7782942
2004-12-08,2005,69,W,1,1,15698,993564,11302044,13486,511791,7782942
2004-12-09,2005,70,W,1,1,21037,1014601,11302044,18825,530616,7782942
2004-12-10,2005,71,W,1,1,29199,1043800,11302044,26938,557554,7782942
2004-12-11,2005,72,W,1,1,30874,1074674,11302044,28500,586054,7782942
2004-12-12,2005,73,W,1,1,26874,1101548,11302044,21373,607427,7782942
2004-12-13,2005,74,W,1,1,23085,1124633,11302044,15047,622474,7782942
2004-12-14,2005,75,W,1,1,21011,1145644,11302044,12983,635457,7782942
2004-12-15,2005,76,W,1,1,19796,1165440,11302044,11781,647238,7782942
2004-12-16,2005,77,W,1,1,19177,1184617,11302044,9008,656246,7782942
2004-12-17,2005,78,W,1,1,18234,1202851,11302044,6684,662930,7782942
2004-12-18,2005,79,W,1,1,17800,1220651,11302044,5627,668557,7782942
2004-12-19,2005,80,W,1,1,16976,1237627,11302044,3437,671994,7782942
2004-12-20,2005,81,W,1,1,16266,1253893,11302044,4337,676331,7782942
2004-12-21,2005,82,W,1,1,15720,1269613,11302044,3143,679474,7782942
2004-12-22,2005,83,W,1,1,15198,1284811,11302044,3635,683109,7782942
2004-12-23,2005,84,W,1,1,14575,1299386,11302044,3055,686164,7782942
2004-12-24,2005,85,W,1,1,14373,1313759,11302044,3579,689743,7782942
2004-12-25,2005,86,W,1,1,14039,1327798,11302044,4005,693748,7782942
2004-12-26,2005,87,W,1,1,13641,1341439,11302044,3620,697368,7782942
2004-12-27,2005,88,W,1,1,13631,1355070,11302044,5372,702740,7782942
2004-12-28,2005,89,W,1,1,17107,1372177,11302044,13275,716015,7782942
2004-12-29,2005,90,W,1,1,33448,1405625,11302044,29942,745957,7782942
2004-12-30,2005,91,W,1,1,45178,1450803,11302044,46803,792760,7782942
2004-12-31,2005,92,W,1,1,56541,1507344,11302044,58511,851271,7782942
2005-01-01,2005,93,W,1,1,64128,1571472,11302044,63899,915170,7782942
2005-01-02,2005,94,W,1,1,65494,1636966,11302044,62929,978099,7782942
2005-01-03,2005,95,W,1,1,62785,1699751,11302044,60205,1038304,7782942
2005-01-04,2005,96,W,1,1,60342,1760093,11302044,52597,1090901,7782942
2005-01-05,2005,97,W,1,1,54987,1815080,11302044,45763,1136664,7782942
2005-01-06,2005,98,W,1,1,49370,1864450,11302044,39138,1175802,7782942
2005-01-07,2005,99,W,1,1,44686,1909136,11302044,33800,1209602,7782942
2005-01-08,2005,100,W,1,1,45489,1954625,11302044,34984,1244586,7782942
2005-01-09,2005,101,W,1,1,49405,2004030,11302044,40727,1285313,7782942
2005-01-10,2005,102,W,1,1,50179,2054209,11302044,42128,1327441,7782942
2005-01-11,2005,103,W,1,1,52771,2106980,11302044,46503,1373944,7782942
2005-01-12,2005,104,W,1,1,53707,2160687,11302044,46658,1420602,7782942
2005-01-13,2005,105,W,1,1,54921,2215608,11302044,46580,1467182,7782942
2005-01-14,2005,106,W,1,1,52364,2267972,11302044,42557,1509739,7782942
2005-01-15,2005,107,W,1,1,48206,2316178,11302044,37651,1547390,7782942
2005-01-16,2005,108,W,1,1,44486,2360664,11302044,31284,1578674,7782942
2005-01-17,2005,109,W,1,1,41112,2401776,11302044,27593,1606267,7782942
2005-01-18,2005,110,W,1,1,37994,2439770,11302044,24954,1631221,7782942
2005-01-19,2005,111,W,1,1,35336,2475106,11302044,21728,1652949,7782942
2005-01-20,2005,112,W,1,1,33301,2508407,11302044,19478,1672427,7782942
2005-01-21,2005,113,W,1,1,31952,2540359,11302044,18240,1690667,7782942
2005-01-22,2005,114,W,1,1,30475,2570834,11302044,16709,1707376,7782942
2005-01-23,2005,115,W,1,1,29136,2599970,11302044,15623,1722999,7782942
2005-01-24,2005,116,W,1,1,27722,2627692,11302044,14327,1737326,7782942
2005-01-25,2005,117,W,1,1,26229,2653921,11302044,12870,1750196,7782942
2005-01-26,2005,118,W,1,1,25561,2679482,11302044,13886,1764082,7782942
2005-01-27,2005,119,W,1,1,25317,2704799,11302044,13947,1778029,7782942
2005-01-28,2005,120,W,1,1,31300,2736099,11302044,22222,1800251,7782942
2005-01-29,2005,121,W,1,1,39231,2775330,11302044,30017,1830268,7782942
2005-01-30,2005,122,W,1,1,42344,2817674,11302044,33233,1863501,7782942
2005-01-31,2005,123,W,1,1,40900,2858574,11302044,30114,1893615,7782942
2005-02-01,2005,124,W,1,1,38012,2896586,11302044,28023,1921638,7782942
2005-02-02,2005,125,W,1,1,35825,2932411,11302044,30618,1952256,7782942
2005-02-03,2005,126,W,1,1,33739,2966150,11302044,29884,1982140,7782942
2005-02-04,2005,127,W,1,1,31829,2997979,11302044,27627,2009767,7782942
2005-02-05,2005,128,W,1,1,30476,3028455,11302044,24265,2034032,7782942
2005-02-06,2005,129,W,1,1,28891,3057346,11302044,20691,2054723,7782942
2005-02-07,2005,130,W,1,1,27065,3084411,11302044,17259,2071982,7782942
2005-02-08,2005,131,W,1,1,26422,3110833,11302044,15632,2087614,7782942
2005-02-09,2005,132,W,1,1,25894,3136727,11302044,13785,2101399,7782942
2005-02-10,2005,133,W,1,1,28493,3165220,11302044,16927,2118326,7782942
2005-02-11,2005,134,W,1,1,29622,3194842,11302044,18245,2136571,7782942
2005-02-12,2005,135,W,1,1,27558,3222400,11302044,15943,2152514,7782942
2005-02-13,2005,136,W,1,1,25059,3247459,11302044,14147,2166661,7782942
2005-02-14,2005,137,W,1,1,23325,3270784,11302044,13397,2180058,7782942
2005-02-15,2005,138,W,1,1,23227,3294011,11302044,18460,2198518,7782942
2005-02-16,2005,139,W,1,1,25426,3319437,11302044,21754,2220272,7782942
2005-02-17,2005,140,W,1,1,28063,3347500,11302044,24271,2244543,7782942
2005-02-18,2005,141,W,1,1,28428,3375928,11302044,26503,2271046,7782942
2005-02-19,2005,142,W,1,1,28693,3404621,11302044,26302,2297348,7782942
2005-02-20,2005,143,W,1,1,32016,3436637,11302044,25523,2322871,7782942
2005-02-21,2005,144,W,1,1,39264,3475901,11302044,31762,2354633,7782942
2005-02-22,2005,145,W,1,1,45791,3521692,11302044,37552,2392185,7782942
2005-02-23,2005,146,W,1,1,47121,3568813,11302044,37773,2429958,7782942
2005-02-24,2005,147,W,1,1,45091,3613904,11302044,33807,2463765,7782942
2005-02-25,2005,148,W,1,1,43260,3657164,11302044,32100,2495865,7782942
2005-02-26,2005,149,W,1,1,41422,3698586,11302044,30044,2525909,7782942
2005-02-27,2005,150,W,1,1,39317,3737903,11302044,32245,2558154,7782942
2005-02-28,2005,151,W,1,1,38608,3776511,11302044,33583,2591737,7782942
2005-03-01,2005,152,W,1,1,38871,3815382,11302044,35424,2627161,7782942
2005-03-02,2005,153,W,1,1,43574,3858956,11302044,41759,2668920,7782942
2005-03-03,2005,154,W,1,1,45474,3904430,11302044,43817,2712737,7782942
2005-03-04,2005,155,W,1,1,44810,3949240,11302044,39271,2752008,7782942
2005-03-05,2005,156,W,1,1,43231,3992471,11302044,37672,2789680,7782942
2005-03-06,2005,157,W,1,1,40603,4033074,11302044,33398,2823078,7782942
2005-03-07,2005,158,W,1,1,38168,4071242,11302044,29560,2852638,7782942
2005-03-08,2005,159,W,1,1,35887,4107129,11302044,26793,2879431,7782942
2005-03-09,2005,160,W,1,1,34360,4141489,11302044,25746,2905177,7782942
2005-03-10,2005,161,W,1,1,33328,4174817,11302044,26818,2931995,7782942
2005-03-11,2005,162,W,1,1,32401,4207218,11302044,25893,2957888,7782942
2005-03-12,2005,163,W,1,1,31557,4238775,11302044,25048,2982936,7782942
2005-03-13,2005,164,W,1,1,29898,4268673,11302044,21683,3004619,7782942
2005-03-14,2005,165,W,1,1,29339,4298012,11302044,22737,3027356,7782942
2005-03-15,2005,166,W,1,1,28576,4326588,11302044,21971,3049327,7782942
2005-03-16,2005,167,W,1,1,28229,4354817,11302044,21883,3071210,7782942
2005-03-17,2005,168,W,1,1,27503,4382320,11302044,19138,3090348,7782942
2005-03-18,2005,169,W,1,1,26892,4409212,11302044,17980,3108328,7782942
2005-03-19,2005,170,W,1,1,30552,4439764,11302044,23846,3132174,7782942
2005-03-20,2005,171,W,1,1,33433,4473197,11302044,27204,3159378,7782942
2005-03-21,2005,172,W,1,1,34641,4507838,11302044,29263,3188641,7782942
2005-03-22,2005,173,W,1,1,38567,4546405,11302044,38057,3226698,7782942
2005-03-23,2005,174,W,1,1,52480,4598885,11302044,53138,3279836,7782942
2005-03-24,2005,175,W,1,1,63648,4662533,11302044,62171,3342007,7782942
2005-03-25,2005,176,W,1,1,73324,4735857,11302044,71870,3413877,7782942
2005-03-26,2005,177,W,1,1,73976,4809833,11302044,71347,3485224,7782942
2005-03-27,2005,178,W,1,1,72405,4882238,11302044,65886,3551110,7782942
2005-03-28,2005,179,W,1,1,70908,4953146,11302044,63941,3615051,7782942
2005-03-29,2005,180,W,1,1,66025,5019171,11302044,60039,3675090,7782942
2005-03-30,2005,181,W,1,1,63429,5082600,11302044,57522,3732612,7782942
2005-03-31,2005,182,W,1,1,60545,5143145,11302044,54422,3787034,7782942
2005-04-01,2005,183,W,1,1,56872,5200017,11302044,50109,3837143,7782942
2005-04-02,2005,184,W,1,1,52466,5252483,11302044,45371,3882514,7782942
2005-04-03,2005,185,W,1,1,49163,5301646,11302044,42050,3924564,7782942
2005-04-04,2005,186,W,1,1,47692,5349338,11302044,39406,3963970,7782942
2005-04-05,2005,187,W,1,1,45558,5394896,11302044,37366,4001336,7782942
2005-04-06,2005,188,W,1,1,43619,5438515,11302044,34894,4036230,7782942
2005-04-07,2005,189,W,1,1,41782,5480297,11302044,33034,4069264,7782942
2005-04-08,2005,190,W,1,1,40514,5520811,11302044,32936,4102200,7782942
2005-04-09,2005,191,W,1,1,40543,5561354,11302044,34069,4136269,7782942
2005-04-10,2005,192,W,1,1,40618,5601972,11302044,34153,4170422,7782942
2005-04-11,2005,193,W,1,1,41393,5643365,11302044,34958,4205380,7782942
2005-04-12,2005,194,W,1,1,40569,5683934,11302044,34129,4239509,7782942
2005-04-13,2005,195,W,1,1,39659,5723593,11302044,30453,4269962,7782942
2005-04-14,2005,196,W,1,1,38031,5761624,11302044,28860,4298822,7782942
2005-04-15,2005,197,W,1,1,36291,5797915,11302044,26508,4325330,7782942
2005-04-16,2005,198,W,1,1,35687,5833602,11302044,25732,4351062,7782942
2005-04-17,2005,199,W,1,1,33889,5867491,11302044,25937,4376999,7782942
2005-04-18,2005,200,W,1,1,33029,5900520,11302044,26694,4403693,7782942
2005-04-19,2005,201,W,1,1,31756,5932276,11302044,25367,4429060,7782942
2005-04-20,2005,202,W,1,1,30665,5962941,11302044,24302,4453362,7782942
2005-04-21,2005,203,W,1,1,29761,5992702,11302044,23451,4476813,7782942
2005-04-22,2005,204,W,1,1,27932,6020634,11302044,21741,4498554,7782942
2005-04-23,2005,205,W,1,1,27783,6048417,11302044,22513,4521067,7782942
2005-04-24,2005,206,W,1,1,26629,6075046,11302044,21458,4542525,7782942
2005-04-25,2005,207,W,1,1,26042,6101088,11302044,21067,4563592,7782942
2005-04-26,2005,208,W,1,1,25405,6126493,11302044,20346,4583938,7782942
2005-04-27,2005,209,W,1,1,25331,6151824,11302044,23357,4607295,7782942
2005-04-28,2005,210,W,1,1,26588,6178412,11302044,25486,4632781,7782942
2005-04-29,2005,211,W,1,1,27202,6205614,11302044,25917,4658698,7782942
2005-04-30,2005,212,W,1,1,26734,6232348,11302044,25427,4684125,7782942
2005-05-01,2005,213,W,1,1,26669,6259017,11302044,26545,4710670,7782942
2005-05-02,2005,214,W,1,1,26471,6285488,11302044,23692,4734362,7782942
2005-05-03,2005,215,W,1,1,26481,6311969,11302044,22026,4756388,7782942
2005-05-04,2005,216,W,1,1,25950,6337919,11302044,23436,4779824,7782942
2005-05-05,2005,217,W,1,1,25708,6363627,11302044,23942,4803766,7782942
2005-05-06,2005,218,W,1,1,26782,6390409,11302044,25079,4828845,7782942
2005-05-07,2005,219,W,1,1,28670,6419079,11302044,26825,4855670,7782942
2005-05-08,2005,220,W,1,1,31656,6450735,11302044,31670,4887340,7782942
2005-05-09,2005,221,W,1,1,35018,6485753,11302044,34272,4921612,7782942
2005-05-10,2005,222,W,1,1,39825,6525578,11302044,37543,4959155,7782942
2005-05-11,2005,223,W,1,1,49453,6575031,11302044,47121,5006276,7782942
2005-05-12,2005,224,W,1,1,52696,6627727,11302044,50322,5056598,7782942
2005-05-13,2005,225,W,1,1,55146,6682873,11302044,50953,5107551,7782942
2005-05-14,2005,226,W,1,1,55450,6738323,11302044,50489,5158040,7782942
2005-05-15,2005,227,W,1,1,55038,6793361,11302044,50091,5208131,7782942
2005-05-16,2005,228,W,1,1,54383,6847744,11302044,49479,5257610,7782942
2005-05-17,2005,229,W,1,1,54951,6902695,11302044,50007,5307617,7782942
2005-05-18,2005,230,W,1,1,57193,6959888,11302044,52269,5359886,7782942
2005-05-19,2005,231,W,1,1,61401,7021289,11302044,56368,5416254,7782942
2005-05-20,2005,232,W,1,1,81491,7102780,11302044,76413,5492667,7782942
2005-05-21,2005,233,W,1,1,91116,7193896,11302044,86026,5578693,7782942
2005-05-22,2005,234,W,1,1,96839,7290735,11302044,91682,5670375,7782942
2005-05-23,2005,235,W,1,1,95465,7386200,11302044,90260,5760635,7782942
2005-05-24,2005,236,W,1,1,90268,7476468,11302044,84952,5845587,7782942
2005-05-25,2005,237,W,1,1,84681,7561149,11302044,79299,5924886,7782942
2005-05-26,2005,238,W,1,1,78674,7639823,11302044,71311,5996197,7782942
2005-05-27,2005,239,W,1,1,71981,7711804,11302044,62616,6058813,7782942
2005-05-28,2005,240,W,1,1,65583,7777387,11302044,56164,6114977,7782942
2005-05-29,2005,241,W,1,1,60182,7837569,11302044,50740,6165717,7782942
2005-05-30,2005,242,W,1,1,58740,7896309,11302044,49247,6214964,7782942
2005-05-31,2005,243,W,1,1,60307,7956616,11302044,50135,6265099,7782942
2005-06-01,2005,244,W,1,1,59450,8016066,11302044,48887,6313986,7782942
2005-06-02,2005,245,W,1,1,58047,8074113,11302044,47440,6361426,7782942
2005-06-03,2005,246,W,1,1,56996,8131109,11302044,46295,6407721,7782942
2005-06-04,2005,247,W,1,1,54266,8185375,11302044,43450,6451171,7782942
2005-06-05,2005,248,W,1,1,50837,8236212,11302044,38020,6489191,7782942
2005-06-06,2005,249,W,1,1,48392,8284604,11302044,36018,6525209,7782942
2005-06-07,2005,250,W,1,1,46038,8330642,11302044,33120,6558329,7782942
2005-06-08,2005,251,W,1,1,44710,8375352,11302044,32468,6590797,7782942
2005-06-09,2005,252,W,1,1,43594,8418946,11302044,30369,6621166,7782942
2005-06-10,2005,253,W,1,1,43751,8462697,11302044,30188,6651354,7782942
2005-06-11,2005,254,W,1,1,45196,8507893,11302044,31666,6683020,7782942
2005-06-12,2005,255,W,1,1,46162,8554055,11302044,32574,6715594,7782942
2005-06-13,2005,256,W,1,1,45455,8599510,11302044,31096,6746690,7782942
2005-06-14,2005,257,W,1,1,44091,8643601,11302044,28942,6775632,7782942
2005-06-15,2005,258,W,1,1,42140,8685741,11302044,26995,6802627,7782942
2005-06-16,2005,259,W,1,1,40028,8725769,11302044,24855,6827482,7782942
2005-06-17,2005,260,W,1,1,40125,8765894,11302044,25106,6852588,7782942
2005-06-18,2005,261,W,1,1,41091,8806985,11302044,26557,6879145,7782942
2005-06-19,2005,262,W,1,1,41054,8848039,11302044,26378,6905523,7782942
2005-06-20,2005,263,W,1,1,40675,8888714,11302044,26575,6932098,7782942
2005-06-21,2005,264,W,1,1,39456,8928170,11302044,29778,6961876,7782942
2005-06-22,2005,265,W,1,1,37616,8965786,11302044,28749,6990625,7782942
2005-06-23,2005,266,W,1,1,35018,9000804,11302044,19903,7010528,7782942
2005-06-24,2005,267,W,1,1,32187,9032991,11302044,16651,7027179,7782942
2005-06-25,2005,268,W,1,1,30251,9063242,11302044,14683,7041862,7782942
2005-06-26,2005,269,W,1,1,29361,9092603,11302044,13860,7055722,7782942
2005-06-27,2005,270,W,1,1,28451,9121054,11302044,12930,7068652,7782942
2005-06-28,2005,271,W,1,1,27991,9149045,11302044,12495,7081147,7782942
2005-06-29,2005,272,W,1,1,27126,9176171,11302044,11432,7092579,7782942
2005-06-30,2005,273,W,1,1,27306,9203477,11302044,11562,7104141,7782942
2005-07-01,2005,274,W,1,1,26660,9230137,11302044,10530,7114671,7782942
2005-07-02,2005,275,W,1,1,25953,9256090,11302044,9779,7124450,7782942
2005-07-03,2005,276,W,1,1,26553,9282643,11302044,10318,7134768,7782942
2005-07-04,2005,277,W,1,1,27381,9310024,11302044,11135,7145903,7782942
2005-07-05,2005,278,W,1,1,27539,9337563,11302044,11316,7157219,7782942
2005-07-06,2005,279,W,1,1,27497,9365060,11302044,11265,7168484,7782942
2005-07-07,2005,280,W,1,1,26854,9391914,11302044,10605,7179089,7782942
2005-07-08,2005,281,W,1,1,26488,9418402,11302044,10148,7189237,7782942
2005-07-09,2005,282,W,1,1,26088,9444490,11302044,9752,7198989,7782942
2005-07-10,2005,283,W,1,1,26249,9470739,11302044,9971,7208960,7782942
2005-07-11,2005,284,W,1,1,25846,9496585,11302044,9408,7218368,7782942
2005-07-12,2005,285,W,1,1,25198,9521783,11302044,8927,7227295,7782942
2005-07-13,2005,286,W,1,1,24734,9546517,11302044,8726,7236021,7782942
2005-07-14,2005,287,W,1,1,25098,9571615,11302044,8710,7244731,7782942
2005-07-15,2005,288,W,1,1,26020,9597635,11302044,9678,7254409,7782942
2005-07-16,2005,289,W,1,1,26582,9624217,11302044,10225,7264634,7782942
2005-07-17,2005,290,W,1,1,26168,9650385,11302044,9841,7274475,7782942
2005-07-18,2005,291,W,1,1,25978,9676363,11302044,9628,7284103,7782942
2005-07-19,2005,292,W,1,1,25838,9702201,11302044,9628,7293731,7782942
2005-07-20,2005,293,W,1,1,25581,9727782,11302044,9604,7303335,7782942
2005-07-21,2005,294,W,1,1,25251,9753033,11302044,9047,7312382,7782942
2005-07-22,2005,295,W,1,1,25518,9778551,11302044,9442,7321824,7782942
2005-07-23,2005,296,W,1,1,25412,9803963,11302044,9203,7331027,7782942
2005-07-24,2005,297,W,1,1,25281,9829244,11302044,9012,7340039,7782942
2005-07-25,2005,298,W,1,1,25158,9854402,11302044,9033,7349072,7782942
2005-07-26,2005,299,W,1,1,24732,9879134,11302044,8614,7357686,7782942
2005-07-27,2005,300,W,1,1,24542,9903676,11302044,8428,7366114,7782942
2005-07-28,2005,301,W,1,1,24298,9927974,11302044,8232,7374346,7782942
2005-07-29,2005,302,W,1,1,23839,9951813,11302044,7750,7382096,7782942
2005-07-30,2005,303,W,1,1,23517,9975330,11302044,7471,7389567,7782942
2005-07-31,2005,304,W,1,1,23259,9998589,11302044,7247,7396814,7782942
2005-08-01,2005,305,W,1,1,22851,10021440,11302044,6874,7403688,7782942
2005-08-02,2005,306,W,1,1,22617,10044057,11302044,6620,7410308,7782942
2005-08-03,2005,307,W,1,1,22495,10066552,11302044,6520,7416828,7782942
2005-08-04,2005,308,W,1,1,22286,10088838,11302044,6277,7423105,7782942
2005-08-05,2005,309,W,1,1,22483,10111321,11302044,6503,7429608,7782942
2005-08-06,2005,310,W,1,1,22201,10133522,11302044,6216,7435824,7782942
2005-08-07,2005,311,W,1,1,21974,10155496,11302044,6035,7441859,7782942
2005-08-08,2005,312,W,1,1,21885,10177381,11302044,5992,7447851,7782942
2005-08-09,2005,313,W,1,1,21976,10199357,11302044,6000,7453851,7782942
2005-08-10,2005,314,W,1,1,22005,10221362,11302044,6065,7459916,7782942
2005-08-11,2005,315,W,1,1,22173,10243535,11302044,6990,7466906,7782942
2005-08-12,2005,316,W,1,1,20989,10264524,11302044,5117,7472023,7782942
2005-08-13,2005,317,W,1,1,19712,10284236,11302044,3899,7475922,7782942
2005-08-14,2005,318,W,1,1,19856,10304092,11302044,4153,7480075,7782942
2005-08-15,2005,319,W,1,1,20360,10324452,11302044,4565,7484640,7782942
2005-08-16,2005,320,W,1,1,20801,10345253,11302044,5054,7489694,7782942
2005-08-17,2005,321,W,1,1,20533,10365786,11302044,4856,7494550,7782942
2005-08-18,2005,322,W,1,1,20393,10386179,11302044,4789,7499339,7782942
2005-08-19,2005,323,W,1,1,20882,10407061,11302044,5301,7504640,7782942
2005-08-20,2005,324,W,1,1,20970,10428031,11302044,5592,7510232,7782942
2005-08-21,2005,325,W,1,1,21136,10449167,11302044,5531,7515763,7782942
2005-08-22,2005,326,W,1,1,21163,10470330,11302044,5637,7521400,7782942
2005-08-23,2005,327,W,1,1,21037,10491367,11302044,5513,7526913,7782942
2005-08-24,2005,328,W,1,1,20783,10512150,11302044,5319,7532232,7782942
2005-08-25,2005,329,W,1,1,21323,10533473,11302044,5947,7538179,7782942
2005-08-26,2005,330,W,1,1,21402,10554875,11302044,6049,7544228,7782942
2005-08-27,2005,331,W,1,1,21143,10576018,11302044,5817,7550045,7782942
2005-08-28,2005,332,W,1,1,21000,10597018,11302044,5682,7555727,7782942
2005-08-29,2005,333,W,1,1,20631,10617649,11302044,5321,7561048,7782942
2005-08-30,2005,334,W,1,1,20410,10638059,11302044,5204,7566252,7782942
2005-08-31,2005,335,W,1,1,20331,10658390,11302044,5160,7571412,7782942
2005-09-01,2005,336,W,1,1,20230,10678620,11302044,5087,7576499,7782942
2005-09-02,2005,337,W,1,1,20813,10699433,11302044,5706,7582205,7782942
2005-09-03,2005,338,W,1,1,21005,10720438,11302044,5998,7588203,7782942
2005-09-04,2005,339,W,1,1,21218,10741656,11302044,6304,7594507,7782942
2005-09-05,2005,340,W,1,1,21478,10763134,11302044,6576,7601083,7782942
2005-09-06,2005,341,W,1,1,21079,10784213,11302044,6222,7607305,7782942
2005-09-07,2005,342,W,1,1,21252,10805465,11302044,6830,7614135,7782942
2005-09-08,2005,343,W,1,1,21304,10826769,11302044,6605,7620740,7782942
2005-09-09,2005,344,W,1,1,21677,10848446,11302044,6987,7627727,7782942
2005-09-10,2005,345,W,1,1,22454,10870900,11302044,7806,7635533,7782942
2005-09-11,2005,346,W,1,1,22323,10893223,11302044,7728,7643261,7782942
2005-09-12,2005,347,W,1,1,22658,10915881,11302044,8117,7651378,7782942
2005-09-13,2005,348,W,1,1,22667,10938548,11302044,8142,7659520,7782942
2005-09-14,2005,349,W,1,1,22586,10961134,11302044,8152,7667672,7782942
2005-09-15,2005,350,W,1,1,21925,10983059,11302044,7482,7675154,7782942
2005-09-16,2005,351,W,1,1,21543,11004602,11302044,7169,7682323,7782942
2005-09-17,2005,352,W,1,1,22436,11027038,11302044,8038,7690361,7782942
2005-09-18,2005,353,W,1,1,22343,11049381,11302044,8015,7698376,7782942
2005-09-19,2005,354,W,1,1,22075,11071456,11302044,8156,7706532,7782942
2005-09-20,2005,355,W,1,1,20963,11092419,11302044,6928,7713460,7782942
2005-09-21,2005,356,W,1,1,21238,11113657,11302044,6980,7720440,7782942
2005-09-22,2005,357,W,1,1,20991,11134648,11302044,6870,7727310,7782942
2005-09-23,2005,358,W,1,1,20328,11154976,11302044,6269,7733579,7782942
2005-09-24,2005,359,W,1,1,20720,11175696,11302044,6683,7740262,7782942
2005-09-25,2005,360,W,1,1,21110,11196806,11302044,7088,7747350,7782942
2005-09-26,2005,361,W,1,1,21146,11217952,11302044,7139,7754489,7782942
2005-09-27,2005,362,W,1,1,21416,11239368,11302044,7403,7761892,7782942
2005-09-28,2005,363,W,1,1,21227,11260595,11302044,7577,7769469,7782942
2005-09-29,2005,364,W,1,1,20804,11281399,11302044,6812,7776281,7782942
2005-09-30,2005,365,W,1,1,20645,11302044,11302044,6661,7782942,7782942
2005-10-01,2006,1,W,2,2,20198,20198,24443164,6736,6736,20949945
2005-10-02,2006,2,W,2,2,20661,40859,24443164,7263,13999,20949945
2005-10-03,2006,3,W,2,2,20425,61284,24443164,7015,21014,20949945
2005-10-04,2006,4,W,2,2,20450,81734,24443164,7035,28049,20949945
2005-10-05,2006,5,W,2,2,19997,101731,24443164,6674,34723,20949945
2005-10-06,2006,6,W,2,2,19570,121301,24443164,6214,40937,20949945
2005-10-07,2006,7,W,2,2,19149,140450,24443164,5876,46813,20949945
2005-10-08,2006,8,W,2,2,19010,159460,24443164,5710,52523,20949945
2005-10-09,2006,9,W,2,2,18864,178324,24443164,5577,58100,20949945
2005-10-10,2006,10,W,2,2,18563,196887,24443164,5326,63426,20949945
2005-10-11,2006,11,W,2,2,17992,214879,24443164,4658,68084,20949945
2005-10-12,2006,12,W,2,2,18000,232879,24443164,4857,72941,20949945
2005-10-13,2006,13,W,2,2,17784,250663,24443164,4813,77754,20949945
2005-10-14,2006,14,W,2,2,17415,268078,24443164,4187,81941,20949945
2005-10-15,2006,15,W,2,2,17643,285721,24443164,4426,86367,20949945
2005-10-16,2006,16,W,2,2,17162,302883,24443164,4367,90734,20949945
2005-10-17,2006,17,W,2,2,16355,319238,24443164,3179,93913,20949945
2005-10-18,2006,18,W,2,2,15294,334532,24443164,2182,96095,20949945
2005-10-19,2006,19,W,2,2,15745,350277,24443164,2693,98788,20949945
2005-10-20,2006,20,W,2,2,15089,365366,24443164,1988,100776,20949945
2005-10-21,2006,21,W,2,2,15038,380404,24443164,2007,102783,20949945
2005-10-22,2006,22,W,2,2,14667,395071,24443164,2500,105283,20949945
2005-10-23,2006,23,W,2,2,14925,409996,24443164,3089,108372,20949945
2005-10-24,2006,24,W,2,2,15054,425050,24443164,3833,112205,20949945
2005-10-25,2006,25,W,2,2,15163,440213,24443164,2866,115071,20949945
2005-10-26,2006,26,W,2,2,15345,455558,24443164,3141,118212,20949945
2005-10-27,2006,27,W,2,2,15926,471484,24443164,4343,122555,20949945
2005-10-28,2006,28,W,2,2,15436,486920,24443164,3569,126124,20949945
2005-10-29,2006,29,W,2,2,15433,502353,24443164,3763,129887,20949945
2005-10-30,2006,30,W,2,2,16114,518467,24443164,4690,134577,20949945
2005-10-31,2006,31,W,2,2,15992,534459,24443164,3906,138483,20949945
2005-11-01,2006,32,W,2,2,15634,550093,24443164,2789,141272,20949945
2005-11-02,2006,33,W,2,2,15269,565362,24443164,3370,144642,20949945
2005-11-03,2006,34,W,2,2,15745,581107,24443164,4126,148768,20949945
2005-11-04,2006,35,W,2,2,15590,596697,24443164,3180,151948,20949945
2005-11-05,2006,36,W,2,2,15658,612355,24443164,5496,157444,20949945
2005-11-06,2006,37,W,2,2,15513,627868,24443164,4671,162115,20949945
2005-11-07,2006,38,W,2,2,15528,643396,24443164,3048,165163,20949945
2005-11-08,2006,39,W,2,2,16089,659485,24443164,5237,170400,20949945
2005-11-09,2006,40,W,2,2,16242,675727,24443164,4814,175214,20949945
2005-11-10,2006,41,W,2,2,19700,695427,24443164,7152,182366,20949945
2005-11-11,2006,42,W,2,2,20041,715468,24443164,7502,189868,20949945
2005-11-12,2006,43,W,2,2,18497,733965,24443164,6542,196410,20949945
2005-11-13,2006,44,W,2,2,16958,750923,24443164,4208,200618,20949945
2005-11-14,2006,45,W,2,2,16230,767153,24443164,3470,204088,20949945
2005-11-15,2006,46,W,2,2,15869,783022,24443164,3013,207101,20949945
2005-11-16,2006,47,W,2,2,15800,798822,24443164,3582,210683,20949945
2005-11-17,2006,48,W,2,2,15822,814644,24443164,4096,214779,20949945
2005-11-18,2006,49,W,2,2,15742,830386,24443164,4463,219242,20949945
2005-11-19,2006,50,W,2,2,15716,846102,24443164,4652,223894,20949945
2005-11-20,2006,51,W,2,2,15578,861680,24443164,4788,228682,20949945
2005-11-21,2006,52,W,2,2,15333,877013,24443164,4530,233212,20949945
2005-11-22,2006,53,W,2,2,15031,892044,24443164,4250,237462,20949945
2005-11-23,2006,54,W,2,2,15176,907220,24443164,5027,242489,20949945
2005-11-24,2006,55,W,2,2,15673,922893,24443164,5509,247998,20949945
2005-11-25,2006,56,W,2,2,15711,938604,24443164,5978,253976,20949945
2005-11-26,2006,57,W,2,2,16142,954746,24443164,6456,260432,20949945
2005-11-27,2006,58,W,2,2,16069,970815,24443164,6313,266745,20949945
2005-11-28,2006,59,W,2,2,16552,987367,24443164,7159,273904,20949945
2005-11-29,2006,60,W,2,2,16578,1003945,24443164,7269,281173,20949945
2005-11-30,2006,61,W,2,2,17379,1021324,24443164,7570,288743,20949945
2005-12-01,2006,62,W,2,2,17929,1039253,24443164,10802,299545,20949945
2005-12-02,2006,63,W,2,2,22118,1061371,24443164,15242,314787,20949945
2005-12-03,2006,64,W,2,2,26416,1087787,24443164,19115,333902,20949945
2005-12-04,2006,65,W,2,2,30909,1118696,24443164,25552,359454,20949945
2005-12-05,2006,66,W,2,2,28165,1146861,24443164,20717,380171,20949945
2005-12-06,2006,67,W,2,2,24092,1170953,24443164,12322,392493,20949945
2005-12-07,2006,68,W,2,2,21382,1192335,24443164,8214,400707,20949945
2005-12-08,2006,69,W,2,2,19700,1212035,24443164,6576,407283,20949945
2005-12-09,2006,70,W,2,2,18700,1230735,24443164,5548,412831,20949945
2005-12-10,2006,71,W,2,2,17892,1248627,24443164,4975,417806,20949945
2005-12-11,2006,72,W,2,2,17373,1266000,24443164,4181,421987,20949945
2005-12-12,2006,73,W,2,2,17242,1283242,24443164,4062,426049,20949945
2005-12-13,2006,74,W,2,2,17210,1300452,24443164,4446,430495,20949945
2005-12-14,2006,75,W,2,2,16995,1317447,24443164,4215,434710,20949945
2005-12-15,2006,76,W,2,2,16867,1334314,24443164,4083,438793,20949945
2005-12-16,2006,77,W,2,2,16633,1350947,24443164,3802,442595,20949945
2005-12-17,2006,78,W,2,2,16328,1367275,24443164,5794,448389,20949945
2005-12-18,2006,79,W,2,2,17765,1385040,24443164,16668,465057,20949945
2005-12-19,2006,80,W,2,2,22117,1407157,24443164,20058,485115,20949945
2005-12-20,2006,81,W,2,2,26688,1433845,24443164,23485,508600,20949945
2005-12-21,2006,82,W,2,2,35744,1469589,24443164,35084,543684,20949945
2005-12-22,2006,83,W,2,2,44446,1514035,24443164,43324,587008,20949945
2005-12-23,2006,84,W,2,2,51787,1565822,24443164,43541,630549,20949945
2005-12-24,2006,85,W,2,2,61680,1627502,24443164,53126,683675,20949945
2005-12-25,2006,86,W,2,2,79536,1707038,24443164,72508,756183,20949945
2005-12-26,2006,87,W,2,2,97579,1804617,24443164,89560,845743,20949945
2005-12-27,2006,88,W,2,2,116804,1921421,24443164,106118,951861,20949945
2005-12-28,2006,89,W,2,2,132174,2053595,24443164,123366,1075227,20949945
2005-12-29,2006,90,W,2,2,154572,2208167,24443164,145626,1220853,20949945
2005-12-30,2006,91,W,2,2,170364,2378531,24443164,159808,1380661,20949945
2005-12-31,2006,92,W,2,2,240657,2619188,24443164,235781,1616442,20949945
2006-01-01,2006,93,W,2,2,352586,2971774,24443164,350249,1966691,20949945
2006-01-02,2006,94,W,2,2,364182,3335956,24443164,365755,2332446,20949945
2006-01-03,2006,95,W,2,2,361075,3697031,24443164,368424,2700870,20949945
2006-01-04,2006,96,W,2,2,332493,4029524,24443164,337980,3038850,20949945
2006-01-05,2006,97,W,2,2,291103,4320627,24443164,289996,3328846,20949945
2006-01-06,2006,98,W,2,2,249374,4570001,24443164,248926,3577772,20949945
2006-01-07,2006,99,W,2,2,214028,4784029,24443164,205364,3783136,20949945
2006-01-08,2006,100,W,2,2,193899,4977928,24443164,185224,3968360,20949945
2006-01-09,2006,101,W,2,2,179516,5157444,24443164,171902,4140262,20949945
2006-01-10,2006,102,W,2,2,165709,5323153,24443164,156278,4296540,20949945
2006-01-11,2006,103,W,2,2,153196,5476349,24443164,143982,4440522,20949945
2006-01-12,2006,104,W,2,2,138707,5615056,24443164,131313,4571835,20949945
2006-01-13,2006,105,W,2,2,127897,5742953,24443164,120734,4692569,20949945
2006-01-14,2006,106,W,2,2,123028,5865981,24443164,118650,4811219,20949945
2006-01-15,2006,107,W,2,2,119521,5985502,24443164,113985,4925204,20949945
2006-01-16,2006,108,W,2,2,116531,6102033,24443164,111452,5036656,20949945
2006-01-17,2006,109,W,2,2,115857,6217890,24443164,111186,5147842,20949945
2006-01-18,2006,110,W,2,2,113504,6331394,24443164,111302,5259144,20949945
2006-01-19,2006,111,W,2,2,107021,6438415,24443164,102083,5361227,20949945
2006-01-20,2006,112,W,2,2,100436,6538851,24443164,94463,5455690,20949945
2006-01-21,2006,113,W,2,2,92039,6630890,24443164,85923,5541613,20949945
2006-01-22,2006,114,W,2,2,83390,6714280,24443164,77032,5618645,20949945
2006-01-23,2006,115,W,2,2,78092,6792372,24443164,69744,5688389,20949945
2006-01-24,2006,116,W,2,2,73498,6865870,24443164,65365,5753754,20949945
2006-01-25,2006,117,W,2,2,69393,6935263,24443164,62319,5816073,20949945
2006-01-26,2006,118,W,2,2,64757,7000020,24443164,58044,5874117,20949945
2006-01-27,2006,119,W,2,2,60855,7060875,24443164,53828,5927945,20949945
2006-01-28,2006,120,W,2,2,58499,7119374,24443164,51848,5979793,20949945
2006-01-29,2006,121,W,2,2,57387,7176761,24443164,51333,6031126,20949945
2006-01-30,2006,122,W,2,2,58206,7234967,24443164,53453,6084579,20949945
2006-01-31,2006,123,W,2,2,60076,7295043,24443164,55416,6139995,20949945
2006-02-01,2006,124,W,2,2,64719,7359762,24443164,58254,6198249,20949945
2006-02-02,2006,125,W,2,2,68369,7428131,24443164,60617,6258866,20949945
2006-02-03,2006,126,W,2,2,71604,7499735,24443164,63621,6322487,20949945
2006-02-04,2006,127,W,2,2,75098,7574833,24443164,65297,6387784,20949945
2006-02-05,2006,128,W,2,2,82532,7657365,24443164,73298,6461082,20949945
2006-02-06,2006,129,W,2,2,89275,7746640,24443164,79902,6540984,20949945
2006-02-07,2006,130,W,2,2,93758,7840398,24443164,85475,6626459,20949945
2006-02-08,2006,131,W,2,2,93239,7933637,24443164,83882,6710341,20949945
2006-02-09,2006,132,W,2,2,90120,8023757,24443164,80292,6790633,20949945
2006-02-10,2006,133,W,2,2,85514,8109271,24443164,75717,6866350,20949945
2006-02-11,2006,134,W,2,2,82318,8191589,24443164,72531,6938881,20949945
2006-02-12,2006,135,W,2,2,74717,8266306,24443164,64928,7003809,20949945
2006-02-13,2006,136,W,2,2,67305,8333611,24443164,57907,7061716,20949945
2006-02-14,2006,137,W,2,2,61866,8395477,24443164,51840,7113556,20949945
2006-02-15,2006,138,W,2,2,57162,8452639,24443164,45711,7159267,20949945
2006-02-16,2006,139,W,2,2,53010,8505649,24443164,41584,7200851,20949945
2006-02-17,2006,140,W,2,2,49932,8555581,24443164,39290,7240141,20949945
2006-02-18,2006,141,W,2,2,46826,8602407,24443164,37113,7277254,20949945
2006-02-19,2006,142,W,2,2,44166,8646573,24443164,34520,7311774,20949945
2006-02-20,2006,143,W,2,2,41878,8688451,24443164,32281,7344055,20949945
2006-02-21,2006,144,W,2,2,40379,8728830,24443164,30686,7374741,20949945
2006-02-22,2006,145,W,2,2,38715,8767545,24443164,27618,7402359,20949945
2006-02-23,2006,146,W,2,2,36668,8804213,24443164,25164,7427523,20949945
2006-02-24,2006,147,W,2,2,36530,8840743,24443164,25024,7452547,20949945
2006-02-25,2006,148,W,2,2,38398,8879141,24443164,26975,7479522,20949945
2006-02-26,2006,149,W,2,2,39547,8918688,24443164,30381,7509903,20949945
2006-02-27,2006,150,W,2,2,42349,8961037,24443164,36546,7546449,20949945
2006-02-28,2006,151,W,2,2,56587,9017624,24443164,53161,7599610,20949945
2006-03-01,2006,152,W,2,2,76270,9093894,24443164,72560,7672170,20949945
2006-03-02,2006,153,W,2,2,100801,9194695,24443164,97867,7770037,20949945
2006-03-03,2006,154,W,2,2,126303,9320998,24443164,122082,7892119,20949945
2006-03-04,2006,155,W,2,2,128252,9449250,24443164,122224,8014343,20949945
2006-03-05,2006,156,W,2,2,121167,9570417,24443164,117133,8131476,20949945
2006-03-06,2006,157,W,2,2,133854,9704271,24443164,133340,8264816,20949945
2006-03-07,2006,158,W,2,2,157255,9861526,24443164,155962,8420778,20949945
2006-03-08,2006,159,W,2,2,170512,10032038,24443164,168272,8589050,20949945
2006-03-09,2006,160,W,2,2,177014,10209052,24443164,175262,8764312,20949945
2006-03-10,2006,161,W,2,2,165193,10374245,24443164,161617,8925929,20949945
2006-03-11,2006,162,W,2,2,143552,10517797,24443164,136521,9062450,20949945
2006-03-12,2006,163,W,2,2,124763,10642560,24443164,121642,9184092,20949945
2006-03-13,2006,164,W,2,2,115682,10758242,24443164,112869,9296961,20949945
2006-03-14,2006,165,W,2,2,113719,10871961,24443164,112495,9409456,20949945
2006-03-15,2006,166,W,2,2,114074,10986035,24443164,112404,9521860,20949945
2006-03-16,2006,167,W,2,2,111946,11097981,24443164,110615,9632475,20949945
2006-03-17,2006,168,W,2,2,109242,11207223,24443164,103911,9736386,20949945
2006-03-18,2006,169,W,2,2,107219,11314442,24443164,101765,9838151,20949945
2006-03-19,2006,170,W,2,2,104389,11418831,24443164,97716,9935867,20949945
2006-03-20,2006,171,W,2,2,103887,11522718,24443164,98084,10033951,20949945
2006-03-21,2006,172,W,2,2,102878,11625596,24443164,96879,10130830,20949945
2006-03-22,2006,173,W,2,2,99435,11725031,24443164,94886,10225716,20949945
2006-03-23,2006,174,W,2,2,94411,11819442,24443164,90979,10316695,20949945
2006-03-24,2006,175,W,2,2,90839,11910281,24443164,87624,10404319,20949945
2006-03-25,2006,176,W,2,2,93064,12003345,24443164,92131,10496450,20949945
2006-03-26,2006,177,W,2,2,104327,12107672,24443164,103110,10599560,20949945
2006-03-27,2006,178,W,2,2,113142,12220814,24443164,113752,10713312,20949945
2006-03-28,2006,179,W,2,2,113044,12333858,24443164,113596,10826908,20949945
2006-03-29,2006,180,W,2,2,115744,12449602,24443164,116482,10943390,20949945
2006-03-30,2006,181,W,2,2,116852,12566454,24443164,114799,11058189,20949945
2006-03-31,2006,182,W,2,2,119374,12685828,24443164,118614,11176803,20949945
2006-04-01,2006,183,W,2,2,125778,12811606,24443164,123214,11300017,20949945
2006-04-02,2006,184,W,2,2,130886,12942492,24443164,130820,11430837,20949945
2006-04-03,2006,185,W,2,2,144650,13087142,24443164,149259,11580096,20949945
2006-04-04,2006,186,W,2,2,205205,13292347,24443164,214682,11794778,20949945
2006-04-05,2006,187,W,2,2,246005,13538352,24443164,255257,12050035,20949945
2006-04-06,2006,188,W,2,2,247711,13786063,24443164,256965,12307000,20949945
2006-04-07,2006,189,W,2,2,229293,14015356,24443164,236198,12543198,20949945
2006-04-08,2006,190,W,2,2,214663,14230019,24443164,216020,12759218,20949945
2006-04-09,2006,191,W,2,2,208997,14439016,24443164,204895,12964113,20949945
2006-04-10,2006,192,W,2,2,199817,14638833,24443164,196888,13161001,20949945
2006-04-11,2006,193,W,2,2,184275,14823108,24443164,181823,13342824,20949945
2006-04-12,2006,194,W,2,2,193094,15016202,24443164,192248,13535072,20949945
2006-04-13,2006,195,W,2,2,204451,15220653,24443164,203555,13738627,20949945
2006-04-14,2006,196,W,2,2,208161,15428814,24443164,207896,13946523,20949945
2006-04-15,2006,197,W,2,2,219730,15648544,24443164,218267,14164790,20949945
2006-04-16,2006,198,W,2,2,226345,15874889,24443164,224708,14389498,20949945
2006-04-17,2006,199,W,2,2,228962,16103851,24443164,225523,14615021,20949945
2006-04-18,2006,200,W,2,2,220545,16324396,24443164,216615,14831636,20949945
2006-04-19,2006,201,W,2,2,205139,16529535,24443164,201385,15033021,20949945
2006-04-20,2006,202,W,2,2,182985,16712520,24443164,179234,15212255,20949945
2006-04-21,2006,203,W,2,2,164176,16876696,24443164,157406,15369661,20949945
2006-04-22,2006,204,W,2,2,155177,17031873,24443164,147264,15516925,20949945
2006-04-23,2006,205,W,2,2,148132,17180005,24443164,140212,15657137,20949945
2006-04-24,2006,206,W,2,2,143502,17323507,24443164,137385,15794522,20949945
2006-04-25,2006,207,W,2,2,140337,17463844,24443164,133140,15927662,20949945
2006-04-26,2006,208,W,2,2,138726,17602570,24443164,132543,16060205,20949945
2006-04-27,2006,209,W,2,2,135735,17738305,24443164,129550,16189755,20949945
2006-04-28,2006,210,W,2,2,133637,17871942,24443164,126135,16315890,20949945
2006-04-29,2006,211,W,2,2,130756,18002698,24443164,122593,16438483,20949945
2006-04-30,2006,212,W,2,2,129588,18132286,24443164,121449,16559932,20949945
2006-05-01,2006,213,W,2,2,130248,18262534,24443164,122053,16681985,20949945
2006-05-02,2006,214,W,2,2,128409,18390943,24443164,120172,16802157,20949945
2006-05-03,2006,215,W,2,2,121670,18512613,24443164,117614,16919771,20949945
2006-05-04,2006,216,W,2,2,112809,18625422,24443164,108988,17028759,20949945
2006-05-05,2006,217,W,2,2,108727,18734149,24443164,104903,17133662,20949945
2006-05-06,2006,218,W,2,2,105486,18839635,24443164,101649,17235311,20949945
2006-05-07,2006,219,W,2,2,101179,18940814,24443164,97265,17332576,20949945
2006-05-08,2006,220,W,2,2,96831,19037645,24443164,93045,17425621,20949945
2006-05-09,2006,221,W,2,2,92252,19129897,24443164,88347,17513968,20949945
2006-05-10,2006,222,W,2,2,90487,19220384,24443164,86573,17600541,20949945
2006-05-11,2006,223,W,2,2,89717,19310101,24443164,85785,17686326,20949945
2006-05-12,2006,224,W,2,2,90354,19400455,24443164,86370,17772696,20949945
2006-05-13,2006,225,W,2,2,90453,19490908,24443164,86473,17859169,20949945
2006-05-14,2006,226,W,2,2,88839,19579747,24443164,84813,17943982,20949945
2006-05-15,2006,227,W,2,2,86529,19666276,24443164,82475,18026457,20949945
2006-05-16,2006,228,W,2,2,84892,19751168,24443164,80791,18107248,20949945
2006-05-17,2006,229,W,2,2,82239,19833407,24443164,78105,18185353,20949945
2006-05-18,2006,230,W,2,2,80952,19914359,24443164,72374,18257727,20949945
2006-05-19,2006,231,W,2,2,79392,19993751,24443164,70241,18327968,20949945
2006-05-20,2006,232,W,2,2,78018,20071769,24443164,69279,18397247,20949945
2006-05-21,2006,233,W,2,2,78100,20149869,24443164,71701,18468948,20949945
2006-05-22,2006,234,W,2,2,78063,20227932,24443164,73682,18542630,20949945
2006-05-23,2006,235,W,2,2,76337,20304269,24443164,71898,18614528,20949945
2006-05-24,2006,236,W,2,2,76643,20380912,24443164,72086,18686614,20949945
2006-05-25,2006,237,W,2,2,74856,20455768,24443164,70243,18756857,20949945
2006-05-26,2006,238,W,2,2,71488,20527256,24443164,64552,18821409,20949945
2006-05-27,2006,239,W,2,2,66812,20594068,24443164,57792,18879201,20949945
2006-05-28,2006,240,W,2,2,63893,20657961,24443164,54854,18934055,20949945
2006-05-29,2006,241,W,2,2,60540,20718501,24443164,51426,18985481,20949945
2006-05-30,2006,242,W,2,2,57615,20776116,24443164,48562,19034043,20949945
2006-05-31,2006,243,W,2,2,55319,20831435,24443164,46989,19081032,20949945
2006-06-01,2006,244,W,2,2,53648,20885083,24443164,46139,19127171,20949945
2006-06-02,2006,245,W,2,2,52269,20937352,24443164,45187,19172358,20949945
2006-06-03,2006,246,W,2,2,50972,20988324,24443164,40968,19213326,20949945
2006-06-04,2006,247,W,2,2,50519,21038843,24443164,39723,19253049,20949945
2006-06-05,2006,248,W,2,2,51557,21090400,24443164,40615,19293664,20949945
2006-06-06,2006,249,W,2,2,51322,21141722,24443164,40190,19333854,20949945
2006-06-07,2006,250,W,2,2,51529,21193251,24443164,41648,19375502,20949945
2006-06-08,2006,251,W,2,2,51668,21244919,24443164,42058,19417560,20949945
2006-06-09,2006,252,W,2,2,50827,21295746,24443164,41200,19458760,20949945
2006-06-10,2006,253,W,2,2,50486,21346232,24443164,40646,19499406,20949945
2006-06-11,2006,254,W,2,2,49868,21396100,24443164,40001,19539407,20949945
2006-06-12,2006,255,W,2,2,49700,21445800,24443164,39792,19579199,20949945
2006-06-13,2006,256,W,2,2,49689,21495489,24443164,39820,19619019,20949945
2006-06-14,2006,257,W,2,2,49173,21544662,24443164,39226,19658245,20949945
2006-06-15,2006,258,W,2,2,48641,21593303,24443164,38365,19696610,20949945
2006-06-16,2006,259,W,2,2,48882,21642185,24443164,38561,19735171,20949945
2006-06-17,2006,260,W,2,2,48228,21690413,24443164,37739,19772910,20949945
2006-06-18,2006,261,W,2,2,47357,21737770,24443164,36881,19809791,20949945
2006-06-19,2006,262,W,2,2,45444,21783214,24443164,35231,19845022,20949945
2006-06-20,2006,263,W,2,2,43343,21826557,24443164,33080,19878102,20949945
2006-06-21,2006,264,W,2,2,41709,21868266,24443164,31509,19909611,20949945
2006-06-22,2006,265,W,2,2,41773,21910039,24443164,27076,19936687,20949945
2006-06-23,2006,266,W,2,2,40719,21950758,24443164,25883,19962570,20949945
2006-06-24,2006,267,W,2,2,39839,21990597,24443164,25017,19987587,20949945
2006-06-25,2006,268,W,2,2,39944,22030541,24443164,25087,20012674,20949945
2006-06-26,2006,269,W,2,2,40412,22070953,24443164,25866,20038540,20949945
2006-06-27,2006,270,W,2,2,40242,22111195,24443164,25884,20064424,20949945
2006-06-28,2006,271,W,2,2,39199,22150394,24443164,24752,20089176,20949945
2006-06-29,2006,272,W,2,2,37623,22188017,24443164,26741,20115917,20949945
2006-06-30,2006,273,W,2,2,35532,22223549,24443164,24871,20140788,20949945
2006-07-01,2006,274,W,2,2,34566,22258115,24443164,19211,20159999,20949945
2006-07-02,2006,275,W,2,2,32437,22290552,24443164,16371,20176370,20949945
2006-07-03,2006,276,W,2,2,30573,22321125,24443164,14428,20190798,20949945
2006-07-04,2006,277,W,2,2,28788,22349913,24443164,12638,20203436,20949945
2006-07-05,2006,278,W,2,2,27942,22377855,24443164,11654,20215090,20949945
2006-07-06,2006,279,W,2,2,27744,22405599,24443164,11502,20226592,20949945
2006-07-07,2006,280,W,2,2,27416,22433015,24443164,11793,20238385,20949945
2006-07-08,2006,281,W,2,2,26470,22459485,24443164,10663,20249048,20949945
2006-07-09,2006,282,W,2,2,25645,22485130,24443164,9868,20258916,20949945
2006-07-10,2006,283,W,2,2,24482,22509612,24443164,8640,20267556,20949945
2006-07-11,2006,284,W,2,2,23776,22533388,24443164,7994,20275550,20949945
2006-07-12,2006,285,W,2,2,23766,22557154,24443164,7929,20283479,20949945
2006-07-13,2006,286,W,2,2,23679,22580833,24443164,8616,20292095,20949945
2006-07-14,2006,287,W,2,2,23298,22604131,24443164,7481,20299576,20949945
2006-07-15,2006,288,W,2,2,24081,22628212,24443164,8212,20307788,20949945
2006-07-16,2006,289,W,2,2,24628,22652840,24443164,8778,20316566,20949945
2006-07-17,2006,290,W,2,2,24890,22677730,24443164,9780,20326346,20949945
2006-07-18,2006,291,W,2,2,24911,22702641,24443164,9136,20335482,20949945
2006-07-19,2006,292,W,2,2,25019,22727660,24443164,9257,20344739,20949945
2006-07-20,2006,293,W,2,2,25316,22752976,24443164,9583,20354322,20949945
2006-07-21,2006,294,W,2,2,25237,22778213,24443164,9012,20363334,20949945
2006-07-22,2006,295,W,2,2,25275,22803488,24443164,9058,20372392,20949945
2006-07-23,2006,296,W,2,2,25484,22828972,24443164,9279,20381671,20949945
2006-07-24,2006,297,W,2,2,25904,22854876,24443164,9904,20391575,20949945
2006-07-25,2006,298,W,2,2,26208,22881084,24443164,10064,20401639,20949945
2006-07-26,2006,299,W,2,2,26130,22907214,24443164,10008,20411647,20949945
2006-07-27,2006,300,W,2,2,26354,22933568,24443164,10217,20421864,20949945
2006-07-28,2006,301,W,2,2,25970,22959538,24443164,9882,20431746,20949945
2006-07-29,2006,302,W,2,2,25304,22984842,24443164,9193,20440939,20949945
2006-07-30,2006,303,W,2,2,25109,23009951,24443164,9040,20449979,20949945
2006-07-31,2006,304,W,2,2,24873,23034824,24443164,8909,20458888,20949945
2006-08-01,2006,305,W,2,2,25496,23060320,24443164,10054,20468942,20949945
2006-08-02,2006,306,W,2,2,25940,23086260,24443164,9770,20478712,20949945
2006-08-03,2006,307,W,2,2,25360,23111620,24443164,9200,20487912,20949945
2006-08-04,2006,308,W,2,2,24855,23136475,24443164,8690,20496602,20949945
2006-08-05,2006,309,W,2,2,25553,23162028,24443164,9450,20506052,20949945
2006-08-06,2006,310,W,2,2,25097,23187125,24443164,8983,20515035,20949945
2006-08-07,2006,311,W,2,2,24618,23211743,24443164,8643,20523678,20949945
2006-08-08,2006,312,W,2,2,24366,23236109,24443164,8397,20532075,20949945
2006-08-09,2006,313,W,2,2,23881,23259990,24443164,8032,20540107,20949945
2006-08-10,2006,314,W,2,2,23640,23283630,24443164,7855,20547962,20949945
2006-08-11,2006,315,W,2,2,23478,23307108,24443164,7580,20555542,20949945
2006-08-12,2006,316,W,2,2,23678,23330786,24443164,7739,20563281,20949945
2006-08-13,2006,317,W,2,2,23570,23354356,24443164,7722,20571003,20949945
2006-08-14,2006,318,W,2,2,23118,23377474,24443164,7471,20578474,20949945
2006-08-15,2006,319,W,2,2,23041,23400515,24443164,7292,20585766,20949945
2006-08-16,2006,320,W,2,2,23953,23424468,24443164,8261,20594027,20949945
2006-08-17,2006,321,W,2,2,23668,23448136,24443164,7984,20602011,20949945
2006-08-18,2006,322,W,2,2,23781,23471917,24443164,8092,20610103,20949945
2006-08-19,2006,323,W,2,2,23851,23495768,24443164,8234,20618337,20949945
2006-08-20,2006,324,W,2,2,24125,23519893,24443164,8546,20626883,20949945
2006-08-21,2006,325,W,2,2,24363,23544256,24443164,8853,20635736,20949945
2006-08-22,2006,326,W,2,2,23544,23567800,24443164,8127,20643863,20949945
2006-08-23,2006,327,W,2,2,23743,23591543,24443164,8336,20652199,20949945
2006-08-24,2006,328,W,2,2,23656,23615199,24443164,9170,20661369,20949945
2006-08-25,2006,329,W,2,2,23242,23638441,24443164,7756,20669125,20949945
2006-08-26,2006,330,W,2,2,23244,23661685,24443164,7832,20676957,20949945
2006-08-27,2006,331,W,2,2,23008,23684693,24443164,7592,20684549,20949945
2006-08-28,2006,332,W,2,2,22716,23707409,24443164,7423,20691972,20949945
2006-08-29,2006,333,W,2,2,21801,23729210,24443164,6539,20698511,20949945
2006-08-30,2006,334,W,2,2,21767,23750977,24443164,6827,20705338,20949945
2006-08-31,2006,335,W,2,2,22160,23773137,24443164,7002,20712340,20949945
2006-09-01,2006,336,W,2,2,22185,23795322,24443164,7077,20719417,20949945
2006-09-02,2006,337,W,2,2,22188,23817510,24443164,7092,20726509,20949945
2006-09-03,2006,338,W,2,2,22419,23839929,24443164,7404,20733913,20949945
2006-09-04,2006,339,W,2,2,22554,23862483,24443164,7573,20741486,20949945
2006-09-05,2006,340,W,2,2,22568,23885051,24443164,7619,20749105,20949945
2006-09-06,2006,341,W,2,2,22089,23907140,24443164,7155,20756260,20949945
2006-09-07,2006,342,W,2,2,21925,23929065,24443164,7042,20763302,20949945
2006-09-08,2006,343,W,2,2,21402,23950467,24443164,6599,20769901,20949945
2006-09-09,2006,344,W,2,2,22591,23973058,24443164,7785,20777686,20949945
2006-09-10,2006,345,W,2,2,22804,23995862,24443164,8036,20785722,20949945
2006-09-11,2006,346,W,2,2,22799,24018661,24443164,8141,20793863,20949945
2006-09-12,2006,347,W,2,2,23280,24041941,24443164,8661,20802524,20949945
2006-09-13,2006,348,W,2,2,23305,24065246,24443164,9373,20811897,20949945
2006-09-14,2006,349,W,2,2,23010,24088256,24443164,8514,20820411,20949945
2006-09-15,2006,350,W,2,2,24408,24112664,24443164,9954,20830365,20949945
2006-09-16,2006,351,W,2,2,23950,24136614,24443164,9516,20839881,20949945
2006-09-17,2006,352,W,2,2,23895,24160509,24443164,9545,20849426,20949945
2006-09-18,2006,353,W,2,2,23548,24184057,24443164,9808,20859234,20949945
2006-09-19,2006,354,W,2,2,23437,24207494,24443164,9494,20868728,20949945
2006-09-20,2006,355,W,2,2,23141,24230635,24443164,8824,20877552,20949945
2006-09-21,2006,356,W,2,2,22963,24253598,24443164,8689,20886241,20949945
2006-09-22,2006,357,W,2,2,22929,24276527,24443164,8728,20894969,20949945
2006-09-23,2006,358,W,2,2,22249,24298776,24443164,8370,20903339,20949945
2006-09-24,2006,359,W,2,2,21860,24320636,24443164,8064,20911403,20949945
2006-09-25,2006,360,W,2,2,21788,24342424,24443164,7728,20919131,20949945
2006-09-26,2006,361,W,2,2,21313,24363737,24443164,7221,20926352,20949945
2006-09-27,2006,362,W,2,2,21054,24384791,24443164,6985,20933337,20949945
2006-09-28,2006,363,W,2,2,20185,24404976,24443164,6152,20939489,20949945
2006-09-29,2006,364,W,2,2,19040,24424016,24443164,5170,20944659,20949945
2006-09-30,2006,365,W,2,2,19148,24443164,24443164,5286,20949945,20949945
2006-10-01,2007,1,D,1,1,19313,19313,6653514,6440,6440,3127250
2006-10-02,2007,2,D,1,1,18962,38275,6653514,6081,12521,3127250
2006-10-03,2007,3,D,1,1,18483,56758,6653514,5649,18170,3127250
2006-10-04,2007,4,D,1,1,18285,75043,6653514,5714,23884,3127250
2006-10-05,2007,5,D,1,1,17962,93005,6653514,6576,30460,3127250
2006-10-06,2007,6,D,1,1,17508,110513,6653514,5653,36113,3127250
2006-10-07,2007,7,D,1,1,17641,128154,6653514,5854,41967,3127250
2006-10-08,2007,8,D,1,1,17430,145584,6653514,5935,47902,3127250
2006-10-09,2007,9,D,1,1,17373,162957,6653514,5323,53225,3127250
2006-10-10,2007,10,D,1,1,17051,180008,6653514,4123,57348,3127250
2006-10-11,2007,11,D,1,1,17290,197298,6653514,4175,61523,3127250
2006-10-12,2007,12,D,1,1,16776,214074,6653514,3656,65179,3127250
2006-10-13,2007,13,D,1,1,16686,230760,6653514,3588,68767,3127250
2006-10-14,2007,14,D,1,1,16581,247341,6653514,4787,73554,3127250
2006-10-15,2007,15,D,1,1,15871,263212,6653514,3841,77395,3127250
2006-10-16,2007,16,D,1,1,15623,278835,6653514,2581,79976,3127250
2006-10-17,2007,17,D,1,1,15621,294456,6653514,2580,82556,3127250
2006-10-18,2007,18,D,1,1,15015,309471,6653514,2016,84572,3127250
2006-10-19,2007,19,D,1,1,14883,324354,6653514,1873,86445,3127250
2006-10-20,2007,20,D,1,1,14927,339281,6653514,2319,88764,3127250
2006-10-21,2007,21,D,1,1,14875,354156,6653514,3686,92450,3127250
2006-10-22,2007,22,D,1,1,14565,368721,6653514,2554,95004,3127250
2006-10-23,2007,23,D,1,1,14431,383152,6653514,2503,97507,3127250
2006-10-24,2007,24,D,1,1,14471,397623,6653514,3028,100535,3127250
2006-10-25,2007,25,D,1,1,15115,412738,6653514,3631,104166,3127250
2006-10-26,2007,26,D,1,1,14441,427179,6653514,2963,107129,3127250
2006-10-27,2007,27,D,1,1,14343,441522,6653514,2863,109992,3127250
2006-10-28,2007,28,D,1,1,14285,455807,6653514,2816,112808,3127250
2006-10-29,2007,29,D,1,1,14038,469845,6653514,2608,115416,3127250
2006-10-30,2007,30,D,1,1,15028,484873,6653514,3709,119125,3127250
2006-10-31,2007,31,D,1,1,15290,500163,6653514,4489,123614,3127250
2006-11-01,2007,32,D,1,1,14938,515101,6653514,3663,127277,3127250
2006-11-02,2007,33,D,1,1,14591,529692,6653514,4913,132190,3127250
2006-11-03,2007,34,D,1,1,14768,544460,6653514,4762,136952,3127250
2006-11-04,2007,35,D,1,1,14815,559275,6653514,5494,142446,3127250
2006-11-05,2007,36,D,1,1,14594,573869,6653514,5374,147820,3127250
2006-11-06,2007,37,D,1,1,14687,588556,6653514,4233,152053,3127250
2006-11-07,2007,38,D,1,1,14270,602826,6653514,3766,155819,3127250
2006-11-08,2007,39,D,1,1,14010,616836,6653514,3982,159801,3127250
2006-11-09,2007,40,D,1,1,14618,631454,6653514,3387,163188,3127250
2006-11-10,2007,41,D,1,1,14525,645979,6653514,4400,167588,3127250
2006-11-11,2007,42,D,1,1,14640,660619,6653514,4930,172518,3127250
2006-11-12,2007,43,D,1,1,14765,675384,6653514,5036,177554,3127250
2006-11-13,2007,44,D,1,1,14921,690305,6653514,7960,185514,3127250
2006-11-14,2007,45,D,1,1,15769,706074,6653514,8785,194299,3127250
2006-11-15,2007,46,D,1,1,16258,722332,6653514,9437,203736,3127250
2006-11-16,2007,47,D,1,1,16306,738638,6653514,8284,212020,3127250
2006-11-17,2007,48,D,1,1,16503,755141,6653514,8276,220296,3127250
2006-11-18,2007,49,D,1,1,16352,771493,6653514,5029,225325,3127250
2006-11-19,2007,50,D,1,1,16012,787505,6653514,4697,230022,3127250
2006-11-20,2007,51,D,1,1,15785,803290,6653514,3865,233887,3127250
2006-11-21,2007,52,D,1,1,15445,818735,6653514,3871,237758,3127250
2006-11-22,2007,53,D,1,1,15265,834000,6653514,4019,241777,3127250
2006-11-23,2007,54,D,1,1,15500,849500,6653514,4213,245990,3127250
2006-11-24,2007,55,D,1,1,15308,864808,6653514,4109,250099,3127250
2006-11-25,2007,56,D,1,1,15659,880467,6653514,4377,254476,3127250
2006-11-26,2007,57,D,1,1,15561,896028,6653514,4303,258779,3127250
2006-11-27,2007,58,D,1,1,15978,912006,6653514,4687,263466,3127250
2006-11-28,2007,59,D,1,1,16366,928372,6653514,5099,268565,3127250
2006-11-29,2007,60,D,1,1,16599,944971,6653514,6288,274853,3127250
2006-11-30,2007,61,D,1,1,16317,961288,6653514,5679,280532,3127250
2006-12-01,2007,62,D,1,1,15464,976752,6653514,3085,283617,3127250
2006-12-02,2007,63,D,1,1,14949,991701,6653514,2541,286158,3127250
2006-12-03,2007,64,D,1,1,14806,1006507,6653514,2462,288620,3127250
2006-12-04,2007,65,D,1,1,14393,1020900,6653514,3032,291652,3127250
2006-12-05,2007,66,D,1,1,14340,1035240,6653514,2905,294557,3127250
2006-12-06,2007,67,D,1,1,14369,1049609,6653514,3789,298346,3127250
2006-12-07,2007,68,D,1,1,14612,1064221,6653514,3758,302104,3127250
2006-12-08,2007,69,D,1,1,14274,1078495,6653514,4339,306443,3127250
2006-12-09,2007,70,D,1,1,15491,1093986,6653514,8371,314814,3127250
2006-12-10,2007,71,D,1,1,17680,1111666,6653514,10929,325743,3127250
2006-12-11,2007,72,D,1,1,17851,1129517,6653514,10346,336089,3127250
2006-12-12,2007,73,D,1,1,18797,1148314,6653514,15564,351653,3127250
2006-12-13,2007,74,D,1,1,20316,1168630,6653514,15645,367298,3127250
2006-12-14,2007,75,D,1,1,21883,1190513,6653514,13199,380497,3127250
2006-12-15,2007,76,D,1,1,25611,1216124,6653514,15504,396001,3127250
2006-12-16,2007,77,D,1,1,27776,1243900,6653514,17414,413415,3127250
2006-12-17,2007,78,D,1,1,26770,1270670,6653514,13267,426682,3127250
2006-12-18,2007,79,D,1,1,24768,1295438,6653514,11275,437957,3127250
2006-12-19,2007,80,D,1,1,22540,1317978,6653514,9057,447014,3127250
2006-12-20,2007,81,D,1,1,20448,1338426,6653514,6496,453510,3127250
2006-12-21,2007,82,D,1,1,19458,1357884,6653514,6489,459999,3127250
2006-12-22,2007,83,D,1,1,19412,1377296,6653514,6657,466656,3127250
2006-12-23,2007,84,D,1,1,19434,1396730,6653514,6675,473331,3127250
2006-12-24,2007,85,D,1,1,19384,1416114,6653514,6738,480069,3127250
2006-12-25,2007,86,D,1,1,19071,1435185,6653514,6616,486685,3127250
2006-12-26,2007,87,D,1,1,18273,1453458,6653514,6183,492868,3127250
2006-12-27,2007,88,D,1,1,19914,1473372,6653514,7977,500845,3127250
2006-12-28,2007,89,D,1,1,23189,1496561,6653514,12120,512965,3127250
2006-12-29,2007,90,D,1,1,29302,1525863,6653514,17722,530687,3127250
2006-12-30,2007,91,D,1,1,29539,1555402,6653514,17815,548502,3127250
2006-12-31,2007,92,D,1,1,25071,1580473,6653514,11630,560132,3127250
2007-01-01,2007,93,D,1,1,22358,1602831,6653514,9287,569419,3127250
2007-01-02,2007,94,D,1,1,20823,1623654,6653514,9742,579161,3127250
2007-01-03,2007,95,D,1,1,19691,1643345,6653514,8688,587849,3127250
2007-01-04,2007,96,D,1,1,19363,1662708,6653514,10310,598159,3127250
2007-01-05,2007,97,D,1,1,20548,1683256,6653514,11600,609759,3127250
2007-01-06,2007,98,D,1,1,20213,1703469,6653514,11284,621043,3127250
2007-01-07,2007,99,D,1,1,20721,1724190,6653514,11824,632867,3127250
2007-01-08,2007,100,D,1,1,20095,1744285,6653514,10738,643605,3127250
2007-01-09,2007,101,D,1,1,19094,1763379,6653514,8809,652414,3127250
2007-01-10,2007,102,D,1,1,18367,1781746,6653514,8148,660562,3127250
2007-01-11,2007,103,D,1,1,18150,1799896,6653514,7401,667963,3127250
2007-01-12,2007,104,D,1,1,17719,1817615,6653514,6372,674335,3127250
2007-01-13,2007,105,D,1,1,16677,1834292,6653514,4734,679069,3127250
2007-01-14,2007,106,D,1,1,16168,1850460,6653514,4348,683417,3127250
2007-01-15,2007,107,D,1,1,15996,1866456,6653514,8384,691801,3127250
2007-01-16,2007,108,D,1,1,15493,1881949,6653514,7853,699654,3127250
2007-01-17,2007,109,D,1,1,15376,1897325,6653514,7770,707424,3127250
2007-01-18,2007,110,D,1,1,15624,1912949,6653514,8109,715533,3127250
2007-01-19,2007,111,D,1,1,15483,1928432,6653514,7935,723468,3127250
2007-01-20,2007,112,D,1,1,15469,1943901,6653514,8213,731681,3127250
2007-01-21,2007,113,D,1,1,15466,1959367,6653514,8274,739955,3127250
2007-01-22,2007,114,D,1,1,15175,1974542,6653514,8118,748073,3127250
2007-01-23,2007,115,D,1,1,15062,1989604,6653514,6649,754722,3127250
2007-01-24,2007,116,D,1,1,14949,2004553,6653514,7077,761799,3127250
2007-01-25,2007,117,D,1,1,14746,2019299,6653514,6780,768579,3127250
2007-01-26,2007,118,D,1,1,14536,2033835,6653514,6606,775185,3127250
2007-01-27,2007,119,D,1,1,14416,2048251,6653514,6760,781945,3127250
2007-01-28,2007,120,D,1,1,14261,2062512,6653514,7481,789426,3127250
2007-01-29,2007,121,D,1,1,14527,2077039,6653514,7853,797279,3127250
2007-01-30,2007,122,D,1,1,15110,2092149,6653514,8840,806119,3127250
2007-01-31,2007,123,D,1,1,16273,2108422,6653514,9537,815656,3127250
2007-02-01,2007,124,D,1,1,16540,2124962,6653514,9588,825244,3127250
2007-02-02,2007,125,D,1,1,16573,2141535,6653514,9006,834250,3127250
2007-02-03,2007,126,D,1,1,16342,2157877,6653514,8490,842740,3127250
2007-02-04,2007,127,D,1,1,15926,2173803,6653514,8031,850771,3127250
2007-02-05,2007,128,D,1,1,15747,2189550,6653514,7877,858648,3127250
2007-02-06,2007,129,D,1,1,15826,2205376,6653514,7774,866422,3127250
2007-02-07,2007,130,D,1,1,16259,2221635,6653514,8310,874732,3127250
2007-02-08,2007,131,D,1,1,16896,2238531,6653514,9712,884444,3127250
2007-02-09,2007,132,D,1,1,18120,2256651,6653514,12511,896955,3127250
2007-02-10,2007,133,D,1,1,21083,2277734,6653514,21268,918223,3127250
2007-02-11,2007,134,D,1,1,33518,2311252,6653514,34092,952315,3127250
2007-02-12,2007,135,D,1,1,45186,2356438,6653514,46754,999069,3127250
2007-02-13,2007,136,D,1,1,45346,2401784,6653514,45630,1044699,3127250
2007-02-14,2007,137,D,1,1,43512,2445296,6653514,42265,1086964,3127250
2007-02-15,2007,138,D,1,1,39324,2484620,6653514,32433,1119397,3127250
2007-02-16,2007,139,D,1,1,35108,2519728,6653514,27658,1147055,3127250
2007-02-17,2007,140,D,1,1,31759,2551487,6653514,23837,1170892,3127250
2007-02-18,2007,141,D,1,1,27913,2579400,6653514,20012,1190904,3127250
2007-02-19,2007,142,D,1,1,25929,2605329,6653514,18085,1208989,3127250
2007-02-20,2007,143,D,1,1,24383,2629712,6653514,16484,1225473,3127250
2007-02-21,2007,144,D,1,1,23092,2652804,6653514,15140,1240613,3127250
2007-02-22,2007,145,D,1,1,22169,2674973,6653514,15890,1256503,3127250
2007-02-23,2007,146,D,1,1,22521,2697494,6653514,16248,1272751,3127250
2007-02-24,2007,147,D,1,1,23664,2721158,6653514,17395,1290146,3127250
2007-02-25,2007,148,D,1,1,27555,2748713,6653514,22649,1312795,3127250
2007-02-26,2007,149,D,1,1,32060,2780773,6653514,29679,1342474,3127250
2007-02-27,2007,150,D,1,1,37049,2817822,6653514,33278,1375752,3127250
2007-02-28,2007,151,D,1,1,38405,2856227,6653514,34468,1410220,3127250
2007-03-01,2007,152,D,1,1,38396,2894623,6653514,34277,1444497,3127250
2007-03-02,2007,153,D,1,1,37003,2931626,6653514,30882,1475379,3127250
2007-03-03,2007,154,D,1,1,35194,2966820,6653514,26571,1501950,3127250
2007-03-04,2007,155,D,1,1,32557,2999377,6653514,23937,1525887,3127250
2007-03-05,2007,156,D,1,1,30925,3030302,6653514,22190,1548077,3127250
2007-03-06,2007,157,D,1,1,29510,3059812,6653514,20433,1568510,3127250
2007-03-07,2007,158,D,1,1,27024,3086836,6653514,17847,1586357,3127250
2007-03-08,2007,159,D,1,1,25100,3111936,6653514,15848,1602205,3127250
2007-03-09,2007,160,D,1,1,23870,3135806,6653514,14641,1616846,3127250
2007-03-10,2007,161,D,1,1,22672,3158478,6653514,13411,1630257,3127250
2007-03-11,2007,162,D,1,1,22124,3180602,6653514,13045,1643302,3127250
2007-03-12,2007,163,D,1,1,20980,3201582,6653514,11727,1655029,3127250
2007-03-13,2007,164,D,1,1,20057,3221639,6653514,11474,1666503,3127250
2007-03-14,2007,165,D,1,1,19633,3241272,6653514,11047,1677550,3127250
2007-03-15,2007,166,D,1,1,19636,3260908,6653514,11238,1688788,3127250
2007-03-16,2007,167,D,1,1,19242,3280150,6653514,10825,1699613,3127250
2007-03-17,2007,168,D,1,1,18502,3298652,6653514,9952,1709565,3127250
2007-03-18,2007,169,D,1,1,18252,3316904,6653514,9706,1719271,3127250
2007-03-19,2007,170,D,1,1,17828,3334732,6653514,8560,1727831,3127250
2007-03-20,2007,171,D,1,1,17529,3352261,6653514,9799,1737630,3127250
2007-03-21,2007,172,D,1,1,17947,3370208,6653514,10505,1748135,3127250
2007-03-22,2007,173,D,1,1,17265,3387473,6653514,10104,1758239,3127250
2007-03-23,2007,174,D,1,1,16673,3404146,6653514,9779,1768018,3127250
2007-03-24,2007,175,D,1,1,16464,3420610,6653514,9453,1777471,3127250
2007-03-25,2007,176,D,1,1,16315,3436925,6653514,8200,1785671,3127250
2007-03-26,2007,177,D,1,1,15790,3452715,6653514,9065,1794736,3127250
2007-03-27,2007,178,D,1,1,15803,3468518,6653514,9034,1803770,3127250
2007-03-28,2007,179,D,1,1,16524,3485042,6653514,9709,1813479,3127250
2007-03-29,2007,180,D,1,1,16514,3501556,6653514,9696,1823175,3127250
2007-03-30,2007,181,D,1,1,17371,3518927,6653514,11092,1834267,3127250
2007-03-31,2007,182,D,1,1,17621,3536548,6653514,10076,1844343,3127250
2007-04-01,2007,183,D,1,1,17916,3554464,6653514,9314,1853657,3127250
2007-04-02,2007,184,D,1,1,18183,3572647,6653514,9848,1863505,3127250
2007-04-03,2007,185,D,1,1,18114,3590761,6653514,10291,1873796,3127250
2007-04-04,2007,186,D,1,1,18539,3609300,6653514,9688,1883484,3127250
2007-04-05,2007,187,D,1,1,18266,3627566,6653514,9632,1893116,3127250
2007-04-06,2007,188,D,1,1,17526,3645092,6653514,9692,1902808,3127250
2007-04-07,2007,189,D,1,1,17205,3662297,6653514,9353,1912161,3127250
2007-04-08,2007,190,D,1,1,17488,3679785,6653514,9541,1921702,3127250
2007-04-09,2007,191,D,1,1,17907,3697692,6653514,10446,1932148,3127250
2007-04-10,2007,192,D,1,1,17715,3715407,6653514,10281,1942429,3127250
2007-04-11,2007,193,D,1,1,16874,3732281,6653514,11331,1953760,3127250
2007-04-12,2007,194,D,1,1,17460,3749741,6653514,11692,1965452,3127250
2007-04-13,2007,195,D,1,1,17101,3766842,6653514,11104,1976556,3127250
2007-04-14,2007,196,D,1,1,17165,3784007,6653514,13115,1989671,3127250
2007-04-15,2007,197,D,1,1,18003,3802010,6653514,13875,2003546,3127250
2007-04-16,2007,198,D,1,1,17588,3819598,6653514,11004,2014550,3127250
2007-04-17,2007,199,D,1,1,16709,3836307,6653514,10296,2024846,3127250
2007-04-18,2007,200,D,1,1,17103,3853410,6653514,10970,2035816,3127250
2007-04-19,2007,201,D,1,1,16010,3869420,6653514,7946,2043762,3127250
2007-04-20,2007,202,D,1,1,15248,3884668,6653514,7684,2051446,3127250
2007-04-21,2007,203,D,1,1,15346,3900014,6653514,8513,2059959,3127250
2007-04-22,2007,204,D,1,1,16425,3916439,6653514,14557,2074516,3127250
2007-04-23,2007,205,D,1,1,17321,3933760,6653514,15962,2090478,3127250
2007-04-24,2007,206,D,1,1,17526,3951286,6653514,16330,2106808,3127250
2007-04-25,2007,207,D,1,1,18066,3969352,6653514,16873,2123681,3127250
2007-04-26,2007,208,D,1,1,17456,3986808,6653514,15335,2139016,3127250
2007-04-27,2007,209,D,1,1,16280,4003088,6653514,12767,2151783,3127250
2007-04-28,2007,210,D,1,1,14951,4018039,6653514,11372,2163155,3127250
2007-04-29,2007,211,D,1,1,13810,4031849,6653514,10226,2173381,3127250
2007-04-30,2007,212,D,1,1,13678,4045527,6653514,10149,2183530,3127250
2007-05-01,2007,213,D,1,1,13001,4058528,6653514,9307,2192837,3127250
2007-05-02,2007,214,D,1,1,13268,4071796,6653514,9543,2202380,3127250
2007-05-03,2007,215,D,1,1,13417,4085213,6653514,9857,2212237,3127250
2007-05-04,2007,216,D,1,1,14098,4099311,6653514,10699,2222936,3127250
2007-05-05,2007,217,D,1,1,15271,4114582,6653514,11876,2234812,3127250
2007-05-06,2007,218,D,1,1,16126,4130708,6653514,12736,2247548,3127250
2007-05-07,2007,219,D,1,1,15425,4146133,6653514,12011,2259559,3127250
2007-05-08,2007,220,D,1,1,14008,4160141,6653514,10322,2269881,3127250
2007-05-09,2007,221,D,1,1,13499,4173640,6653514,9500,2279381,3127250
2007-05-10,2007,222,D,1,1,13024,4186664,6653514,9101,2288482,3127250
2007-05-11,2007,223,D,1,1,13118,4199782,6653514,9117,2297599,3127250
2007-05-12,2007,224,D,1,1,13311,4213093,6653514,9243,2306842,3127250
2007-05-13,2007,225,D,1,1,13635,4226728,6653514,9569,2316411,3127250
2007-05-14,2007,226,D,1,1,13444,4240172,6653514,9409,2325820,3127250
2007-05-15,2007,227,D,1,1,13039,4253211,6653514,8978,2334798,3127250
2007-05-16,2007,228,D,1,1,13147,4266358,6653514,9373,2344171,3127250
2007-05-17,2007,229,D,1,1,12831,4279189,6653514,9010,2353181,3127250
2007-05-18,2007,230,D,1,1,13447,4292636,6653514,9610,2362791,3127250
2007-05-19,2007,231,D,1,1,13649,4306285,6653514,9726,2372517,3127250
2007-05-20,2007,232,D,1,1,13369,4319654,6653514,9379,2381896,3127250
2007-05-21,2007,233,D,1,1,13913,4333567,6653514,9950,2391846,3127250
2007-05-22,2007,234,D,1,1,14110,4347677,6653514,10086,2401932,3127250
2007-05-23,2007,235,D,1,1,14117,4361794,6653514,9971,2411903,3127250
2007-05-24,2007,236,D,1,1,13353,4375147,6653514,9131,2421034,3127250
2007-05-25,2007,237,D,1,1,12648,4387795,6653514,8376,2429410,3127250
2007-05-26,2007,238,D,1,1,11857,4399652,6653514,7609,2437019,3127250
2007-05-27,2007,239,D,1,1,11403,4411055,6653514,7131,2444150,3127250
2007-05-28,2007,240,D,1,1,11466,4422521,6653514,7111,2451261,3127250
2007-05-29,2007,241,D,1,1,11563,4434084,6653514,7161,2458422,3127250
2007-05-30,2007,242,D,1,1,12388,4446472,6653514,7975,2466397,3127250
2007-05-31,2007,243,D,1,1,12356,4458828,6653514,7907,2474304,3127250
2007-06-01,2007,244,D,1,1,12127,4470955,6653514,7824,2482128,3127250
2007-06-02,2007,245,D,1,1,12274,4483229,6653514,7886,2490014,3127250
2007-06-03,2007,246,D,1,1,12667,4495896,6653514,8151,2498165,3127250
2007-06-04,2007,247,D,1,1,13070,4508966,6653514,8610,2506775,3127250
2007-06-05,2007,248,D,1,1,12684,4521650,6653514,8164,2514939,3127250
2007-06-06,2007,249,D,1,1,13651,4535301,6653514,9091,2524030,3127250
2007-06-07,2007,250,D,1,1,13542,4548843,6653514,8890,2532920,3127250
2007-06-08,2007,251,D,1,1,14061,4562904,6653514,9355,2542275,3127250
2007-06-09,2007,252,D,1,1,14602,4577506,6653514,9907,2552182,3127250
2007-06-10,2007,253,D,1,1,14269,4591775,6653514,9461,2561643,3127250
2007-06-11,2007,254,D,1,1,14314,4606089,6653514,9499,2571142,3127250
2007-06-12,2007,255,D,1,1,13956,4620045,6653514,8670,2579812,3127250
2007-06-13,2007,256,D,1,1,13363,4633408,6653514,6860,2586672,3127250
2007-06-14,2007,257,D,1,1,12842,4646250,6653514,5742,2592414,3127250
2007-06-15,2007,258,D,1,1,12668,4658918,6653514,5473,2597887,3127250
2007-06-16,2007,259,D,1,1,13358,4672276,6653514,6161,2604048,3127250
2007-06-17,2007,260,D,1,1,15192,4687468,6653514,7177,2611225,3127250
2007-06-18,2007,261,D,1,1,15711,4703179,6653514,7740,2618965,3127250
2007-06-19,2007,262,D,1,1,15660,4718839,6653514,6879,2625844,3127250
2007-06-20,2007,263,D,1,1,16275,4735114,6653514,7322,2633166,3127250
2007-06-21,2007,264,D,1,1,16574,4751688,6653514,7527,2640693,3127250
2007-06-22,2007,265,D,1,1,16418,4768106,6653514,6823,2647516,3127250
2007-06-23,2007,266,D,1,1,16355,4784461,6653514,6497,2654013,3127250
2007-06-24,2007,267,D,1,1,16305,4800766,6653514,7126,2661139,3127250
2007-06-25,2007,268,D,1,1,16601,4817367,6653514,7224,2668363,3127250
2007-06-26,2007,269,D,1,1,16532,4833899,6653514,6841,2675204,3127250
2007-06-27,2007,270,D,1,1,17066,4850965,6653514,7618,2682822,3127250
2007-06-28,2007,271,D,1,1,17353,4868318,6653514,7399,2690221,3127250
2007-06-29,2007,272,D,1,1,19093,4887411,6653514,9028,2699249,3127250
2007-06-30,2007,273,D,1,1,20669,4908080,6653514,10450,2709699,3127250
2007-07-01,2007,274,D,1,1,21209,4929289,6653514,5830,2715529,3127250
2007-07-02,2007,275,D,1,1,22132,4951421,6653514,6541,2722070,3127250
2007-07-03,2007,276,D,1,1,22145,4973566,6653514,7525,2729595,3127250
2007-07-04,2007,277,D,1,1,21661,4995227,6653514,6845,2736440,3127250
2007-07-05,2007,278,D,1,1,20489,5015716,6653514,5527,2741967,3127250
2007-07-06,2007,279,D,1,1,19928,5035644,6653514,4888,2746855,3127250
2007-07-07,2007,280,D,1,1,20080,5055724,6653514,5841,2752696,3127250
2007-07-08,2007,281,D,1,1,19843,5075567,6653514,4825,2757521,3127250
2007-07-09,2007,282,D,1,1,19594,5095161,6653514,4292,2761813,3127250
2007-07-10,2007,283,D,1,1,19963,5115124,6653514,4678,2766491,3127250
2007-07-11,2007,284,D,1,1,20237,5135361,6653514,4280,2770771,3127250
2007-07-12,2007,285,D,1,1,21396,5156757,6653514,5686,2776457,3127250
2007-07-13,2007,286,D,1,1,21778,5178535,6653514,6494,2782951,3127250
2007-07-14,2007,287,D,1,1,21502,5200037,6653514,5315,2788266,3127250
2007-07-15,2007,288,D,1,1,21829,5221866,6653514,5407,2793673,3127250
2007-07-16,2007,289,D,1,1,21656,5243522,6653514,5390,2799063,3127250
2007-07-17,2007,290,D,1,1,22069,5265591,6653514,5642,2804705,3127250
2007-07-18,2007,291,D,1,1,21834,5287425,6653514,5409,2810114,3127250
2007-07-19,2007,292,D,1,1,21961,5309386,6653514,5736,2815850,3127250
2007-07-20,2007,293,D,1,1,22143,5331529,6653514,5755,2821605,3127250
2007-07-21,2007,294,D,1,1,22494,5354023,6653514,7151,2828756,3127250
2007-07-22,2007,295,D,1,1,22567,5376590,6653514,6382,2835138,3127250
2007-07-23,2007,296,D,1,1,22139,5398729,6653514,5965,2841103,3127250
2007-07-24,2007,297,D,1,1,21484,5420213,6653514,5230,2846333,3127250
2007-07-25,2007,298,D,1,1,21109,5441322,6653514,5453,2851786,3127250
2007-07-26,2007,299,D,1,1,20767,5462089,6653514,4643,2856429,3127250
2007-07-27,2007,300,D,1,1,20422,5482511,6653514,4188,2860617,3127250
2007-07-28,2007,301,D,1,1,20304,5502815,6653514,4211,2864828,3127250
2007-07-29,2007,302,D,1,1,20331,5523146,6653514,4165,2868993,3127250
2007-07-30,2007,303,D,1,1,19934,5543080,6653514,3743,2872736,3127250
2007-07-31,2007,304,D,1,1,19233,5562313,6653514,3148,2875884,3127250
2007-08-01,2007,305,D,1,1,19004,5581317,6653514,2931,2878815,3127250
2007-08-02,2007,306,D,1,1,18810,5600127,6653514,2688,2881503,3127250
2007-08-03,2007,307,D,1,1,19202,5619329,6653514,3109,2884612,3127250
2007-08-04,2007,308,D,1,1,19070,5638399,6653514,4167,2888779,3127250
2007-08-05,2007,309,D,1,1,18421,5656820,6653514,2394,2891173,3127250
2007-08-06,2007,310,D,1,1,19469,5676289,6653514,3484,2894657,3127250
2007-08-07,2007,311,D,1,1,19484,5695773,6653514,3599,2898256,3127250
2007-08-08,2007,312,D,1,1,19357,5715130,6653514,3424,2901680,3127250
2007-08-09,2007,313,D,1,1,19792,5734922,6653514,3885,2905565,3127250
2007-08-10,2007,314,D,1,1,20155,5755077,6653514,4286,2909851,3127250
2007-08-11,2007,315,D,1,1,19771,5774848,6653514,4584,2914435,3127250
2007-08-12,2007,316,D,1,1,19967,5794815,6653514,4203,2918638,3127250
2007-08-13,2007,317,D,1,1,20098,5814913,6653514,4463,2923101,3127250
2007-08-14,2007,318,D,1,1,19836,5834749,6653514,4144,2927245,3127250
2007-08-15,2007,319,D,1,1,19788,5854537,6653514,4067,2931312,3127250
2007-08-16,2007,320,D,1,1,19683,5874220,6653514,4042,2935354,3127250
2007-08-17,2007,321,D,1,1,19166,5893386,6653514,3561,2938915,3127250
2007-08-18,2007,322,D,1,1,18514,5911900,6653514,2950,2941865,3127250
2007-08-19,2007,323,D,1,1,18825,5930725,6653514,3325,2945190,3127250
2007-08-20,2007,324,D,1,1,18733,5949458,6653514,3295,2948485,3127250
2007-08-21,2007,325,D,1,1,18189,5967647,6653514,2747,2951232,3127250
2007-08-22,2007,326,D,1,1,18144,5985791,6653514,2723,2953955,3127250
2007-08-23,2007,327,D,1,1,18172,6003963,6653514,2797,2956752,3127250
2007-08-24,2007,328,D,1,1,18424,6022387,6653514,3045,2959797,3127250
2007-08-25,2007,329,D,1,1,18433,6040820,6653514,4377,2964174,3127250
2007-08-26,2007,330,D,1,1,18360,6059180,6653514,4335,2968509,3127250
2007-08-27,2007,331,D,1,1,18258,6077438,6653514,4709,2973218,3127250
2007-08-28,2007,332,D,1,1,18043,6095481,6653514,4620,2977838,3127250
2007-08-29,2007,333,D,1,1,17792,6113273,6653514,4352,2982190,3127250
2007-08-30,2007,334,D,1,1,18009,6131282,6653514,4628,2986818,3127250
2007-08-31,2007,335,D,1,1,18211,6149493,6653514,4917,2991735,3127250
2007-09-01,2007,336,D,1,1,18526,6168019,6653514,4796,2996531,3127250
2007-09-02,2007,337,D,1,1,18862,6186881,6653514,5127,3001658,3127250
2007-09-03,2007,338,D,1,1,18588,6205469,6653514,4916,3006574,3127250
2007-09-04,2007,339,D,1,1,18390,6223859,6653514,4765,3011339,3127250
2007-09-05,2007,340,D,1,1,18823,6242682,6653514,5264,3016603,3127250
2007-09-06,2007,341,D,1,1,18434,6261116,6653514,4905,3021508,3127250
2007-09-07,2007,342,D,1,1,18194,6279310,6653514,4724,3026232,3127250
2007-09-08,2007,343,D,1,1,18461,6297771,6653514,5060,3031292,3127250
2007-09-09,2007,344,D,1,1,18150,6315921,6653514,4685,3035977,3127250
2007-09-10,2007,345,D,1,1,18254,6334175,6653514,4937,3040914,3127250
2007-09-11,2007,346,D,1,1,17898,6352073,6653514,4539,3045453,3127250
2007-09-12,2007,347,D,1,1,17179,6369252,6653514,4914,3050367,3127250
2007-09-13,2007,348,D,1,1,17762,6387014,6653514,5577,3055944,3127250
2007-09-14,2007,349,D,1,1,17629,6404643,6653514,5496,3061440,3127250
2007-09-15,2007,350,D,1,1,17195,6421838,6653514,5082,3066522,3127250
2007-09-16,2007,351,D,1,1,17609,6439447,6653514,5544,3072066,3127250
2007-09-17,2007,352,D,1,1,17193,6456640,6653514,6035,3078101,3127250
2007-09-18,2007,353,D,1,1,16621,6473261,6653514,5322,3083423,3127250
2007-09-19,2007,354,D,1,1,16092,6489353,6653514,4671,3088094,3127250
2007-09-20,2007,355,D,1,1,16987,6506340,6653514,5595,3093689,3127250
2007-09-21,2007,356,D,1,1,16561,6522901,6653514,5139,3098828,3127250
2007-09-22,2007,357,D,1,1,15868,6538769,6653514,4728,3103556,3127250
2007-09-23,2007,358,D,1,1,15653,6554422,6653514,4965,3108521,3127250
2007-09-24,2007,359,D,1,1,15475,6569897,6653514,5330,3113851,3127250
2007-09-25,2007,360,D,1,1,15167,6585064,6653514,4050,3117901,3127250
2007-09-26,2007,361,D,1,1,14494,6599558,6653514,3347,3121248,3127250
2007-09-27,2007,362,D,1,1,13971,6613529,6653514,1187,3122435,3127250
2007-09-28,2007,363,D,1,1,13122,6626651,6653514,857,3123292,3127250
2007-09-29,2007,364,D,1,1,13576,6640227,6653514,2869,3126161,3127250
2007-09-30,2007,365,D,1,1,13287,6653514,6653514,1089,3127250,3127250
2007-10-01,2008,1,D,2,2,14348,14348,5819508,3103,3103,3397741
2007-10-02,2008,2,D,2,2,13930,28278,5819508,2768,5871,3397741
2007-10-03,2008,3,D,2,2,13619,41897,5819508,3044,8915,3397741
2007-10-04,2008,4,D,2,2,13563,55460,5819508,3468,12383,3397741
2007-10-05,2008,5,D,2,2,13877,69337,5819508,3863,16246,3397741
2007-10-06,2008,6,D,2,2,13426,82763,5819508,3816,20062,3397741
2007-10-07,2008,7,D,2,2,12791,95554,5819508,3274,23336,3397741
2007-10-08,2008,8,D,2,2,12489,108043,5819508,3092,26428,3397741
2007-10-09,2008,9,D,2,2,12228,120271,5819508,2786,29214,3397741
2007-10-10,2008,10,D,2,2,13222,133493,5819508,5470,34684,3397741
2007-10-11,2008,11,D,2,2,13171,146664,5819508,4903,39587,3397741
2007-10-12,2008,12,D,2,2,12881,159545,5819508,6729,46316,3397741
2007-10-13,2008,13,D,2,2,12371,171916,5819508,6268,52584,3397741
2007-10-14,2008,14,D,2,2,12186,184102,5819508,6078,58662,3397741
2007-10-15,2008,15,D,2,2,11466,195568,5819508,3660,62322,3397741
2007-10-16,2008,16,D,2,2,11348,206916,5819508,4366,66688,3397741
2007-10-17,2008,17,D,2,2,11879,218795,5819508,2854,69542,3397741
2007-10-18,2008,18,D,2,2,12491,231286,5819508,3029,72571,3397741
2007-10-19,2008,19,D,2,2,12350,243636,5819508,2828,75399,3397741
2007-10-20,2008,20,D,2,2,12543,256179,5819508,3521,78920,3397741
2007-10-21,2008,21,D,2,2,12154,268333,5819508,2938,81858,3397741
2007-10-22,2008,22,D,2,2,12342,280675,5819508,3115,84973,3397741
2007-10-23,2008,23,D,2,2,12297,292972,5819508,3607,88580,3397741
2007-10-24,2008,24,D,2,2,11768,304740,5819508,2981,91561,3397741
2007-10-25,2008,25,D,2,2,11594,316334,5819508,2836,94397,3397741
2007-10-26,2008,26,D,2,2,11518,327852,5819508,2751,97148,3397741
2007-10-27,2008,27,D,2,2,11651,339503,5819508,3452,100600,3397741
2007-10-28,2008,28,D,2,2,11968,351471,5819508,3757,104357,3397741
2007-10-29,2008,29,D,2,2,11446,362917,5819508,2774,107131,3397741
2007-10-30,2008,30,D,2,2,12263,375180,5819508,3557,110688,3397741
2007-10-31,2008,31,D,2,2,12635,387815,5819508,3485,114173,3397741
2007-11-01,2008,32,D,2,2,12326,400141,5819508,3626,117799,3397741
2007-11-02,2008,33,D,2,2,12120,412261,5819508,3477,121276,3397741
2007-11-03,2008,34,D,2,2,11776,424037,5819508,3550,124826,3397741
2007-11-04,2008,35,D,2,2,11314,435351,5819508,3052,127878,3397741
2007-11-05,2008,36,D,2,2,11213,446564,5819508,3002,130880,3397741
2007-11-06,2008,37,D,2,2,11003,457567,5819508,2789,133669,3397741
2007-11-07,2008,38,D,2,2,11062,468629,5819508,2853,136522,3397741
2007-11-08,2008,39,D,2,2,10674,479303,5819508,3530,140052,3397741
2007-11-09,2008,40,D,2,2,11248,490551,5819508,4274,144326,3397741
2007-11-10,2008,41,D,2,2,11254,501805,5819508,6275,150601,3397741
2007-11-11,2008,42,D,2,2,12266,514071,5819508,10035,160636,3397741
2007-11-12,2008,43,D,2,2,12310,526381,5819508,10067,170703,3397741
2007-11-13,2008,44,D,2,2,12361,538742,5819508,8650,179353,3397741
2007-11-14,2008,45,D,2,2,12390,551132,5819508,8164,187517,3397741
2007-11-15,2008,46,D,2,2,12316,563448,5819508,5683,193200,3397741
2007-11-16,2008,47,D,2,2,12806,576254,5819508,3648,196848,3397741
2007-11-17,2008,48,D,2,2,12895,589149,5819508,4045,200893,3397741
2007-11-18,2008,49,D,2,2,12888,602037,5819508,4037,204930,3397741
2007-11-19,2008,50,D,2,2,13103,615140,5819508,3932,208862,3397741
2007-11-20,2008,51,D,2,2,12984,628124,5819508,4079,212941,3397741
2007-11-21,2008,52,D,2,2,12362,640486,5819508,2430,215371,3397741
2007-11-22,2008,53,D,2,2,12268,652754,5819508,2504,217875,3397741
2007-11-23,2008,54,D,2,2,12365,665119,5819508,3621,221496,3397741
2007-11-24,2008,55,D,2,2,11968,677087,5819508,3241,224737,3397741
2007-11-25,2008,56,D,2,2,11852,688939,5819508,3012,227749,3397741
2007-11-26,2008,57,D,2,2,12030,700969,5819508,3198,230947,3397741
2007-11-27,2008,58,D,2,2,12028,712997,5819508,3147,234094,3397741
2007-11-28,2008,59,D,2,2,11934,724931,5819508,3022,237116,3397741
2007-11-29,2008,60,D,2,2,11669,736600,5819508,2753,239869,3397741
2007-11-30,2008,61,D,2,2,11493,748093,5819508,3031,242900,3397741
2007-12-01,2008,62,D,2,2,11823,759916,5819508,3362,246262,3397741
2007-12-02,2008,63,D,2,2,11930,771846,5819508,3948,250210,3397741
2007-12-03,2008,64,D,2,2,11878,783724,5819508,3665,253875,3397741
2007-12-04,2008,65,D,2,2,11778,795502,5819508,2999,256874,3397741
2007-12-05,2008,66,D,2,2,11803,807305,5819508,3579,260453,3397741
2007-12-06,2008,67,D,2,2,12719,820024,5819508,6205,266658,3397741
2007-12-07,2008,68,D,2,2,15881,835905,5819508,9979,276637,3397741
2007-12-08,2008,69,D,2,2,16693,852598,5819508,10262,286899,3397741
2007-12-09,2008,70,D,2,2,16180,868778,5819508,9210,296109,3397741
2007-12-10,2008,71,D,2,2,15504,884282,5819508,10103,306212,3397741
2007-12-11,2008,72,D,2,2,14700,898982,5819508,6719,312931,3397741
2007-12-12,2008,73,D,2,2,13888,912870,5819508,2823,315754,3397741
2007-12-13,2008,74,D,2,2,13197,926067,5819508,2113,317867,3397741
2007-12-14,2008,75,D,2,2,12896,938963,5819508,1812,319679,3397741
2007-12-15,2008,76,D,2,2,12576,951539,5819508,3307,322986,3397741
2007-12-16,2008,77,D,2,2,12162,963701,5819508,3866,326852,3397741
2007-12-17,2008,78,D,2,2,12553,976254,5819508,4176,331028,3397741
2007-12-18,2008,79,D,2,2,12604,988858,5819508,6479,337507,3397741
2007-12-19,2008,80,D,2,2,13700,1002558,5819508,7782,345289,3397741
2007-12-20,2008,81,D,2,2,14678,1017236,5819508,11302,356591,3397741
2007-12-21,2008,82,D,2,2,17098,1034334,5819508,13733,370324,3397741
2007-12-22,2008,83,D,2,2,18400,1052734,5819508,15056,385380,3397741
2007-12-23,2008,84,D,2,2,18350,1071084,5819508,13764,399144,3397741
2007-12-24,2008,85,D,2,2,16722,1087806,5819508,11918,411062,3397741
2007-12-25,2008,86,D,2,2,14995,1102801,5819508,7738,418800,3397741
2007-12-26,2008,87,D,2,2,14182,1116983,5819508,6936,425736,3397741
2007-12-27,2008,88,D,2,2,13469,1130452,5819508,4226,429962,3397741
2007-12-28,2008,89,D,2,2,13245,1143697,5819508,8536,438498,3397741
2007-12-29,2008,90,D,2,2,12932,1156629,5819508,8978,447476,3397741
2007-12-30,2008,91,D,2,2,13034,1169663,5819508,9122,456598,3397741
2007-12-31,2008,92,D,2,2,12914,1182577,5819508,9055,465653,3397741
2008-01-01,2008,93,D,2,2,12798,1195375,5819508,9040,474693,3397741
2008-01-02,2008,94,D,2,2,12465,1207840,5819508,8188,482881,3397741
2008-01-03,2008,95,D,2,2,12260,1220100,5819508,10415,493296,3397741
2008-01-04,2008,96,D,2,2,14810,1234910,5819508,22641,515937,3397741
2008-01-05,2008,97,D,2,2,23954,1258864,5819508,36168,552105,3397741
2008-01-06,2008,98,D,2,2,36447,1295311,5819508,46524,598629,3397741
2008-01-07,2008,99,D,2,2,40546,1335857,5819508,50477,649106,3397741
2008-01-08,2008,100,D,2,2,37012,1372869,5819508,43644,692750,3397741
2008-01-09,2008,101,D,2,2,32982,1405851,5819508,29531,722281,3397741
2008-01-10,2008,102,D,2,2,30944,1436795,5819508,23362,745643,3397741
2008-01-11,2008,103,D,2,2,30953,1467748,5819508,23348,768991,3397741
2008-01-12,2008,104,D,2,2,29629,1497377,5819508,21829,790820,3397741
2008-01-13,2008,105,D,2,2,28330,1525707,5819508,19863,810683,3397741
2008-01-14,2008,106,D,2,2,24869,1550576,5819508,18090,828773,3397741
2008-01-15,2008,107,D,2,2,22871,1573447,5819508,16176,844949,3397741
2008-01-16,2008,108,D,2,2,21122,1594569,5819508,14947,859896,3397741
2008-01-17,2008,109,D,2,2,19371,1613940,5819508,12684,872580,3397741
2008-01-18,2008,110,D,2,2,17612,1631552,5819508,10781,883361,3397741
2008-01-19,2008,111,D,2,2,16101,1647653,5819508,8966,892327,3397741
2008-01-20,2008,112,D,2,2,14778,1662431,5819508,7677,900004,3397741
2008-01-21,2008,113,D,2,2,14461,1676892,5819508,8553,908557,3397741
2008-01-22,2008,114,D,2,2,15410,1692302,5819508,14050,922607,3397741
2008-01-23,2008,115,D,2,2,16519,1708821,5819508,18199,940806,3397741
2008-01-24,2008,116,D,2,2,19260,1728081,5819508,21185,961991,3397741
2008-01-25,2008,117,D,2,2,22241,1750322,5819508,23803,985794,3397741
2008-01-26,2008,118,D,2,2,27410,1777732,5819508,28562,1014356,3397741
2008-01-27,2008,119,D,2,2,39562,1817294,5819508,37519,1051875,3397741
2008-01-28,2008,120,D,2,2,48624,1865918,5819508,43200,1095075,3397741
2008-01-29,2008,121,D,2,2,50593,1916511,5819508,44870,1139945,3397741
2008-01-30,2008,122,D,2,2,50291,1966802,5819508,44804,1184749,3397741
2008-01-31,2008,123,D,2,2,47542,2014344,5819508,42266,1227015,3397741
2008-02-01,2008,124,D,2,2,45404,2059748,5819508,38290,1265305,3397741
2008-02-02,2008,125,D,2,2,44852,2104600,5819508,39326,1304631,3397741
2008-02-03,2008,126,D,2,2,45657,2150257,5819508,41724,1346355,3397741
2008-02-04,2008,127,D,2,2,42784,2193041,5819508,39993,1386348,3397741
2008-02-05,2008,128,D,2,2,42137,2235178,5819508,37427,1423775,3397741
2008-02-06,2008,129,D,2,2,40946,2276124,5819508,36276,1460051,3397741
2008-02-07,2008,130,D,2,2,37664,2313788,5819508,31384,1491435,3397741
2008-02-08,2008,131,D,2,2,33766,2347554,5819508,25431,1516866,3397741
2008-02-09,2008,132,D,2,2,30648,2378202,5819508,22730,1539596,3397741
2008-02-10,2008,133,D,2,2,28013,2406215,5819508,20149,1559745,3397741
2008-02-11,2008,134,D,2,2,26170,2432385,5819508,17795,1577540,3397741
2008-02-12,2008,135,D,2,2,24415,2456800,5819508,16029,1593569,3397741
2008-02-13,2008,136,D,2,2,23384,2480184,5819508,14977,1608546,3397741
2008-02-14,2008,137,D,2,2,23684,2503868,5819508,15300,1623846,3397741
2008-02-15,2008,138,D,2,2,23542,2527410,5819508,15341,1639187,3397741
2008-02-16,2008,139,D,2,2,22050,2549460,5819508,13474,1652661,3397741
2008-02-17,2008,140,D,2,2,19597,2569057,5819508,11455,1664116,3397741
2008-02-18,2008,141,D,2,2,18441,2587498,5819508,11174,1675290,3397741
2008-02-19,2008,142,D,2,2,17704,2605202,5819508,11630,1686920,3397741
2008-02-20,2008,143,D,2,2,18578,2623780,5819508,12546,1699466,3397741
2008-02-21,2008,144,D,2,2,17872,2641652,5819508,11700,1711166,3397741
2008-02-22,2008,145,D,2,2,18240,2659892,5819508,12201,1723367,3397741
2008-02-23,2008,146,D,2,2,19512,2679404,5819508,14332,1737699,3397741
2008-02-24,2008,147,D,2,2,23406,2702810,5819508,18004,1755703,3397741
2008-02-25,2008,148,D,2,2,33572,2736382,5819508,27705,1783408,3397741
2008-02-26,2008,149,D,2,2,42127,2778509,5819508,36326,1819734,3397741
2008-02-27,2008,150,D,2,2,43594,2822103,5819508,38082,1857816,3397741
2008-02-28,2008,151,D,2,2,41667,2863770,5819508,36046,1893862,3397741
2008-02-29,2008,152,D,2,2,38098,2901868,5819508,32870,1926732,3397741
2008-03-01,2008,153,D,2,2,33916,2935784,5819508,29179,1955911,3397741
2008-03-02,2008,154,D,2,2,30372,2966156,5819508,26565,1982476,3397741
2008-03-03,2008,155,D,2,2,27001,2993157,5819508,23367,2005843,3397741
2008-03-04,2008,156,D,2,2,23831,3016988,5819508,19194,2025037,3397741
2008-03-05,2008,157,D,2,2,21772,3038760,5819508,16323,2041360,3397741
2008-03-06,2008,158,D,2,2,20384,3059144,5819508,14117,2055477,3397741
2008-03-07,2008,159,D,2,2,18992,3078136,5819508,11618,2067095,3397741
2008-03-08,2008,160,D,2,2,17250,3095386,5819508,9750,2076845,3397741
2008-03-09,2008,161,D,2,2,16716,3112102,5819508,9588,2086433,3397741
2008-03-10,2008,162,D,2,2,16610,3128712,5819508,10525,2096958,3397741
2008-03-11,2008,163,D,2,2,16109,3144821,5819508,10569,2107527,3397741
2008-03-12,2008,164,D,2,2,15642,3160463,5819508,10710,2118237,3397741
2008-03-13,2008,165,D,2,2,15009,3175472,5819508,11214,2129451,3397741
2008-03-14,2008,166,D,2,2,15318,3190790,5819508,11308,2140759,3397741
2008-03-15,2008,167,D,2,2,15326,3206116,5819508,12069,2152828,3397741
2008-03-16,2008,168,D,2,2,15773,3221889,5819508,12455,2165283,3397741
2008-03-17,2008,169,D,2,2,15147,3237036,5819508,11757,2177040,3397741
2008-03-18,2008,170,D,2,2,14990,3252026,5819508,10550,2187590,3397741
2008-03-19,2008,171,D,2,2,14340,3266366,5819508,9851,2197441,3397741
2008-03-20,2008,172,D,2,2,14540,3280906,5819508,10060,2207501,3397741
2008-03-21,2008,173,D,2,2,14410,3295316,5819508,9803,2217304,3397741
2008-03-22,2008,174,D,2,2,13696,3309012,5819508,8865,2226169,3397741
2008-03-23,2008,175,D,2,2,13897,3322909,5819508,9523,2235692,3397741
2008-03-24,2008,176,D,2,2,13768,3336677,5819508,8932,2244624,3397741
2008-03-25,2008,177,D,2,2,13334,3350011,5819508,7517,2252141,3397741
2008-03-26,2008,178,D,2,2,13370,3363381,5819508,7506,2259647,3397741
2008-03-27,2008,179,D,2,2,13305,3376686,5819508,7929,2267576,3397741
2008-03-28,2008,180,D,2,2,12997,3389683,5819508,8368,2275944,3397741
2008-03-29,2008,181,D,2,2,13230,3402913,5819508,9300,2285244,3397741
2008-03-30,2008,182,D,2,2,13109,3416022,5819508,10030,2295274,3397741
2008-03-31,2008,183,D,2,2,13312,3429334,5819508,10284,2305558,3397741
2008-04-01,2008,184,D,2,2,12496,3441830,5819508,8465,2314023,3397741
2008-04-02,2008,185,D,2,2,12669,3454499,5819508,7676,2321699,3397741
2008-04-03,2008,186,D,2,2,12498,3466997,5819508,6902,2328601,3397741
2008-04-04,2008,187,D,2,2,11800,3478797,5819508,5401,2334002,3397741
2008-04-05,2008,188,D,2,2,11665,3490462,5819508,5550,2339552,3397741
2008-04-06,2008,189,D,2,2,11432,3501894,5819508,5792,2345344,3397741
2008-04-07,2008,190,D,2,2,12093,3513987,5819508,6375,2351719,3397741
2008-04-08,2008,191,D,2,2,11968,3525955,5819508,6701,2358420,3397741
2008-04-09,2008,192,D,2,2,12819,3538774,5819508,7608,2366028,3397741
2008-04-10,2008,193,D,2,2,13683,3552457,5819508,9438,2375466,3397741
2008-04-11,2008,194,D,2,2,15155,3567612,5819508,11451,2386917,3397741
2008-04-12,2008,195,D,2,2,15555,3583167,5819508,12364,2399281,3397741
2008-04-13,2008,196,D,2,2,15844,3599011,5819508,12591,2411872,3397741
2008-04-14,2008,197,D,2,2,15209,3614220,5819508,11469,2423341,3397741
2008-04-15,2008,198,D,2,2,16374,3630594,5819508,12626,2435967,3397741
2008-04-16,2008,199,D,2,2,16082,3646676,5819508,11821,2447788,3397741
2008-04-17,2008,200,D,2,2,15709,3662385,5819508,11442,2459230,3397741
2008-04-18,2008,201,D,2,2,15156,3677541,5819508,10858,2470088,3397741
2008-04-19,2008,202,D,2,2,14681,3692222,5819508,10842,2480930,3397741
2008-04-20,2008,203,D,2,2,15363,3707585,5819508,11601,2492531,3397741
2008-04-21,2008,204,D,2,2,15312,3722897,5819508,11667,2504198,3397741
2008-04-22,2008,205,D,2,2,14798,3737695,5819508,11333,2515531,3397741
2008-04-23,2008,206,D,2,2,14001,3751696,5819508,10557,2526088,3397741
2008-04-24,2008,207,D,2,2,14154,3765850,5819508,10693,2536781,3397741
2008-04-25,2008,208,D,2,2,13673,3779523,5819508,10170,2546951,3397741
2008-04-26,2008,209,D,2,2,13201,3792724,5819508,9677,2556628,3397741
2008-04-27,2008,210,D,2,2,12789,3805513,5819508,9209,2565837,3397741
2008-04-28,2008,211,D,2,2,12262,3817775,5819508,8689,2574526,3397741
2008-04-29,2008,212,D,2,2,11660,3829435,5819508,8061,2582587,3397741
2008-04-30,2008,213,D,2,2,12721,3842156,5819508,9171,2591758,3397741
2008-05-01,2008,214,D,2,2,12365,3854521,5819508,8635,2600393,3397741
2008-05-02,2008,215,D,2,2,12282,3866803,5819508,8521,2608914,3397741
2008-05-03,2008,216,D,2,2,11911,3878714,5819508,8075,2616989,3397741
2008-05-04,2008,217,D,2,2,11016,3889730,5819508,7121,2624110,3397741
2008-05-05,2008,218,D,2,2,11213,3900943,5819508,7355,2631465,3397741
2008-05-06,2008,219,D,2,2,11969,3912912,5819508,8082,2639547,3397741
2008-05-07,2008,220,D,2,2,12496,3925408,5819508,8573,2648120,3397741
2008-05-08,2008,221,D,2,2,12211,3937619,5819508,8277,2656397,3397741
2008-05-09,2008,222,D,2,2,12595,3950214,5819508,8613,2665010,3397741
2008-05-10,2008,223,D,2,2,12504,3962718,5819508,8509,2673519,3397741
2008-05-11,2008,224,D,2,2,12161,3974879,5819508,8128,2681647,3397741
2008-05-12,2008,225,D,2,2,12883,3987762,5819508,8805,2690452,3397741
2008-05-13,2008,226,D,2,2,12827,4000589,5819508,8771,2699223,3397741
2008-05-14,2008,227,D,2,2,12920,4013509,5819508,8798,2708021,3397741
2008-05-15,2008,228,D,2,2,12526,4026035,5819508,8365,2716386,3397741
2008-05-16,2008,229,D,2,2,11618,4037653,5819508,7581,2723967,3397741
2008-05-17,2008,230,D,2,2,11205,4048858,5819508,6867,2730834,3397741
2008-05-18,2008,231,D,2,2,11748,4060606,5819508,7458,2738292,3397741
2008-05-19,2008,232,D,2,2,11825,4072431,5819508,7542,2745834,3397741
2008-05-20,2008,233,D,2,2,11731,4084162,5819508,7558,2753392,3397741
2008-05-21,2008,234,D,2,2,13524,4097686,5819508,9023,2762415,3397741
2008-05-22,2008,235,D,2,2,14332,4112018,5819508,9974,2772389,3397741
2008-05-23,2008,236,D,2,2,14115,4126133,5819508,8828,2781217,3397741
2008-05-24,2008,237,D,2,2,14392,4140525,5819508,8903,2790120,3397741
2008-05-25,2008,238,D,2,2,13822,4154347,5819508,8754,2798874,3397741
2008-05-26,2008,239,D,2,2,13346,4167693,5819508,7840,2806714,3397741
2008-05-27,2008,240,D,2,2,13269,4180962,5819508,8091,2814805,3397741
2008-05-28,2008,241,D,2,2,12952,4193914,5819508,7721,2822526,3397741
2008-05-29,2008,242,D,2,2,13444,4207358,5819508,8086,2830612,3397741
2008-05-30,2008,243,D,2,2,13695,4221053,5819508,7909,2838521,3397741
2008-05-31,2008,244,D,2,2,13441,4234494,5819508,7897,2846418,3397741
2008-06-01,2008,245,D,2,2,13830,4248324,5819508,8313,2854731,3397741
2008-06-02,2008,246,D,2,2,13639,4261963,5819508,8144,2862875,3397741
2008-06-03,2008,247,D,2,2,12718,4274681,5819508,7124,2869999,3397741
2008-06-04,2008,248,D,2,2,12902,4287583,5819508,7533,2877532,3397741
2008-06-05,2008,249,D,2,2,12650,4300233,5819508,7327,2884859,3397741
2008-06-06,2008,250,D,2,2,12683,4312916,5819508,7225,2892084,3397741
2008-06-07,2008,251,D,2,2,12511,4325427,5819508,7032,2899116,3397741
2008-06-08,2008,252,D,2,2,11556,4336983,5819508,5832,2904948,3397741
2008-06-09,2008,253,D,2,2,10835,4347818,5819508,5574,2910522,3397741
2008-06-10,2008,254,D,2,2,11927,4359745,5819508,7410,2917932,3397741
2008-06-11,2008,255,D,2,2,12484,4372229,5819508,8003,2925935,3397741
2008-06-12,2008,256,D,2,2,12945,4385174,5819508,8434,2934369,3397741
2008-06-13,2008,257,D,2,2,12905,4398079,5819508,7636,2942005,3397741
2008-06-14,2008,258,D,2,2,12868,4410947,5819508,7435,2949440,3397741
2008-06-15,2008,259,D,2,2,13090,4424037,5819508,7608,2957048,3397741
2008-06-16,2008,260,D,2,2,12992,4437029,5819508,6871,2963919,3397741
2008-06-17,2008,261,D,2,2,12848,4449877,5819508,6688,2970607,3397741
2008-06-18,2008,262,D,2,2,12557,4462434,5819508,6338,2976945,3397741
2008-06-19,2008,263,D,2,2,13150,4475584,5819508,7022,2983967,3397741
2008-06-20,2008,264,D,2,2,13915,4489499,5819508,7626,2991593,3397741
2008-06-21,2008,265,D,2,2,14330,4503829,5819508,7968,2999561,3397741
2008-06-22,2008,266,D,2,2,14221,4518050,5819508,7555,3007116,3397741
2008-06-23,2008,267,D,2,2,14487,4532537,5819508,7602,3014718,3397741
2008-06-24,2008,268,D,2,2,14513,4547050,5819508,7154,3021872,3397741
2008-06-25,2008,269,D,2,2,14117,4561167,5819508,7191,3029063,3397741
2008-06-26,2008,270,D,2,2,14125,4575292,5819508,7393,3036456,3397741
2008-06-27,2008,271,D,2,2,13873,4589165,5819508,7109,3043565,3397741
2008-06-28,2008,272,D,2,2,14326,4603491,5819508,7570,3051135,3397741
2008-06-29,2008,273,D,2,2,14671,4618162,5819508,7836,3058971,3397741
2008-06-30,2008,274,D,2,2,14875,4633037,5819508,7419,3066390,3397741
2008-07-01,2008,275,D,2,2,14848,4647885,5819508,5301,3071691,3397741
2008-07-02,2008,276,D,2,2,14731,4662616,5819508,4869,3076560,3397741
2008-07-03,2008,277,D,2,2,14747,4677363,5819508,3884,3080444,3397741
2008-07-04,2008,278,D,2,2,15038,4692401,5819508,4154,3084598,3397741
2008-07-05,2008,279,D,2,2,14836,4707237,5819508,3885,3088483,3397741
2008-07-06,2008,280,D,2,2,14724,4721961,5819508,3891,3092374,3397741
2008-07-07,2008,281,D,2,2,14619,4736580,5819508,3639,3096013,3397741
2008-07-08,2008,282,D,2,2,14765,4751345,5819508,3427,3099440,3397741
2008-07-09,2008,283,D,2,2,14711,4766056,5819508,3110,3102550,3397741
2008-07-10,2008,284,D,2,2,14248,4780304,5819508,2686,3105236,3397741
2008-07-11,2008,285,D,2,2,13729,4794033,5819508,2588,3107824,3397741
2008-07-12,2008,286,D,2,2,14662,4808695,5819508,3580,3111404,3397741
2008-07-13,2008,287,D,2,2,14404,4823099,5819508,3300,3114704,3397741
2008-07-14,2008,288,D,2,2,14427,4837526,5819508,3288,3117992,3397741
2008-07-15,2008,289,D,2,2,14979,4852505,5819508,3788,3121780,3397741
2008-07-16,2008,290,D,2,2,15152,4867657,5819508,3983,3125763,3397741
2008-07-17,2008,291,D,2,2,14787,4882444,5819508,4126,3129889,3397741
2008-07-18,2008,292,D,2,2,14847,4897291,5819508,4144,3134033,3397741
2008-07-19,2008,293,D,2,2,14761,4912052,5819508,4062,3138095,3397741
2008-07-20,2008,294,D,2,2,14515,4926567,5819508,3856,3141951,3397741
2008-07-21,2008,295,D,2,2,14912,4941479,5819508,4247,3146198,3397741
2008-07-22,2008,296,D,2,2,14394,4955873,5819508,3758,3149956,3397741
2008-07-23,2008,297,D,2,2,13538,4969411,5819508,2902,3152858,3397741
2008-07-24,2008,298,D,2,2,13315,4982726,5819508,3374,3156232,3397741
2008-07-25,2008,299,D,2,2,13539,4996265,5819508,3856,3160088,3397741
2008-07-26,2008,300,D,2,2,13386,5009651,5819508,3706,3163794,3397741
2008-07-27,2008,301,D,2,2,13468,5023119,5819508,3719,3167513,3397741
2008-07-28,2008,302,D,2,2,13461,5036580,5819508,3642,3171155,3397741
2008-07-29,2008,303,D,2,2,13454,5050034,5819508,3329,3174484,3397741
2008-07-30,2008,304,D,2,2,13380,5063414,5819508,3254,3177738,3397741
2008-07-31,2008,305,D,2,2,12931,5076345,5819508,2558,3180296,3397741
2008-08-01,2008,306,D,2,2,12718,5089063,5819508,2480,3182776,3397741
2008-08-02,2008,307,D,2,2,12764,5101827,5819508,2527,3185303,3397741
2008-08-03,2008,308,D,2,2,12520,5114347,5819508,2302,3187605,3397741
2008-08-04,2008,309,D,2,2,12542,5126889,5819508,2415,3190020,3397741
2008-08-05,2008,310,D,2,2,12390,5139279,5819508,2692,3192712,3397741
2008-08-06,2008,311,D,2,2,12249,5151528,5819508,2556,3195268,3397741
2008-08-07,2008,312,D,2,2,11935,5163463,5819508,2282,3197550,3397741
2008-08-08,2008,313,D,2,2,11969,5175432,5819508,2300,3199850,3397741
2008-08-09,2008,314,D,2,2,12204,5187636,5819508,3147,3202997,3397741
2008-08-10,2008,315,D,2,2,12503,5200139,5819508,3846,3206843,3397741
2008-08-11,2008,316,D,2,2,12148,5212287,5819508,3542,3210385,3397741
2008-08-12,2008,317,D,2,2,12258,5224545,5819508,3663,3214048,3397741
2008-08-13,2008,318,D,2,2,12020,5236565,5819508,3501,3217549,3397741
2008-08-14,2008,319,D,2,2,11806,5248371,5819508,3388,3220937,3397741
2008-08-15,2008,320,D,2,2,11853,5260224,5819508,3437,3224374,3397741
2008-08-16,2008,321,D,2,2,11813,5272037,5819508,3469,3227843,3397741
2008-08-17,2008,322,D,2,2,12129,5284166,5819508,3695,3231538,3397741
2008-08-18,2008,323,D,2,2,12079,5296245,5819508,3666,3235204,3397741
2008-08-19,2008,324,D,2,2,12080,5308325,5819508,3568,3238772,3397741
2008-08-20,2008,325,D,2,2,12276,5320601,5819508,3088,3241860,3397741
2008-08-21,2008,326,D,2,2,12581,5333182,5819508,3407,3245267,3397741
2008-08-22,2008,327,D,2,2,12912,5346094,5819508,3815,3249082,3397741
2008-08-23,2008,328,D,2,2,12853,5358947,5819508,3748,3252830,3397741
2008-08-24,2008,329,D,2,2,13040,5371987,5819508,3983,3256813,3397741
2008-08-25,2008,330,D,2,2,12835,5384822,5819508,2471,3259284,3397741
2008-08-26,2008,331,D,2,2,13351,5398173,5819508,2760,3262044,3397741
2008-08-27,2008,332,D,2,2,13052,5411225,5819508,2523,3264567,3397741
2008-08-28,2008,333,D,2,2,13158,5424383,5819508,2605,3267172,3397741
2008-08-29,2008,334,D,2,2,13057,5437440,5819508,2539,3269711,3397741
2008-08-30,2008,335,D,2,2,13099,5450539,5819508,2629,3272340,3397741
2008-08-31,2008,336,D,2,2,13642,5464181,5819508,3251,3275591,3397741
2008-09-01,2008,337,D,2,2,13841,5478022,5819508,4076,3279667,3397741
2008-09-02,2008,338,D,2,2,13023,5491045,5819508,3318,3282985,3397741
2008-09-03,2008,339,D,2,2,12652,5503697,5819508,2929,3285914,3397741
2008-09-04,2008,340,D,2,2,12432,5516129,5819508,2786,3288700,3397741
2008-09-05,2008,341,D,2,2,12906,5529035,5819508,3261,3291961,3397741
2008-09-06,2008,342,D,2,2,13415,5542450,5819508,3803,3295764,3397741
2008-09-07,2008,343,D,2,2,13319,5555769,5819508,3751,3299515,3397741
2008-09-08,2008,344,D,2,2,13014,5568783,5819508,3544,3303059,3397741
2008-09-09,2008,345,D,2,2,12334,5581117,5819508,3238,3306297,3397741
2008-09-10,2008,346,D,2,2,12943,5594060,5819508,5335,3311632,3397741
2008-09-11,2008,347,D,2,2,12721,5606781,5819508,5368,3317000,3397741
2008-09-12,2008,348,D,2,2,12507,5619288,5819508,5696,3322696,3397741
2008-09-13,2008,349,D,2,2,12407,5631695,5819508,6084,3328780,3397741
2008-09-14,2008,350,D,2,2,12132,5643827,5819508,5885,3334665,3397741
2008-09-15,2008,351,D,2,2,11998,5655825,5819508,5748,3340413,3397741
2008-09-16,2008,352,D,2,2,11666,5667491,5819508,4785,3345198,3397741
2008-09-17,2008,353,D,2,2,11365,5678856,5819508,4324,3349522,3397741
2008-09-18,2008,354,D,2,2,11513,5690369,5819508,4560,3354082,3397741
2008-09-19,2008,355,D,2,2,11266,5701635,5819508,4367,3358449,3397741
2008-09-20,2008,356,D,2,2,11268,5712903,5819508,4329,3362778,3397741
2008-09-21,2008,357,D,2,2,11235,5724138,5819508,4360,3367138,3397741
2008-09-22,2008,358,D,2,2,11728,5735866,5819508,5279,3372417,3397741
2008-09-23,2008,359,D,2,2,11699,5747565,5819508,4630,3377047,3397741
2008-09-24,2008,360,D,2,2,11285,5758850,5819508,3811,3380858,3397741
2008-09-25,2008,361,D,2,2,10849,5769699,5819508,3474,3384332,3397741
2008-09-26,2008,362,D,2,2,10557,5780256,5819508,3219,3387551,3397741
2008-09-27,2008,363,D,2,2,10138,5790394,5819508,2815,3390366,3397741
2008-09-28,2008,364,D,2,2,9521,5799915,5819508,2232,3392598,3397741
2008-09-29,2008,365,D,2,2,9634,5809549,5819508,2369,3394967,3397741
2008-09-30,2008,366,D,2,2,9959,5819508,5819508,2774,3397741,3397741
2008-10-01,2009,1,D,3,3+,9857,9857,5809138,2628,2628,3449314
2008-10-02,2009,2,D,3,3+,9166,19023,5809138,2288,4916,3449314
2008-10-03,2009,3,D,3,3+,9277,28300,5809138,2585,7501,3449314
2008-10-04,2009,4,D,3,3+,9172,37472,5809138,3383,10884,3449314
2008-10-05,2009,5,D,3,3+,10177,47649,5809138,4456,15340,3449314
2008-10-06,2009,6,D,3,3+,10252,57901,5809138,4559,19899,3449314
2008-10-07,2009,7,D,3,3+,10285,68186,5809138,4627,24526,3449314
2008-10-08,2009,8,D,3,3+,10058,78244,5809138,3925,28451,3449314
2008-10-09,2009,9,D,3,3+,10296,88540,5809138,3204,31655,3449314
2008-10-10,2009,10,D,3,3+,10213,98753,5809138,3236,34891,3449314
2008-10-11,2009,11,D,3,3+,10169,108922,5809138,3146,38037,3449314
2008-10-12,2009,12,D,3,3+,10019,118941,5809138,3339,41376,3449314
2008-10-13,2009,13,D,3,3+,9812,128753,5809138,3813,45189,3449314
2008-10-14,2009,14,D,3,3+,9778,138531,5809138,3603,48792,3449314
2008-10-15,2009,15,D,3,3+,9325,147856,5809138,3210,52002,3449314
2008-10-16,2009,16,D,3,3+,8698,156554,5809138,2439,54441,3449314
2008-10-17,2009,17,D,3,3+,8529,165083,5809138,1621,56062,3449314
2008-10-18,2009,18,D,3,3+,8056,173139,5809138,1130,57192,3449314
2008-10-19,2009,19,D,3,3+,8502,181641,5809138,1995,59187,3449314
2008-10-20,2009,20,D,3,3+,9156,190797,5809138,2824,62011,3449314
2008-10-21,2009,21,D,3,3+,9635,200432,5809138,3342,65353,3449314
2008-10-22,2009,22,D,3,3+,9345,209777,5809138,3052,68405,3449314
2008-10-23,2009,23,D,3,3+,8939,218716,5809138,2640,71045,3449314
2008-10-24,2009,24,D,3,3+,8823,227539,5809138,2755,73800,3449314
2008-10-25,2009,25,D,3,3+,8673,236212,5809138,2566,76366,3449314
2008-10-26,2009,26,D,3,3+,8431,244643,5809138,2314,78680,3449314
2008-10-27,2009,27,D,3,3+,8264,252907,5809138,2216,80896,3449314
2008-10-28,2009,28,D,3,3+,8859,261766,5809138,3017,83913,3449314
2008-10-29,2009,29,D,3,3+,8953,270719,5809138,3224,87137,3449314
2008-10-30,2009,30,D,3,3+,9129,279848,5809138,5111,92248,3449314
2008-10-31,2009,31,D,3,3+,9613,289461,5809138,6521,98769,3449314
2008-11-01,2009,32,D,3,3+,11177,300638,5809138,13115,111884,3449314
2008-11-02,2009,33,D,3,3+,14061,314699,5809138,16321,128205,3449314
2008-11-03,2009,34,D,3,3+,14090,328789,5809138,17417,145622,3449314
2008-11-04,2009,35,D,3,3+,15942,344731,5809138,15170,160792,3449314
2008-11-05,2009,36,D,3,3+,15854,360585,5809138,14382,175174,3449314
2008-11-06,2009,37,D,3,3+,15116,375701,5809138,7869,183043,3449314
2008-11-07,2009,38,D,3,3+,14352,390053,5809138,6167,189210,3449314
2008-11-08,2009,39,D,3,3+,12894,402947,5809138,3824,193034,3449314
2008-11-09,2009,40,D,3,3+,12510,415457,5809138,3905,196939,3449314
2008-11-10,2009,41,D,3,3+,12257,427714,5809138,4199,201138,3449314
2008-11-11,2009,42,D,3,3+,11852,439566,5809138,3822,204960,3449314
2008-11-12,2009,43,D,3,3+,11404,450970,5809138,2723,207683,3449314
2008-11-13,2009,44,D,3,3+,11168,462138,5809138,2544,210227,3449314
2008-11-14,2009,45,D,3,3+,10857,472995,5809138,2409,212636,3449314
2008-11-15,2009,46,D,3,3+,10803,483798,5809138,2293,214929,3449314
2008-11-16,2009,47,D,3,3+,10763,494561,5809138,2260,217189,3449314
2008-11-17,2009,48,D,3,3+,10691,505252,5809138,2866,220055,3449314
2008-11-18,2009,49,D,3,3+,10273,515525,5809138,2675,222730,3449314
2008-11-19,2009,50,D,3,3+,9771,525296,5809138,3147,225877,3449314
2008-11-20,2009,51,D,3,3+,10131,535427,5809138,3437,229314,3449314
2008-11-21,2009,52,D,3,3+,9739,545166,5809138,3086,232400,3449314
2008-11-22,2009,53,D,3,3+,9312,554478,5809138,2672,235072,3449314
2008-11-23,2009,54,D,3,3+,9114,563592,5809138,3057,238129,3449314
2008-11-24,2009,55,D,3,3+,8543,572135,5809138,2541,240670,3449314
2008-11-25,2009,56,D,3,3+,8984,581119,5809138,3722,244392,3449314
2008-11-26,2009,57,D,3,3+,8762,589881,5809138,5234,249626,3449314
2008-11-27,2009,58,D,3,3+,8950,598831,5809138,5817,255443,3449314
2008-11-28,2009,59,D,3,3+,9339,608170,5809138,6180,261623,3449314
2008-11-29,2009,60,D,3,3+,9042,617212,5809138,5881,267504,3449314
2008-11-30,2009,61,D,3,3+,9010,626222,5809138,5797,273301,3449314
2008-12-01,2009,62,D,3,3+,8794,635016,5809138,4164,277465,3449314
2008-12-02,2009,63,D,3,3+,9338,644354,5809138,4707,282172,3449314
2008-12-03,2009,64,D,3,3+,9445,653799,5809138,4195,286367,3449314
2008-12-04,2009,65,D,3,3+,9264,663063,5809138,3713,290080,3449314
2008-12-05,2009,66,D,3,3+,9678,672741,5809138,4091,294171,3449314
2008-12-06,2009,67,D,3,3+,9535,682276,5809138,4472,298643,3449314
2008-12-07,2009,68,D,3,3+,9190,691466,5809138,4093,302736,3449314
2008-12-08,2009,69,D,3,3+,9081,700547,5809138,4221,306957,3449314
2008-12-09,2009,70,D,3,3+,8954,709501,5809138,4081,311038,3449314
2008-12-10,2009,71,D,3,3+,8766,718267,5809138,3792,314830,3449314
2008-12-11,2009,72,D,3,3+,8563,726830,5809138,3579,318409,3449314
2008-12-12,2009,73,D,3,3+,8257,735087,5809138,3274,321683,3449314
2008-12-13,2009,74,D,3,3+,8597,743684,5809138,3805,325488,3449314
2008-12-14,2009,75,D,3,3+,8896,752580,5809138,6443,331931,3449314
2008-12-15,2009,76,D,3,3+,9024,761604,5809138,7486,339417,3449314
2008-12-16,2009,77,D,3,3+,10327,771931,5809138,9929,349346,3449314
2008-12-17,2009,78,D,3,3+,9547,781478,5809138,9154,358500,3449314
2008-12-18,2009,79,D,3,3+,9876,791354,5809138,9529,368029,3449314
2008-12-19,2009,80,D,3,3+,10037,801391,5809138,8313,376342,3449314
2008-12-20,2009,81,D,3,3+,10243,811634,5809138,7305,383647,3449314
2008-12-21,2009,82,D,3,3+,10094,821728,5809138,7664,391311,3449314
2008-12-22,2009,83,D,3,3+,9859,831587,5809138,7878,399189,3449314
2008-12-23,2009,84,D,3,3+,10735,842322,5809138,8818,408007,3449314
2008-12-24,2009,85,D,3,3+,10702,853024,5809138,9238,417245,3449314
2008-12-25,2009,86,D,3,3+,10805,863829,5809138,11676,428921,3449314
2008-12-26,2009,87,D,3,3+,13548,877377,5809138,13072,441993,3449314
2008-12-27,2009,88,D,3,3+,15303,892680,5809138,14201,456194,3449314
2008-12-28,2009,89,D,3,3+,15625,908305,5809138,14494,470688,3449314
2008-12-29,2009,90,D,3,3+,13589,921894,5809138,10865,481553,3449314
2008-12-30,2009,91,D,3,3+,12568,934462,5809138,6873,488426,3449314
2008-12-31,2009,92,D,3,3+,12153,946615,5809138,5391,493817,3449314
2009-01-01,2009,93,D,3,3+,11932,958547,5809138,4298,498115,3449314
2009-01-02,2009,94,D,3,3+,10891,969438,5809138,3761,501876,3449314
2009-01-03,2009,95,D,3,3+,11336,980774,5809138,4230,506106,3449314
2009-01-04,2009,96,D,3,3+,11053,991827,5809138,4521,510627,3449314
2009-01-05,2009,97,D,3,3+,10920,1002747,5809138,4840,515467,3449314
2009-01-06,2009,98,D,3,3+,10573,1013320,5809138,4365,519832,3449314
2009-01-07,2009,99,D,3,3+,10056,1023376,5809138,3367,523199,3449314
2009-01-08,2009,100,D,3,3+,9523,1032899,5809138,2820,526019,3449314
2009-01-09,2009,101,D,3,3+,9810,1042709,5809138,3875,529894,3449314
2009-01-10,2009,102,D,3,3+,9744,1052453,5809138,4408,534302,3449314
2009-01-11,2009,103,D,3,3+,9437,1061890,5809138,4111,538413,3449314
2009-01-12,2009,104,D,3,3+,9637,1071527,5809138,4354,542767,3449314
2009-01-13,2009,105,D,3,3+,9625,1081152,5809138,4082,546849,3449314
2009-01-14,2009,106,D,3,3+,9342,1090494,5809138,3843,550692,3449314
2009-01-15,2009,107,D,3,3+,9331,1099825,5809138,3609,554301,3449314
2009-01-16,2009,108,D,3,3+,9584,1109409,5809138,3881,558182,3449314
2009-01-17,2009,109,D,3,3+,9348,1118757,5809138,3642,561824,3449314
2009-01-18,2009,110,D,3,3+,9342,1128099,5809138,3702,565526,3449314
2009-01-19,2009,111,D,3,3+,8954,1137053,5809138,3289,568815,3449314
2009-01-20,2009,112,D,3,3+,8484,1145537,5809138,2803,571618,3449314
2009-01-21,2009,113,D,3,3+,8117,1153654,5809138,4781,576399,3449314
2009-01-22,2009,114,D,3,3+,9431,1163085,5809138,10712,587111,3449314
2009-01-23,2009,115,D,3,3+,10081,1173166,5809138,13503,600614,3449314
2009-01-24,2009,116,D,3,3+,10651,1183817,5809138,13671,614285,3449314
2009-01-25,2009,117,D,3,3+,11296,1195113,5809138,13990,628275,3449314
2009-01-26,2009,118,D,3,3+,12434,1207547,5809138,14001,642276,3449314
2009-01-27,2009,119,D,3,3+,15238,1222785,5809138,12037,654313,3449314
2009-01-28,2009,120,D,3,3+,15405,1238190,5809138,9594,663907,3449314
2009-01-29,2009,121,D,3,3+,14318,1252508,5809138,8054,671961,3449314
2009-01-30,2009,122,D,3,3+,12816,1265324,5809138,8316,680277,3449314
2009-01-31,2009,123,D,3,3+,12045,1277369,5809138,9029,689306,3449314
2009-02-01,2009,124,D,3,3+,11793,1289162,5809138,8785,698091,3449314
2009-02-02,2009,125,D,3,3+,11324,1300486,5809138,8303,706394,3449314
2009-02-03,2009,126,D,3,3+,10623,1311109,5809138,7627,714021,3449314
2009-02-04,2009,127,D,3,3+,10590,1321699,5809138,7558,721579,3449314
2009-02-05,2009,128,D,3,3+,10450,1332149,5809138,8347,729926,3449314
2009-02-06,2009,129,D,3,3+,10702,1342851,5809138,10424,740350,3449314
2009-02-07,2009,130,D,3,3+,10559,1353410,5809138,10292,750642,3449314
2009-02-08,2009,131,D,3,3+,9834,1363244,5809138,10033,760675,3449314
2009-02-09,2009,132,D,3,3+,10468,1373712,5809138,10651,771326,3449314
2009-02-10,2009,133,D,3,3+,10853,1384565,5809138,10872,782198,3449314
2009-02-11,2009,134,D,3,3+,11191,1395756,5809138,9028,791226,3449314
2009-02-12,2009,135,D,3,3+,12117,1407873,5809138,9864,801090,3449314
2009-02-13,2009,136,D,3,3+,12299,1420172,5809138,13903,814993,3449314
2009-02-14,2009,137,D,3,3+,13744,1433916,5809138,15657,830650,3449314
2009-02-15,2009,138,D,3,3+,14277,1448193,5809138,15475,846125,3449314
2009-02-16,2009,139,D,3,3+,15735,1463928,5809138,17110,863235,3449314
2009-02-17,2009,140,D,3,3+,23868,1487796,5809138,32404,895639,3449314
2009-02-18,2009,141,D,3,3+,36114,1523910,5809138,40281,935920,3449314
2009-02-19,2009,142,D,3,3+,40209,1564119,5809138,43109,979029,3449314
2009-02-20,2009,143,D,3,3+,41223,1605342,5809138,43399,1022428,3449314
2009-02-21,2009,144,D,3,3+,38235,1643577,5809138,38989,1061417,3449314
2009-02-22,2009,145,D,3,3+,33329,1676906,5809138,29754,1091171,3449314
2009-02-23,2009,146,D,3,3+,33594,1710500,5809138,30409,1121580,3449314
2009-02-24,2009,147,D,3,3+,42662,1753162,5809138,39490,1161070,3449314
2009-02-25,2009,148,D,3,3+,48372,1801534,5809138,45177,1206247,3449314
2009-02-26,2009,149,D,3,3+,48814,1850348,5809138,45779,1252026,3449314
2009-02-27,2009,150,D,3,3+,46383,1896731,5809138,40370,1292396,3449314
2009-02-28,2009,151,D,3,3+,40710,1937441,5809138,33984,1326380,3449314
2009-03-01,2009,152,D,3,3+,36057,1973498,5809138,29855,1356235,3449314
2009-03-02,2009,153,D,3,3+,34799,2008297,5809138,29817,1386052,3449314
2009-03-03,2009,154,D,3,3+,43755,2052052,5809138,40864,1426916,3449314
2009-03-04,2009,155,D,3,3+,54476,2106528,5809138,53123,1480039,3449314
2009-03-05,2009,156,D,3,3+,54489,2161017,5809138,53794,1533833,3449314
2009-03-06,2009,157,D,3,3+,55020,2216037,5809138,53445,1587278,3449314
2009-03-07,2009,158,D,3,3+,50168,2266205,5809138,47679,1634957,3449314
2009-03-08,2009,159,D,3,3+,42528,2308733,5809138,37712,1672669,3449314
2009-03-09,2009,160,D,3,3+,36161,2344894,5809138,30408,1703077,3449314
2009-03-10,2009,161,D,3,3+,31643,2376537,5809138,25235,1728312,3449314
2009-03-11,2009,162,D,3,3+,27745,2404282,5809138,20519,1748831,3449314
2009-03-12,2009,163,D,3,3+,23720,2428002,5809138,15867,1764698,3449314
2009-03-13,2009,164,D,3,3+,21720,2449722,5809138,13136,1777834,3449314
2009-03-14,2009,165,D,3,3+,19645,2469367,5809138,10641,1788475,3449314
2009-03-15,2009,166,D,3,3+,18985,2488352,5809138,10042,1798517,3449314
2009-03-16,2009,167,D,3,3+,17808,2506160,5809138,8785,1807302,3449314
2009-03-17,2009,168,D,3,3+,17372,2523532,5809138,8203,1815505,3449314
2009-03-18,2009,169,D,3,3+,17344,2540876,5809138,8171,1823676,3449314
2009-03-19,2009,170,D,3,3+,19316,2560192,5809138,10607,1834283,3449314
2009-03-20,2009,171,D,3,3+,19003,2579195,5809138,10524,1844807,3449314
2009-03-21,2009,172,D,3,3+,17369,2596564,5809138,9588,1854395,3449314
2009-03-22,2009,173,D,3,3+,17094,2613658,5809138,9689,1864084,3449314
2009-03-23,2009,174,D,3,3+,17201,2630859,5809138,10858,1874942,3449314
2009-03-24,2009,175,D,3,3+,16112,2646971,5809138,10303,1885245,3449314
2009-03-25,2009,176,D,3,3+,15417,2662388,5809138,10066,1895311,3449314
2009-03-26,2009,177,D,3,3+,15192,2677580,5809138,9567,1904878,3449314
2009-03-27,2009,178,D,3,3+,14866,2692446,5809138,9025,1913903,3449314
2009-03-28,2009,179,D,3,3+,14221,2706667,5809138,8321,1922224,3449314
2009-03-29,2009,180,D,3,3+,14549,2721216,5809138,7761,1929985,3449314
2009-03-30,2009,181,D,3,3+,14085,2735301,5809138,7090,1937075,3449314
2009-03-31,2009,182,D,3,3+,13755,2749056,5809138,7038,1944113,3449314
2009-04-01,2009,183,D,3,3+,13756,2762812,5809138,7165,1951278,3449314
2009-04-02,2009,184,D,3,3+,13244,2776056,5809138,6676,1957954,3449314
2009-04-03,2009,185,D,3,3+,13398,2789454,5809138,7426,1965380,3449314
2009-04-04,2009,186,D,3,3+,13581,2803035,5809138,7802,1973182,3449314
2009-04-05,2009,187,D,3,3+,15205,2818240,5809138,9423,1982605,3449314
2009-04-06,2009,188,D,3,3+,16393,2834633,5809138,12369,1994974,3449314
2009-04-07,2009,189,D,3,3+,16604,2851237,5809138,13774,2008748,3449314
2009-04-08,2009,190,D,3,3+,17400,2868637,5809138,14504,2023252,3449314
2009-04-09,2009,191,D,3,3+,17263,2885900,5809138,14186,2037438,3449314
2009-04-10,2009,192,D,3,3+,17933,2903833,5809138,14560,2051998,3449314
2009-04-11,2009,193,D,3,3+,17912,2921745,5809138,13809,2065807,3449314
2009-04-12,2009,194,D,3,3+,18189,2939934,5809138,12933,2078740,3449314
2009-04-13,2009,195,D,3,3+,17117,2957051,5809138,11416,2090156,3449314
2009-04-14,2009,196,D,3,3+,18376,2975427,5809138,12551,2102707,3449314
2009-04-15,2009,197,D,3,3+,17965,2993392,5809138,12950,2115657,3449314
2009-04-16,2009,198,D,3,3+,17636,3011028,5809138,12912,2128569,3449314
2009-04-17,2009,199,D,3,3+,17246,3028274,5809138,13837,2142406,3449314
2009-04-18,2009,200,D,3,3+,16961,3045235,5809138,13535,2155941,3449314
2009-04-19,2009,201,D,3,3+,16311,3061546,5809138,12888,2168829,3449314
2009-04-20,2009,202,D,3,3+,16321,3077867,5809138,12904,2181733,3449314
2009-04-21,2009,203,D,3,3+,16344,3094211,5809138,12506,2194239,3449314
2009-04-22,2009,204,D,3,3+,15546,3109757,5809138,11822,2206061,3449314
2009-04-23,2009,205,D,3,3+,14802,3124559,5809138,10942,2217003,3449314
2009-04-24,2009,206,D,3,3+,15019,3139578,5809138,11612,2228615,3449314
2009-04-25,2009,207,D,3,3+,15553,3155131,5809138,12199,2240814,3449314
2009-04-26,2009,208,D,3,3+,16582,3171713,5809138,13281,2254095,3449314
2009-04-27,2009,209,D,3,3+,16286,3187999,5809138,12448,2266543,3449314
2009-04-28,2009,210,D,3,3+,16777,3204776,5809138,13005,2279548,3449314
2009-04-29,2009,211,D,3,3+,16768,3221544,5809138,12892,2292440,3449314
2009-04-30,2009,212,D,3,3+,16763,3238307,5809138,12866,2305306,3449314
2009-05-01,2009,213,D,3,3+,16761,3255068,5809138,15445,2320751,3449314
2009-05-02,2009,214,D,3,3+,18763,3273831,5809138,17524,2338275,3449314
2009-05-03,2009,215,D,3,3+,19761,3293592,5809138,18722,2356997,3449314
2009-05-04,2009,216,D,3,3+,22235,3315827,5809138,21056,2378053,3449314
2009-05-05,2009,217,D,3,3+,26510,3342337,5809138,25345,2403398,3449314
2009-05-06,2009,218,D,3,3+,34462,3376799,5809138,30528,2433926,3449314
2009-05-07,2009,219,D,3,3+,35825,3412624,5809138,31636,2465562,3449314
2009-05-08,2009,220,D,3,3+,32805,3445429,5809138,28460,2494022,3449314
2009-05-09,2009,221,D,3,3+,29575,3475004,5809138,25100,2519122,3449314
2009-05-10,2009,222,D,3,3+,26259,3501263,5809138,21609,2540731,3449314
2009-05-11,2009,223,D,3,3+,23523,3524786,5809138,18626,2559357,3449314
2009-05-12,2009,224,D,3,3+,22093,3546879,5809138,17215,2576572,3449314
2009-05-13,2009,225,D,3,3+,20513,3567392,5809138,15602,2592174,3449314
2009-05-14,2009,226,D,3,3+,18873,3586265,5809138,13672,2605846,3449314
2009-05-15,2009,227,D,3,3+,17956,3604221,5809138,13075,2618921,3449314
2009-05-16,2009,228,D,3,3+,17496,3621717,5809138,12561,2631482,3449314
2009-05-17,2009,229,D,3,3+,17559,3639276,5809138,12552,2644034,3449314
2009-05-18,2009,230,D,3,3+,17276,3656552,5809138,12010,2656044,3449314
2009-05-19,2009,231,D,3,3+,17280,3673832,5809138,12374,2668418,3449314
2009-05-20,2009,232,D,3,3+,17142,3690974,5809138,12250,2680668,3449314
2009-05-21,2009,233,D,3,3+,16443,3707417,5809138,11521,2692189,3449314
2009-05-22,2009,234,D,3,3+,15556,3722973,5809138,10573,2702762,3449314
2009-05-23,2009,235,D,3,3+,15291,3738264,5809138,10229,2712991,3449314
2009-05-24,2009,236,D,3,3+,15611,3753875,5809138,10535,2723526,3449314
2009-05-25,2009,237,D,3,3+,15766,3769641,5809138,10636,2734162,3449314
2009-05-26,2009,238,D,3,3+,15683,3785324,5809138,10515,2744677,3449314
2009-05-27,2009,239,D,3,3+,16048,3801372,5809138,11172,2755849,3449314
2009-05-28,2009,240,D,3,3+,15069,3816441,5809138,10497,2766346,3449314
2009-05-29,2009,241,D,3,3+,14663,3831104,5809138,9971,2776317,3449314
2009-05-30,2009,242,D,3,3+,14553,3845657,5809138,9980,2786297,3449314
2009-05-31,2009,243,D,3,3+,15194,3860851,5809138,11443,2797740,3449314
2009-06-01,2009,244,D,3,3+,15214,3876065,5809138,10319,2808059,3449314
2009-06-02,2009,245,D,3,3+,15303,3891368,5809138,10347,2818406,3449314
2009-06-03,2009,246,D,3,3+,15065,3906433,5809138,10041,2828447,3449314
2009-06-04,2009,247,D,3,3+,14576,3921009,5809138,9974,2838421,3449314
2009-06-05,2009,248,D,3,3+,15242,3936251,5809138,10346,2848767,3449314
2009-06-06,2009,249,D,3,3+,15361,3951612,5809138,10329,2859096,3449314
2009-06-07,2009,250,D,3,3+,15708,3967320,5809138,10731,2869827,3449314
2009-06-08,2009,251,D,3,3+,16276,3983596,5809138,11247,2881074,3449314
2009-06-09,2009,252,D,3,3+,16178,3999774,5809138,10841,2891915,3449314
2009-06-10,2009,253,D,3,3+,16002,4015776,5809138,10594,2902509,3449314
2009-06-11,2009,254,D,3,3+,14853,4030629,5809138,9354,2911863,3449314
2009-06-12,2009,255,D,3,3+,14086,4044715,5809138,8531,2920394,3449314
2009-06-13,2009,256,D,3,3+,13284,4057999,5809138,7684,2928078,3449314
2009-06-14,2009,257,D,3,3+,12996,4070995,5809138,7434,2935512,3449314
2009-06-15,2009,258,D,3,3+,12297,4083292,5809138,6764,2942276,3449314
2009-06-16,2009,259,D,3,3+,12215,4095507,5809138,6603,2948879,3449314
2009-06-17,2009,260,D,3,3+,11525,4107032,5809138,5530,2954409,3449314
2009-06-18,2009,261,D,3,3+,11506,4118538,5809138,5119,2959528,3449314
2009-06-19,2009,262,D,3,3+,10965,4129503,5809138,4468,2963996,3449314
2009-06-20,2009,263,D,3,3+,11994,4141497,5809138,5734,2969730,3449314
2009-06-21,2009,264,D,3,3+,12570,4154067,5809138,5873,2975603,3449314
2009-06-22,2009,265,D,3,3+,12263,4166330,5809138,5387,2980990,3449314
2009-06-23,2009,266,D,3,3+,12103,4178433,5809138,5237,2986227,3449314
2009-06-24,2009,267,D,3,3+,12995,4191428,5809138,5908,2992135,3449314
2009-06-25,2009,268,D,3,3+,14118,4205546,5809138,7704,2999839,3449314
2009-06-26,2009,269,D,3,3+,14907,4220453,5809138,7994,3007833,3449314
2009-06-27,2009,270,D,3,3+,14715,4235168,5809138,7717,3015550,3449314
2009-06-28,2009,271,D,3,3+,15067,4250235,5809138,8082,3023632,3449314
2009-06-29,2009,272,D,3,3+,16226,4266461,5809138,7943,3031575,3449314
2009-06-30,2009,273,D,3,3+,17041,4283502,5809138,8104,3039679,3449314
2009-07-01,2009,274,D,3,3+,18221,4301723,5809138,5881,3045560,3449314
2009-07-02,2009,275,D,3,3+,19171,4320894,5809138,5356,3050916,3449314
2009-07-03,2009,276,D,3,3+,19584,4340478,5809138,4662,3055578,3449314
2009-07-04,2009,277,D,3,3+,19650,4360128,5809138,4727,3060305,3449314
2009-07-05,2009,278,D,3,3+,20068,4380196,5809138,5148,3065453,3449314
2009-07-06,2009,279,D,3,3+,20861,4401057,5809138,6240,3071693,3449314
2009-07-07,2009,280,D,3,3+,20831,4421888,5809138,5866,3077559,3449314
2009-07-08,2009,281,D,3,3+,20647,4442535,5809138,5688,3083247,3449314
2009-07-09,2009,282,D,3,3+,20539,4463074,5809138,5101,3088348,3449314
2009-07-10,2009,283,D,3,3+,20665,4483739,5809138,5208,3093556,3449314
2009-07-11,2009,284,D,3,3+,21062,4504801,5809138,5650,3099206,3449314
2009-07-12,2009,285,D,3,3+,21081,4525882,5809138,5639,3104845,3449314
2009-07-13,2009,286,D,3,3+,21365,4547247,5809138,6015,3110860,3449314
2009-07-14,2009,287,D,3,3+,21379,4568626,5809138,5923,3116783,3449314
2009-07-15,2009,288,D,3,3+,21627,4590253,5809138,7793,3124576,3449314
2009-07-16,2009,289,D,3,3+,21183,4611436,5809138,7020,3131596,3449314
2009-07-17,2009,290,D,3,3+,20452,4631888,5809138,5431,3137027,3449314
2009-07-18,2009,291,D,3,3+,20391,4652279,5809138,4274,3141301,3449314
2009-07-19,2009,292,D,3,3+,20251,4672530,5809138,4085,3145386,3449314
2009-07-20,2009,293,D,3,3+,20228,4692758,5809138,4090,3149476,3449314
2009-07-21,2009,294,D,3,3+,20360,4713118,5809138,4208,3153684,3449314
2009-07-22,2009,295,D,3,3+,19462,4732580,5809138,3502,3157186,3449314
2009-07-23,2009,296,D,3,3+,19429,4752009,5809138,3313,3160499,3449314
2009-07-24,2009,297,D,3,3+,17129,4769138,5809138,3190,3163689,3449314
2009-07-25,2009,298,D,3,3+,18949,4788087,5809138,5002,3168691,3449314
2009-07-26,2009,299,D,3,3+,19731,4807818,5809138,5800,3174491,3449314
2009-07-27,2009,300,D,3,3+,19525,4827343,5809138,5694,3180185,3449314
2009-07-28,2009,301,D,3,3+,19589,4846932,5809138,5197,3185382,3449314
2009-07-29,2009,302,D,3,3+,19852,4866784,5809138,3724,3189106,3449314
2009-07-30,2009,303,D,3,3+,20327,4887111,5809138,4731,3193837,3449314
2009-07-31,2009,304,D,3,3+,20670,4907781,5809138,7484,3201321,3449314
2009-08-01,2009,305,D,3,3+,20398,4928179,5809138,6825,3208146,3449314
2009-08-02,2009,306,D,3,3+,20179,4948358,5809138,6631,3214777,3449314
2009-08-03,2009,307,D,3,3+,19913,4968271,5809138,6407,3221184,3449314
2009-08-04,2009,308,D,3,3+,19561,4987832,5809138,5970,3227154,3449314
2009-08-05,2009,309,D,3,3+,17779,5005611,5809138,4193,3231347,3449314
2009-08-06,2009,310,D,3,3+,17117,5022728,5809138,4008,3235355,3449314
2009-08-07,2009,311,D,3,3+,17026,5039754,5809138,3439,3238794,3449314
2009-08-08,2009,312,D,3,3+,16571,5056325,5809138,3982,3242776,3449314
2009-08-09,2009,313,D,3,3+,16499,5072824,5809138,3931,3246707,3449314
2009-08-10,2009,314,D,3,3+,16519,5089343,5809138,4149,3250856,3449314
2009-08-11,2009,315,D,3,3+,16294,5105637,5809138,4496,3255352,3449314
2009-08-12,2009,316,D,3,3+,16430,5122067,5809138,4654,3260006,3449314
2009-08-13,2009,317,D,3,3+,15823,5137890,5809138,3916,3263922,3449314
2009-08-14,2009,318,D,3,3+,15915,5153805,5809138,3554,3267476,3449314
2009-08-15,2009,319,D,3,3+,15990,5169795,5809138,3569,3271045,3449314
2009-08-16,2009,320,D,3,3+,15933,5185728,5809138,3566,3274611,3449314
2009-08-17,2009,321,D,3,3+,15336,5201064,5809138,2995,3277606,3449314
2009-08-18,2009,322,D,3,3+,15079,5216143,5809138,3382,3280988,3449314
2009-08-19,2009,323,D,3,3+,14755,5230898,5809138,3246,3284234,3449314
2009-08-20,2009,324,D,3,3+,15107,5246005,5809138,3651,3287885,3449314
2009-08-21,2009,325,D,3,3+,15717,5261722,5809138,4309,3292194,3449314
2009-08-22,2009,326,D,3,3+,15242,5276964,5809138,3904,3296098,3449314
2009-08-23,2009,327,D,3,3+,15583,5292547,5809138,4224,3300322,3449314
2009-08-24,2009,328,D,3,3+,15892,5308439,5809138,4633,3304955,3449314
2009-08-25,2009,329,D,3,3+,15436,5323875,5809138,4129,3309084,3449314
2009-08-26,2009,330,D,3,3+,15492,5339367,5809138,3494,3312578,3449314
2009-08-27,2009,331,D,3,3+,15780,5355147,5809138,3812,3316390,3449314
2009-08-28,2009,332,D,3,3+,15997,5371144,5809138,4018,3320408,3449314
2009-08-29,2009,333,D,3,3+,16089,5387233,5809138,4180,3324588,3449314
2009-08-30,2009,334,D,3,3+,15873,5403106,5809138,3992,3328580,3449314
2009-08-31,2009,335,D,3,3+,15877,5418983,5809138,4123,3332703,3449314
2009-09-01,2009,336,D,3,3+,15930,5434913,5809138,4256,3336959,3449314
2009-09-02,2009,337,D,3,3+,15006,5449919,5809138,3951,3340910,3449314
2009-09-03,2009,338,D,3,3+,15111,5465030,5809138,4088,3344998,3449314
2009-09-04,2009,339,D,3,3+,15424,5480454,5809138,4435,3349433,3449314
2009-09-05,2009,340,D,3,3+,15166,5495620,5809138,4220,3353653,3449314
2009-09-06,2009,341,D,3,3+,14751,5510371,5809138,3864,3357517,3449314
2009-09-07,2009,342,D,3,3+,14358,5524729,5809138,3540,3361057,3449314
2009-09-08,2009,343,D,3,3+,13369,5538098,5809138,2626,3363683,3449314
2009-09-09,2009,344,D,3,3+,12641,5550739,5809138,2039,3365722,3449314
2009-09-10,2009,345,D,3,3+,13352,5564091,5809138,2638,3368360,3449314
2009-09-11,2009,346,D,3,3+,13039,5577130,5809138,2885,3371245,3449314
2009-09-12,2009,347,D,3,3+,12947,5590077,5809138,2886,3374131,3449314
2009-09-13,2009,348,D,3,3+,13723,5603800,5809138,4221,3378352,3449314
2009-09-14,2009,349,D,3,3+,14527,5618327,5809138,6943,3385295,3449314
2009-09-15,2009,350,D,3,3+,14174,5632501,5809138,6584,3391879,3449314
2009-09-16,2009,351,D,3,3+,13756,5646257,5809138,5702,3397581,3449314
2009-09-17,2009,352,D,3,3+,13327,5659584,5809138,5342,3402923,3449314
2009-09-18,2009,353,D,3,3+,12874,5672458,5809138,5394,3408317,3449314
2009-09-19,2009,354,D,3,3+,12325,5684783,5809138,2986,3411303,3449314
2009-09-20,2009,355,D,3,3+,12341,5697124,5809138,3552,3414855,3449314
2009-09-21,2009,356,D,3,3+,11909,5709033,5809138,3442,3418297,3449314
2009-09-22,2009,357,D,3,3+,11799,5720832,5809138,3467,3421764,3449314
2009-09-23,2009,358,D,3,3+,11587,5732419,5809138,3690,3425454,3449314
2009-09-24,2009,359,D,3,3+,11240,5743659,5809138,3575,3429029,3449314
2009-09-25,2009,360,D,3,3+,11406,5755065,5809138,3804,3432833,3449314
2009-09-26,2009,361,D,3,3+,11345,5766410,5809138,3756,3436589,3449314
2009-09-27,2009,362,D,3,3+,10899,5777309,5809138,3387,3439976,3449314
2009-09-28,2009,363,D,3,3+,10046,5787355,5809138,2550,3442526,3449314
2009-09-29,2009,364,D,3,3+,10689,5798044,5809138,3191,3445717,3449314
2009-09-30,2009,365,D,3,3+,11094,5809138,5809138,3597,3449314,3449314
2009-10-01,2010,1,D,4,3+,11116,11116,7972297,4123,4123,5123736
2009-10-02,2010,2,D,4,3+,11272,22388,7972297,4344,8467,5123736
2009-10-03,2010,3,D,4,3+,10848,33236,7972297,3960,12427,5123736
2009-10-04,2010,4,D,4,3+,11212,44448,7972297,4287,16714,5123736
2009-10-05,2010,5,D,4,3+,11183,55631,7972297,4389,21103,5123736
2009-10-06,2010,6,D,4,3+,11014,66645,7972297,4178,25281,5123736
2009-10-07,2010,7,D,4,3+,10570,77215,7972297,3777,29058,5123736
2009-10-08,2010,8,D,4,3+,11441,88656,7972297,4637,33695,5123736
2009-10-09,2010,9,D,4,3+,12053,100709,7972297,5467,39162,5123736
2009-10-10,2010,10,D,4,3+,11549,112258,7972297,5164,44326,5123736
2009-10-11,2010,11,D,4,3+,11282,123540,7972297,4896,49222,5123736
2009-10-12,2010,12,D,4,3+,11789,135329,7972297,5427,54649,5123736
2009-10-13,2010,13,D,4,3+,12105,147434,7972297,18340,72989,5123736
2009-10-14,2010,14,D,4,3+,15338,162772,7972297,21855,94844,5123736
2009-10-15,2010,15,D,4,3+,15553,178325,7972297,19910,114754,5123736
2009-10-16,2010,16,D,4,3+,14640,192965,7972297,18426,133180,5123736
2009-10-17,2010,17,D,4,3+,14110,207075,7972297,16870,150050,5123736
2009-10-18,2010,18,D,4,3+,13253,220328,7972297,3439,153489,5123736
2009-10-19,2010,19,D,4,3+,13153,233481,7972297,4610,158099,5123736
2009-10-20,2010,20,D,4,3+,12784,246265,7972297,2709,160808,5123736
2009-10-21,2010,21,D,4,3+,12956,259221,7972297,3859,164667,5123736
2009-10-22,2010,22,D,4,3+,13159,272380,7972297,4054,168721,5123736
2009-10-23,2010,23,D,4,3+,13027,285407,7972297,4334,173055,5123736
2009-10-24,2010,24,D,4,3+,13109,298516,7972297,3527,176582,5123736
2009-10-25,2010,25,D,4,3+,13009,311525,7972297,2895,179477,5123736
2009-10-26,2010,26,D,4,3+,12352,323877,7972297,2801,182278,5123736
2009-10-27,2010,27,D,4,3+,13375,337252,7972297,4321,186599,5123736
2009-10-28,2010,28,D,4,3+,12357,349609,7972297,2834,189433,5123736
2009-10-29,2010,29,D,4,3+,11570,361179,7972297,2093,191526,5123736
2009-10-30,2010,30,D,4,3+,11220,372399,7972297,2701,194227,5123736
2009-10-31,2010,31,D,4,3+,11107,383506,7972297,3089,197316,5123736
2009-11-01,2010,32,D,4,3+,11088,394594,7972297,4349,201665,5123736
2009-11-02,2010,33,D,4,3+,10728,405322,7972297,4409,206074,5123736
2009-11-03,2010,34,D,4,3+,10410,415732,7972297,4090,210164,5123736
2009-11-04,2010,35,D,4,3+,9898,425630,7972297,3543,213707,5123736
2009-11-05,2010,36,D,4,3+,10799,436429,7972297,4437,218144,5123736
2009-11-06,2010,37,D,4,3+,10276,446705,7972297,3881,222025,5123736
2009-11-07,2010,38,D,4,3+,10912,457617,7972297,4516,226541,5123736
2009-11-08,2010,39,D,4,3+,10858,468475,7972297,4537,231078,5123736
2009-11-09,2010,40,D,4,3+,11037,479512,7972297,4482,235560,5123736
2009-11-10,2010,41,D,4,3+,11170,490682,7972297,4858,240418,5123736
2009-11-11,2010,42,D,4,3+,11058,501740,7972297,4825,245243,5123736
2009-11-12,2010,43,D,4,3+,10534,512274,7972297,4197,249440,5123736
2009-11-13,2010,44,D,4,3+,10499,522773,7972297,4167,253607,5123736
2009-11-14,2010,45,D,4,3+,10460,533233,7972297,4135,257742,5123736
2009-11-15,2010,46,D,4,3+,10211,543444,7972297,3844,261586,5123736
2009-11-16,2010,47,D,4,3+,10221,553665,7972297,4272,265858,5123736
2009-11-17,2010,48,D,4,3+,9749,563414,7972297,3956,269814,5123736
2009-11-18,2010,49,D,4,3+,10400,573814,7972297,4580,274394,5123736
2009-11-19,2010,50,D,4,3+,10639,584453,7972297,5472,279866,5123736
2009-11-20,2010,51,D,4,3+,10335,594788,7972297,5837,285703,5123736
2009-11-21,2010,52,D,4,3+,12005,606793,7972297,7526,293229,5123736
2009-11-22,2010,53,D,4,3+,11909,618702,7972297,7438,300667,5123736
2009-11-23,2010,54,D,4,3+,12122,630824,7972297,7599,308266,5123736
2009-11-24,2010,55,D,4,3+,11625,642449,7972297,6067,314333,5123736
2009-11-25,2010,56,D,4,3+,11387,653836,7972297,3302,317635,5123736
2009-11-26,2010,57,D,4,3+,11079,664915,7972297,3479,321114,5123736
2009-11-27,2010,58,D,4,3+,10434,675349,7972297,3738,324852,5123736
2009-11-28,2010,59,D,4,3+,11956,687305,7972297,5224,330076,5123736
2009-11-29,2010,60,D,4,3+,10825,698130,7972297,3572,333648,5123736
2009-11-30,2010,61,D,4,3+,10588,708718,7972297,3300,336948,5123736
2009-12-01,2010,62,D,4,3+,10228,718946,7972297,2900,339848,5123736
2009-12-02,2010,63,D,4,3+,9981,728927,7972297,2737,342585,5123736
2009-12-03,2010,64,D,4,3+,10152,739079,7972297,3897,346482,5123736
2009-12-04,2010,65,D,4,3+,10374,749453,7972297,4062,350544,5123736
2009-12-05,2010,66,D,4,3+,10211,759664,7972297,3835,354379,5123736
2009-12-06,2010,67,D,4,3+,9935,769599,7972297,3588,357967,5123736
2009-12-07,2010,68,D,4,3+,10909,780508,7972297,6376,364343,5123736
2009-12-08,2010,69,D,4,3+,11392,791900,7972297,6947,371290,5123736
2009-12-09,2010,70,D,4,3+,10881,802781,7972297,6500,377790,5123736
2009-12-10,2010,71,D,4,3+,10503,813284,7972297,6262,384052,5123736
2009-12-11,2010,72,D,4,3+,10388,823672,7972297,6649,390701,5123736
2009-12-12,2010,73,D,4,3+,11568,835240,7972297,8008,398709,5123736
2009-12-13,2010,74,D,4,3+,13979,849219,7972297,13445,412154,5123736
2009-12-14,2010,75,D,4,3+,14799,864018,7972297,13167,425321,5123736
2009-12-15,2010,76,D,4,3+,14865,878883,7972297,12513,437834,5123736
2009-12-16,2010,77,D,4,3+,14541,893424,7972297,10910,448744,5123736
2009-12-17,2010,78,D,4,3+,14065,907489,7972297,7976,456720,5123736
2009-12-18,2010,79,D,4,3+,14871,922360,7972297,5372,462092,5123736
2009-12-19,2010,80,D,4,3+,15947,938307,7972297,6449,468541,5123736
2009-12-20,2010,81,D,4,3+,15087,953394,7972297,5596,474137,5123736
2009-12-21,2010,82,D,4,3+,13962,967356,7972297,5259,479396,5123736
2009-12-22,2010,83,D,4,3+,14229,981585,7972297,6015,485411,5123736
2009-12-23,2010,84,D,4,3+,13898,995483,7972297,5950,491361,5123736
2009-12-24,2010,85,D,4,3+,13844,1009327,7972297,5401,496762,5123736
2009-12-25,2010,86,D,4,3+,13608,1022935,7972297,5980,502742,5123736
2009-12-26,2010,87,D,4,3+,12680,1035615,7972297,4580,507322,5123736
2009-12-27,2010,88,D,4,3+,12075,1047690,7972297,4484,511806,5123736
2009-12-28,2010,89,D,4,3+,11602,1059292,7972297,4491,516297,5123736
2009-12-29,2010,90,D,4,3+,11624,1070916,7972297,5258,521555,5123736
2009-12-30,2010,91,D,4,3+,11541,1082457,7972297,5963,527518,5123736
2009-12-31,2010,92,D,4,3+,11679,1094136,7972297,6924,534442,5123736
2010-01-01,2010,93,D,4,3+,11761,1105897,7972297,6653,541095,5123736
2010-01-02,2010,94,D,4,3+,12242,1118139,7972297,6739,547834,5123736
2010-01-03,2010,95,D,4,3+,12425,1130564,7972297,6741,554575,5123736
2010-01-04,2010,96,D,4,3+,13207,1143771,7972297,6601,561176,5123736
2010-01-05,2010,97,D,4,3+,13478,1157249,7972297,6390,567566,5123736
2010-01-06,2010,98,D,4,3+,12878,1170127,7972297,5840,573406,5123736
2010-01-07,2010,99,D,4,3+,12365,1182492,7972297,5843,579249,5123736
2010-01-08,2010,100,D,4,3+,11944,1194436,7972297,5692,584941,5123736
2010-01-09,2010,101,D,4,3+,11595,1206031,7972297,5907,590848,5123736
2010-01-10,2010,102,D,4,3+,11192,1217223,7972297,5543,596391,5123736
2010-01-11,2010,103,D,4,3+,10873,1228096,7972297,5252,601643,5123736
2010-01-12,2010,104,D,4,3+,10492,1238588,7972297,5586,607229,5123736
2010-01-13,2010,105,D,4,3+,12244,1250832,7972297,7767,614996,5123736
2010-01-14,2010,106,D,4,3+,14277,1265109,7972297,9331,624327,5123736
2010-01-15,2010,107,D,4,3+,18569,1283678,7972297,13135,637462,5123736
2010-01-16,2010,108,D,4,3+,20084,1303762,7972297,14704,652166,5123736
2010-01-17,2010,109,D,4,3+,18590,1322352,7972297,13675,665841,5123736
2010-01-18,2010,110,D,4,3+,17787,1340139,7972297,13406,679247,5123736
2010-01-19,2010,111,D,4,3+,21641,1361780,7972297,18363,697610,5123736
2010-01-20,2010,112,D,4,3+,35543,1397323,7972297,34130,731740,5123736
2010-01-21,2010,113,D,4,3+,50052,1447375,7972297,52556,784296,5123736
2010-01-22,2010,114,D,4,3+,59436,1506811,7972297,61519,845815,5123736
2010-01-23,2010,115,D,4,3+,66230,1573041,7972297,66990,912805,5123736
2010-01-24,2010,116,D,4,3+,69238,1642279,7972297,68205,981010,5123736
2010-01-25,2010,117,D,4,3+,65653,1707932,7972297,63473,1044483,5123736
2010-01-26,2010,118,D,4,3+,61131,1769063,7972297,55146,1099629,5123736
2010-01-27,2010,119,D,4,3+,61886,1830949,7972297,55736,1155365,5123736
2010-01-28,2010,120,D,4,3+,64053,1895002,7972297,56785,1212150,5123736
2010-01-29,2010,121,D,4,3+,65688,1960690,7972297,58504,1270654,5123736
2010-01-30,2010,122,D,4,3+,61468,2022158,7972297,53692,1324346,5123736
2010-01-31,2010,123,D,4,3+,53117,2075275,7972297,45701,1370047,5123736
2010-02-01,2010,124,D,4,3+,46029,2121304,7972297,38400,1408447,5123736
2010-02-02,2010,125,D,4,3+,42321,2163625,7972297,34816,1443263,5123736
2010-02-03,2010,126,D,4,3+,39706,2203331,7972297,31427,1474690,5123736
2010-02-04,2010,127,D,4,3+,37969,2241300,7972297,30143,1504833,5123736
2010-02-05,2010,128,D,4,3+,37301,2278601,7972297,32795,1537628,5123736
2010-02-06,2010,129,D,4,3+,37482,2316083,7972297,33344,1570972,5123736
2010-02-07,2010,130,D,4,3+,42626,2358709,7972297,38146,1609118,5123736
2010-02-08,2010,131,D,4,3+,44972,2403681,7972297,40721,1649839,5123736
2010-02-09,2010,132,D,4,3+,46941,2450622,7972297,43961,1693800,5123736
2010-02-10,2010,133,D,4,3+,46793,2497415,7972297,41618,1735418,5123736
2010-02-11,2010,134,D,4,3+,44809,2542224,7972297,39205,1774623,5123736
2010-02-12,2010,135,D,4,3+,41985,2584209,7972297,37099,1811722,5123736
2010-02-13,2010,136,D,4,3+,38622,2622831,7972297,33508,1845230,5123736
2010-02-14,2010,137,D,4,3+,36424,2659255,7972297,29479,1874709,5123736
2010-02-15,2010,138,D,4,3+,34197,2693452,7972297,27252,1901961,5123736
2010-02-16,2010,139,D,4,3+,32554,2726006,7972297,25624,1927585,5123736
2010-02-17,2010,140,D,4,3+,30909,2756915,7972297,23902,1951487,5123736
2010-02-18,2010,141,D,4,3+,29274,2786189,7972297,21609,1973096,5123736
2010-02-19,2010,142,D,4,3+,27792,2813981,7972297,19435,1992531,5123736
2010-02-20,2010,143,D,4,3+,25888,2839869,7972297,17527,2010058,5123736
2010-02-21,2010,144,D,4,3+,24128,2863997,7972297,16861,2026919,5123736
2010-02-22,2010,145,D,4,3+,23053,2887050,7972297,15698,2042617,5123736
2010-02-23,2010,146,D,4,3+,22877,2909927,7972297,21855,2064472,5123736
2010-02-24,2010,147,D,4,3+,23452,2933379,7972297,22719,2087191,5123736
2010-02-25,2010,148,D,4,3+,24861,2958240,7972297,24069,2111260,5123736
2010-02-26,2010,149,D,4,3+,31499,2989739,7972297,30935,2142195,5123736
2010-02-27,2010,150,D,4,3+,36634,3026373,7972297,36237,2178432,5123736
2010-02-28,2010,151,D,4,3+,37168,3063541,7972297,31115,2209547,5123736
2010-03-01,2010,152,D,4,3+,39971,3103512,7972297,32837,2242384,5123736
2010-03-02,2010,153,D,4,3+,38178,3141690,7972297,31018,2273402,5123736
2010-03-03,2010,154,D,4,3+,36334,3178024,7972297,30362,2303764,5123736
2010-03-04,2010,155,D,4,3+,36939,3214963,7972297,30973,2334737,5123736
2010-03-05,2010,156,D,4,3+,38913,3253876,7972297,32363,2367100,5123736
2010-03-06,2010,157,D,4,3+,39168,3293044,7972297,32643,2399743,5123736
2010-03-07,2010,158,D,4,3+,35770,3328814,7972297,29037,2428780,5123736
2010-03-08,2010,159,D,4,3+,31444,3360258,7972297,21923,2450703,5123736
2010-03-09,2010,160,D,4,3+,28594,3388852,7972297,19160,2469863,5123736
2010-03-10,2010,161,D,4,3+,25281,3414133,7972297,16597,2486460,5123736
2010-03-11,2010,162,D,4,3+,24295,3438428,7972297,16085,2502545,5123736
2010-03-12,2010,163,D,4,3+,23040,3461468,7972297,19234,2521779,5123736
2010-03-13,2010,164,D,4,3+,23026,3484494,7972297,20453,2542232,5123736
2010-03-14,2010,165,D,4,3+,22188,3506682,7972297,20037,2562269,5123736
2010-03-15,2010,166,D,4,3+,22787,3529469,7972297,19226,2581495,5123736
2010-03-16,2010,167,D,4,3+,22176,3551645,7972297,18004,2599499,5123736
2010-03-17,2010,168,D,4,3+,20801,3572446,7972297,13106,2612605,5123736
2010-03-18,2010,169,D,4,3+,19565,3592011,7972297,11321,2623926,5123736
2010-03-19,2010,170,D,4,3+,19061,3611072,7972297,10536,2634462,5123736
2010-03-20,2010,171,D,4,3+,18858,3629930,7972297,10327,2644789,5123736
2010-03-21,2010,172,D,4,3+,18579,3648509,7972297,9979,2654768,5123736
2010-03-22,2010,173,D,4,3+,18469,3666978,7972297,9831,2664599,5123736
2010-03-23,2010,174,D,4,3+,18111,3685089,7972297,9590,2674189,5123736
2010-03-24,2010,175,D,4,3+,17123,3702212,7972297,8744,2682933,5123736
2010-03-25,2010,176,D,4,3+,16669,3718881,7972297,8241,2691174,5123736
2010-03-26,2010,177,D,4,3+,16514,3735395,7972297,7991,2699165,5123736
2010-03-27,2010,178,D,4,3+,16218,3751613,7972297,8087,2707252,5123736
2010-03-28,2010,179,D,4,3+,16197,3767810,7972297,7645,2714897,5123736
2010-03-29,2010,180,D,4,3+,15584,3783394,7972297,7597,2722494,5123736
2010-03-30,2010,181,D,4,3+,15168,3798562,7972297,7617,2730111,5123736
2010-03-31,2010,182,D,4,3+,15905,3814467,7972297,10202,2740313,5123736
2010-04-01,2010,183,D,4,3+,16384,3830851,7972297,15195,2755508,5123736
2010-04-02,2010,184,D,4,3+,16713,3847564,7972297,17857,2773365,5123736
2010-04-03,2010,185,D,4,3+,17308,3864872,7972297,18403,2791768,5123736
2010-04-04,2010,186,D,4,3+,16945,3881817,7972297,20748,2812516,5123736
2010-04-05,2010,187,D,4,3+,19643,3901460,7972297,21889,2834405,5123736
2010-04-06,2010,188,D,4,3+,19717,3921177,7972297,21923,2856328,5123736
2010-04-07,2010,189,D,4,3+,19584,3940761,7972297,19474,2875802,5123736
2010-04-08,2010,190,D,4,3+,19335,3960096,7972297,19178,2894980,5123736
2010-04-09,2010,191,D,4,3+,18465,3978561,7972297,15104,2910084,5123736
2010-04-10,2010,192,D,4,3+,17128,3995689,7972297,13784,2923868,5123736
2010-04-11,2010,193,D,4,3+,17328,4013017,7972297,15811,2939679,5123736
2010-04-12,2010,194,D,4,3+,18561,4031578,7972297,17893,2957572,5123736
2010-04-13,2010,195,D,4,3+,20844,4052422,7972297,20187,2977759,5123736
2010-04-14,2010,196,D,4,3+,26559,4078981,7972297,25897,3003656,5123736
2010-04-15,2010,197,D,4,3+,33858,4112839,7972297,33150,3036806,5123736
2010-04-16,2010,198,D,4,3+,35015,4147854,7972297,32518,3069324,5123736
2010-04-17,2010,199,D,4,3+,33762,4181616,7972297,30345,3099669,5123736
2010-04-18,2010,200,D,4,3+,32340,4213956,7972297,28915,3128584,5123736
2010-04-19,2010,201,D,4,3+,30487,4244443,7972297,27060,3155644,5123736
2010-04-20,2010,202,D,4,3+,29787,4274230,7972297,29831,3185475,5123736
2010-04-21,2010,203,D,4,3+,30677,4304907,7972297,32541,3218016,5123736
2010-04-22,2010,204,D,4,3+,31937,4336844,7972297,33758,3251774,5123736
2010-04-23,2010,205,D,4,3+,33639,4370483,7972297,35457,3287231,5123736
2010-04-24,2010,206,D,4,3+,31561,4402044,7972297,33279,3320510,5123736
2010-04-25,2010,207,D,4,3+,29279,4431323,7972297,27619,3348129,5123736
2010-04-26,2010,208,D,4,3+,27735,4459058,7972297,24260,3372389,5123736
2010-04-27,2010,209,D,4,3+,26757,4485815,7972297,23273,3395662,5123736
2010-04-28,2010,210,D,4,3+,28309,4514124,7972297,25720,3421382,5123736
2010-04-29,2010,211,D,4,3+,29750,4543874,7972297,27165,3448547,5123736
2010-04-30,2010,212,D,4,3+,32488,4576362,7972297,29900,3478447,5123736
2010-05-01,2010,213,D,4,3+,32579,4608941,7972297,29855,3508302,5123736
2010-05-02,2010,214,D,4,3+,31920,4640861,7972297,29184,3537486,5123736
2010-05-03,2010,215,D,4,3+,30253,4671114,7972297,26526,3564012,5123736
2010-05-04,2010,216,D,4,3+,28521,4699635,7972297,24822,3588834,5123736
2010-05-05,2010,217,D,4,3+,27985,4727620,7972297,24175,3613009,5123736
2010-05-06,2010,218,D,4,3+,28469,4756089,7972297,24733,3637742,5123736
2010-05-07,2010,219,D,4,3+,28233,4784322,7972297,24432,3662174,5123736
2010-05-08,2010,220,D,4,3+,26758,4811080,7972297,22925,3685099,5123736
2010-05-09,2010,221,D,4,3+,25687,4836767,7972297,22279,3707378,5123736
2010-05-10,2010,222,D,4,3+,24802,4861569,7972297,21886,3729264,5123736
2010-05-11,2010,223,D,4,3+,24732,4886301,7972297,21802,3751066,5123736
2010-05-12,2010,224,D,4,3+,23840,4910141,7972297,20948,3772014,5123736
2010-05-13,2010,225,D,4,3+,23507,4933648,7972297,20536,3792550,5123736
2010-05-14,2010,226,D,4,3+,22454,4956102,7972297,18956,3811506,5123736
2010-05-15,2010,227,D,4,3+,21238,4977340,7972297,17307,3828813,5123736
2010-05-16,2010,228,D,4,3+,20616,4997956,7972297,16520,3845333,5123736
2010-05-17,2010,229,D,4,3+,20912,5018868,7972297,16943,3862276,5123736
2010-05-18,2010,230,D,4,3+,21128,5039996,7972297,17040,3879316,5123736
2010-05-19,2010,231,D,4,3+,21373,5061369,7972297,17435,3896751,5123736
2010-05-20,2010,232,D,4,3+,21753,5083122,7972297,17569,3914320,5123736
2010-05-21,2010,233,D,4,3+,21593,5104715,7972297,17354,3931674,5123736
2010-05-22,2010,234,D,4,3+,21835,5126550,7972297,17560,3949234,5123736
2010-05-23,2010,235,D,4,3+,21864,5148414,7972297,17589,3966823,5123736
2010-05-24,2010,236,D,4,3+,22210,5170624,7972297,17753,3984576,5123736
2010-05-25,2010,237,D,4,3+,22117,5192741,7972297,18356,4002932,5123736
2010-05-26,2010,238,D,4,3+,22100,5214841,7972297,16977,4019909,5123736
2010-05-27,2010,239,D,4,3+,23103,5237944,7972297,17394,4037303,5123736
2010-05-28,2010,240,D,4,3+,25606,5263550,7972297,18846,4056149,5123736
2010-05-29,2010,241,D,4,3+,27612,5291162,7972297,20307,4076456,5123736
2010-05-30,2010,242,D,4,3+,29112,5320274,7972297,21084,4097540,5123736
2010-05-31,2010,243,D,4,3+,30182,5350456,7972297,22041,4119581,5123736
2010-06-01,2010,244,D,4,3+,31201,5381657,7972297,21530,4141111,5123736
2010-06-02,2010,245,D,4,3+,31662,5413319,7972297,21436,4162547,5123736
2010-06-03,2010,246,D,4,3+,31186,5444505,7972297,20604,4183151,5123736
2010-06-04,2010,247,D,4,3+,30090,5474595,7972297,19774,4202925,5123736
2010-06-05,2010,248,D,4,3+,31342,5505937,7972297,20625,4223550,5123736
2010-06-06,2010,249,D,4,3+,33663,5539600,7972297,22540,4246090,5123736
2010-06-07,2010,250,D,4,3+,34995,5574595,7972297,23966,4270056,5123736
2010-06-08,2010,251,D,4,3+,36564,5611159,7972297,25364,4295420,5123736
2010-06-09,2010,252,D,4,3+,36192,5647351,7972297,24942,4320362,5123736
2010-06-10,2010,253,D,4,3+,34846,5682197,7972297,23990,4344352,5123736
2010-06-11,2010,254,D,4,3+,34098,5716295,7972297,23733,4368085,5123736
2010-06-12,2010,255,D,4,3+,33531,5749826,7972297,23269,4391354,5123736
2010-06-13,2010,256,D,4,3+,32203,5782029,7972297,21966,4413320,5123736
2010-06-14,2010,257,D,4,3+,31353,5813382,7972297,20990,4434310,5123736
2010-06-15,2010,258,D,4,3+,30264,5843646,7972297,20405,4454715,5123736
2010-06-16,2010,259,D,4,3+,28183,5871829,7972297,19279,4473994,5123736
2010-06-17,2010,260,D,4,3+,25551,5897380,7972297,14583,4488577,5123736
2010-06-18,2010,261,D,4,3+,23235,5920615,7972297,12245,4500822,5123736
2010-06-19,2010,262,D,4,3+,22246,5942861,7972297,11306,4512128,5123736
2010-06-20,2010,263,D,4,3+,21362,5964223,7972297,9783,4521911,5123736
2010-06-21,2010,264,D,4,3+,20878,5985101,7972297,9516,4531427,5123736
2010-06-22,2010,265,D,4,3+,20819,6005920,7972297,9414,4540841,5123736
2010-06-23,2010,266,D,4,3+,20368,6026288,7972297,9445,4550286,5123736
2010-06-24,2010,267,D,4,3+,19955,6046243,7972297,10063,4560349,5123736
2010-06-25,2010,268,D,4,3+,19757,6066000,7972297,9879,4570228,5123736
2010-06-26,2010,269,D,4,3+,19549,6085549,7972297,9911,4580139,5123736
2010-06-27,2010,270,D,4,3+,19746,6105295,7972297,10042,4590181,5123736
2010-06-28,2010,271,D,4,3+,19497,6124792,7972297,8772,4598953,5123736
2010-06-29,2010,272,D,4,3+,19133,6143925,7972297,8420,4607373,5123736
2010-06-30,2010,273,D,4,3+,19791,6163716,7972297,7957,4615330,5123736
2010-07-01,2010,274,D,4,3+,20410,6184126,7972297,6735,4622065,5123736
2010-07-02,2010,275,D,4,3+,21470,6205596,7972297,6566,4628631,5123736
2010-07-03,2010,276,D,4,3+,21401,6226997,7972297,5779,4634410,5123736
2010-07-04,2010,277,D,4,3+,21044,6248041,7972297,6059,4640469,5123736
2010-07-05,2010,278,D,4,3+,20526,6268567,7972297,4937,4645406,5123736
2010-07-06,2010,279,D,4,3+,19884,6288451,7972297,4961,4650367,5123736
2010-07-07,2010,280,D,4,3+,20412,6308863,7972297,5435,4655802,5123736
2010-07-08,2010,281,D,4,3+,20797,6329660,7972297,5723,4661525,5123736
2010-07-09,2010,282,D,4,3+,20310,6349970,7972297,4893,4666418,5123736
2010-07-10,2010,283,D,4,3+,20300,6370270,7972297,4803,4671221,5123736
2010-07-11,2010,284,D,4,3+,20183,6390453,7972297,6435,4677656,5123736
2010-07-12,2010,285,D,4,3+,19926,6410379,7972297,6104,4683760,5123736
2010-07-13,2010,286,D,4,3+,20480,6430859,7972297,6694,4690454,5123736
2010-07-14,2010,287,D,4,3+,20445,6451304,7972297,7608,4698062,5123736
2010-07-15,2010,288,D,4,3+,20216,6471520,7972297,7010,4705072,5123736
2010-07-16,2010,289,D,4,3+,20366,6491886,7972297,7151,4712223,5123736
2010-07-17,2010,290,D,4,3+,20805,6512691,7972297,7540,4719763,5123736
2010-07-18,2010,291,D,4,3+,21365,6534056,7972297,8113,4727876,5123736
2010-07-19,2010,292,D,4,3+,21375,6555431,7972297,8163,4736039,5123736
2010-07-20,2010,293,D,4,3+,21187,6576618,7972297,7739,4743778,5123736
2010-07-21,2010,294,D,4,3+,21191,6597809,7972297,7231,4751009,5123736
2010-07-22,2010,295,D,4,3+,21628,6619437,7972297,7708,4758717,5123736
2010-07-23,2010,296,D,4,3+,21864,6641301,7972297,7959,4766676,5123736
2010-07-24,2010,297,D,4,3+,21677,6662978,7972297,7859,4774535,5123736
2010-07-25,2010,298,D,4,3+,21462,6684440,7972297,7926,4782461,5123736
2010-07-26,2010,299,D,4,3+,21408,6705848,7972297,7823,4790284,5123736
2010-07-27,2010,300,D,4,3+,21630,6727478,7972297,6910,4797194,5123736
2010-07-28,2010,301,D,4,3+,21562,6749040,7972297,6956,4804150,5123736
2010-07-29,2010,302,D,4,3+,21258,6770298,7972297,6631,4810781,5123736
2010-07-30,2010,303,D,4,3+,21312,6791610,7972297,5625,4816406,5123736
2010-07-31,2010,304,D,4,3+,21388,6812998,7972297,6650,4823056,5123736
2010-08-01,2010,305,D,4,3+,21431,6834429,7972297,7506,4830562,5123736
2010-08-02,2010,306,D,4,3+,21453,6855882,7972297,5544,4836106,5123736
2010-08-03,2010,307,D,4,3+,21346,6877228,7972297,5503,4841609,5123736
2010-08-04,2010,308,D,4,3+,20775,6898003,7972297,4957,4846566,5123736
2010-08-05,2010,309,D,4,3+,20544,6918547,7972297,4706,4851272,5123736
2010-08-06,2010,310,D,4,3+,20724,6939271,7972297,4970,4856242,5123736
2010-08-07,2010,311,D,4,3+,20599,6959870,7972297,4849,4861091,5123736
2010-08-08,2010,312,D,4,3+,20025,6979895,7972297,4302,4865393,5123736
2010-08-09,2010,313,D,4,3+,19901,6999796,7972297,4356,4869749,5123736
2010-08-10,2010,314,D,4,3+,19370,7019166,7972297,3846,4873595,5123736
2010-08-11,2010,315,D,4,3+,18560,7037726,7972297,3001,4876596,5123736
2010-08-12,2010,316,D,4,3+,18855,7056581,7972297,3292,4879888,5123736
2010-08-13,2010,317,D,4,3+,18778,7075359,7972297,3639,4883527,5123736
2010-08-14,2010,318,D,4,3+,18847,7094206,7972297,4605,4888132,5123736
2010-08-15,2010,319,D,4,3+,19055,7113261,7972297,4949,4893081,5123736
2010-08-16,2010,320,D,4,3+,19163,7132424,7972297,3826,4896907,5123736
2010-08-17,2010,321,D,4,3+,18750,7151174,7972297,3323,4900230,5123736
2010-08-18,2010,322,D,4,3+,18982,7170156,7972297,3696,4903926,5123736
2010-08-19,2010,323,D,4,3+,19035,7189191,7972297,4019,4907945,5123736
2010-08-20,2010,324,D,4,3+,19135,7208326,7972297,4558,4912503,5123736
2010-08-21,2010,325,D,4,3+,18416,7226742,7972297,3878,4916381,5123736
2010-08-22,2010,326,D,4,3+,18429,7245171,7972297,3657,4920038,5123736
2010-08-23,2010,327,D,4,3+,17855,7263026,7972297,2958,4922996,5123736
2010-08-24,2010,328,D,4,3+,17376,7280402,7972297,2413,4925409,5123736
2010-08-25,2010,329,D,4,3+,16983,7297385,7972297,2471,4927880,5123736
2010-08-26,2010,330,D,4,3+,16779,7314164,7972297,2680,4930560,5123736
2010-08-27,2010,331,D,4,3+,16981,7331145,7972297,2925,4933485,5123736
2010-08-28,2010,332,D,4,3+,16530,7347675,7972297,3240,4936725,5123736
2010-08-29,2010,333,D,4,3+,17135,7364810,7972297,3895,4940620,5123736
2010-08-30,2010,334,D,4,3+,16732,7381542,7972297,3562,4944182,5123736
2010-08-31,2010,335,D,4,3+,16974,7398516,7972297,2996,4947178,5123736
2010-09-01,2010,336,D,4,3+,17084,7415600,7972297,3447,4950625,5123736
2010-09-02,2010,337,D,4,3+,17292,7432892,7972297,3151,4953776,5123736
2010-09-03,2010,338,D,4,3+,17424,7450316,7972297,3335,4957111,5123736
2010-09-04,2010,339,D,4,3+,17663,7467979,7972297,3625,4960736,5123736
2010-09-05,2010,340,D,4,3+,17871,7485850,7972297,3888,4964624,5123736
2010-09-06,2010,341,D,4,3+,18087,7503937,7972297,4168,4968792,5123736
2010-09-07,2010,342,D,4,3+,17672,7521609,7972297,3485,4972277,5123736
2010-09-08,2010,343,D,4,3+,17563,7539172,7972297,3424,4975701,5123736
2010-09-09,2010,344,D,4,3+,18512,7557684,7972297,4192,4979893,5123736
2010-09-10,2010,345,D,4,3+,18791,7576475,7972297,4828,4984721,5123736
2010-09-11,2010,346,D,4,3+,19607,7596082,7972297,5656,4990377,5123736
2010-09-12,2010,347,D,4,3+,20379,7616461,7972297,6177,4996554,5123736
2010-09-13,2010,348,D,4,3+,21541,7638002,7972297,7435,5003989,5123736
2010-09-14,2010,349,D,4,3+,22299,7660301,7972297,8267,5012256,5123736
2010-09-15,2010,350,D,4,3+,22432,7682733,7972297,8475,5020731,5123736
2010-09-16,2010,351,D,4,3+,22078,7704811,7972297,8804,5029535,5123736
2010-09-17,2010,352,D,4,3+,21391,7726202,7972297,8667,5038202,5123736
2010-09-18,2010,353,D,4,3+,21049,7747251,7972297,8352,5046554,5123736
2010-09-19,2010,354,D,4,3+,21010,7768261,7972297,8375,5054929,5123736
2010-09-20,2010,355,D,4,3+,20347,7788608,7972297,8584,5063513,5123736
2010-09-21,2010,356,D,4,3+,19847,7808455,7972297,8628,5072141,5123736
2010-09-22,2010,357,D,4,3+,19880,7828335,7972297,7720,5079861,5123736
2010-09-23,2010,358,D,4,3+,19423,7847758,7972297,7769,5087630,5123736
2010-09-24,2010,359,D,4,3+,19028,7866786,7972297,6505,5094135,5123736
2010-09-25,2010,360,D,4,3+,18645,7885431,7972297,6418,5100553,5123736
2010-09-26,2010,361,D,4,3+,17945,7903376,7972297,5441,5105994,5123736
2010-09-27,2010,362,D,4,3+,17593,7920969,7972297,5183,5111177,5123736
2010-09-28,2010,363,D,4,3+,17127,7938096,7972297,4188,5115365,5123736
2010-09-29,2010,364,D,4,3+,16879,7954975,7972297,3980,5119345,5123736
2010-09-30,2010,365,D,4,3+,17322,7972297,7972297,4391,5123736,5123736
2010-10-01,2011,1,N,1,1,17780,17780,17316998,5362,5362,13574997
2010-10-02,2011,2,N,1,1,17408,35188,17316998,5033,10395,13574997
2010-10-03,2011,3,N,1,1,16568,51756,17316998,4230,14625,13574997
2010-10-04,2011,4,N,1,1,16546,68302,17316998,4724,19349,13574997
2010-10-05,2011,5,N,1,1,16366,84668,17316998,4093,23442,13574997
2010-10-06,2011,6,N,1,1,16362,101030,17316998,4095,27537,13574997
2010-10-07,2011,7,N,1,1,16150,117180,17316998,3947,31484,13574997
2010-10-08,2011,8,N,1,1,15651,132831,17316998,3504,34988,13574997
2010-10-09,2011,9,N,1,1,14948,147779,17316998,2784,37772,13574997
2010-10-10,2011,10,N,1,1,14466,162245,17316998,2295,40067,13574997
2010-10-11,2011,11,N,1,1,14469,176714,17316998,2351,42418,13574997
2010-10-12,2011,12,N,1,1,14162,190876,17316998,4472,46890,13574997
2010-10-13,2011,13,N,1,1,14187,205063,17316998,2981,49871,13574997
2010-10-14,2011,14,N,1,1,14783,219846,17316998,3653,53524,13574997
2010-10-15,2011,15,N,1,1,14663,234509,17316998,4554,58078,13574997
2010-10-16,2011,16,N,1,1,14570,249079,17316998,3905,61983,13574997
2010-10-17,2011,17,N,1,1,14515,263594,17316998,3663,65646,13574997
2010-10-18,2011,18,N,1,1,14499,278093,17316998,5069,70715,13574997
2010-10-19,2011,19,N,1,1,14171,292264,17316998,4449,75164,13574997
2010-10-20,2011,20,N,1,1,13672,305936,17316998,3967,79131,13574997
2010-10-21,2011,21,N,1,1,13480,319416,17316998,4261,83392,13574997
2010-10-22,2011,22,N,1,1,13107,332523,17316998,3921,87313,13574997
2010-10-23,2011,23,N,1,1,13199,345722,17316998,4166,91479,13574997
2010-10-24,2011,24,N,1,1,13799,359521,17316998,5963,97442,13574997
2010-10-25,2011,25,N,1,1,17246,376767,17316998,12015,109457,13574997
2010-10-26,2011,26,N,1,1,19321,396088,17316998,13590,123047,13574997
2010-10-27,2011,27,N,1,1,21512,417600,17316998,15248,138295,13574997
2010-10-28,2011,28,N,1,1,19604,437204,17316998,12329,150624,13574997
2010-10-29,2011,29,N,1,1,17265,454469,17316998,8958,159582,13574997
2010-10-30,2011,30,N,1,1,16474,470943,17316998,4487,164069,13574997
2010-10-31,2011,31,N,1,1,16696,487639,17316998,5602,169671,13574997
2010-11-01,2011,32,N,1,1,16356,503995,17316998,5482,175153,13574997
2010-11-02,2011,33,N,1,1,15849,519844,17316998,4868,180021,13574997
2010-11-03,2011,34,N,1,1,15099,534943,17316998,4101,184122,13574997
2010-11-04,2011,35,N,1,1,14669,549612,17316998,3665,187787,13574997
2010-11-05,2011,36,N,1,1,13750,563362,17316998,2735,190522,13574997
2010-11-06,2011,37,N,1,1,13452,576814,17316998,3923,194445,13574997
2010-11-07,2011,38,N,1,1,14176,590990,17316998,3520,197965,13574997
2010-11-08,2011,39,N,1,1,14574,605564,17316998,7055,205020,13574997
2010-11-09,2011,40,N,1,1,14694,620258,17316998,6623,211643,13574997
2010-11-10,2011,41,N,1,1,14949,635207,17316998,6947,218590,13574997
2010-11-11,2011,42,N,1,1,15217,650424,17316998,7280,225870,13574997
2010-11-12,2011,43,N,1,1,14717,665141,17316998,6709,232579,13574997
2010-11-13,2011,44,N,1,1,14168,679309,17316998,3203,235782,13574997
2010-11-14,2011,45,N,1,1,13943,693252,17316998,3975,239757,13574997
2010-11-15,2011,46,N,1,1,13623,706875,17316998,3511,243268,13574997
2010-11-16,2011,47,N,1,1,13105,719980,17316998,3055,246323,13574997
2010-11-17,2011,48,N,1,1,12939,732919,17316998,2711,249034,13574997
2010-11-18,2011,49,N,1,1,12611,745530,17316998,2643,251677,13574997
2010-11-19,2011,50,N,1,1,12693,758223,17316998,2655,254332,13574997
2010-11-20,2011,51,N,1,1,13867,772090,17316998,4993,259325,13574997
2010-11-21,2011,52,N,1,1,15822,787912,17316998,11743,271068,13574997
2010-11-22,2011,53,N,1,1,17234,805146,17316998,12866,283934,13574997
2010-11-23,2011,54,N,1,1,17713,822859,17316998,12820,296754,13574997
2010-11-24,2011,55,N,1,1,19825,842684,17316998,16341,313095,13574997
2010-11-25,2011,56,N,1,1,19702,862386,17316998,14548,327643,13574997
2010-11-26,2011,57,N,1,1,19406,881792,17316998,9417,337060,13574997
2010-11-27,2011,58,N,1,1,18741,900533,17316998,7990,345050,13574997
2010-11-28,2011,59,N,1,1,19260,919793,17316998,10735,355785,13574997
2010-11-29,2011,60,N,1,1,21318,941111,17316998,11949,367734,13574997
2010-11-30,2011,61,N,1,1,22313,963424,17316998,12563,380297,13574997
2010-12-01,2011,62,N,1,1,21059,984483,17316998,11830,392127,13574997
2010-12-02,2011,63,N,1,1,19089,1003572,17316998,8745,400872,13574997
2010-12-03,2011,64,N,1,1,20704,1024276,17316998,8055,408927,13574997
2010-12-04,2011,65,N,1,1,23798,1048074,17316998,11091,420018,13574997
2010-12-05,2011,66,N,1,1,25623,1073697,17316998,14294,434312,13574997
2010-12-06,2011,67,N,1,1,26386,1100083,17316998,17361,451673,13574997
2010-12-07,2011,68,N,1,1,28868,1128951,17316998,20232,471905,13574997
2010-12-08,2011,69,N,1,1,34228,1163179,17316998,25598,497503,13574997
2010-12-09,2011,70,N,1,1,36266,1199445,17316998,29453,526956,13574997
2010-12-10,2011,71,N,1,1,37008,1236453,17316998,28804,555760,13574997
2010-12-11,2011,72,N,1,1,36207,1272660,17316998,25862,581622,13574997
2010-12-12,2011,73,N,1,1,34565,1307225,17316998,23995,605617,13574997
2010-12-13,2011,74,N,1,1,32768,1339993,17316998,22129,627746,13574997
2010-12-14,2011,75,N,1,1,39072,1379065,17316998,26640,654386,13574997
2010-12-15,2011,76,N,1,1,43055,1422120,17316998,32095,686481,13574997
2010-12-16,2011,77,N,1,1,54940,1477060,17316998,43985,730466,13574997
2010-12-17,2011,78,N,1,1,63699,1540759,17316998,52783,783249,13574997
2010-12-18,2011,79,N,1,1,67895,1608654,17316998,59346,842595,13574997
2010-12-19,2011,80,N,1,1,80881,1689535,17316998,73493,916088,13574997
2010-12-20,2011,81,N,1,1,90574,1780109,17316998,84934,1001022,13574997
2010-12-21,2011,82,N,1,1,94748,1874857,17316998,89296,1090318,13574997
2010-12-22,2011,83,N,1,1,94721,1969578,17316998,89710,1180028,13574997
2010-12-23,2011,84,N,1,1,91169,2060747,17316998,84173,1264201,13574997
2010-12-24,2011,85,N,1,1,87861,2148608,17316998,79722,1343923,13574997
2010-12-25,2011,86,N,1,1,86465,2235073,17316998,73589,1417512,13574997
2010-12-26,2011,87,N,1,1,86816,2321889,17316998,77610,1495122,13574997
2010-12-27,2011,88,N,1,1,83548,2405437,17316998,73807,1568929,13574997
2010-12-28,2011,89,N,1,1,81779,2487216,17316998,70849,1639778,13574997
2010-12-29,2011,90,N,1,1,85015,2572231,17316998,76056,1715834,13574997
2010-12-30,2011,91,N,1,1,85982,2658213,17316998,79056,1794890,13574997
2010-12-31,2011,92,N,1,1,88347,2746560,17316998,77687,1872577,13574997
2011-01-01,2011,93,N,1,1,87986,2834546,17316998,79581,1952158,13574997
2011-01-02,2011,94,N,1,1,86990,2921536,17316998,79079,2031237,13574997
2011-01-03,2011,95,N,1,1,86369,3007905,17316998,78494,2109731,13574997
2011-01-04,2011,96,N,1,1,83549,3091454,17316998,73881,2183612,13574997
2011-01-05,2011,97,N,1,1,78531,3169985,17316998,66783,2250395,13574997
2011-01-06,2011,98,N,1,1,73669,3243654,17316998,62006,2312401,13574997
2011-01-07,2011,99,N,1,1,68208,3311862,17316998,55786,2368187,13574997
2011-01-08,2011,100,N,1,1,64299,3376161,17316998,50045,2418232,13574997
2011-01-09,2011,101,N,1,1,60780,3436941,17316998,47097,2465329,13574997
2011-01-10,2011,102,N,1,1,58158,3495099,17316998,45665,2510994,13574997
2011-01-11,2011,103,N,1,1,54957,3550056,17316998,42020,2553014,13574997
2011-01-12,2011,104,N,1,1,51320,3601376,17316998,38821,2591835,13574997
2011-01-13,2011,105,N,1,1,48396,3649772,17316998,35751,2627586,13574997
2011-01-14,2011,106,N,1,1,45271,3695043,17316998,32898,2660484,13574997
2011-01-15,2011,107,N,1,1,43029,3738072,17316998,30919,2691403,13574997
2011-01-16,2011,108,N,1,1,42553,3780625,17316998,30485,2721888,13574997
2011-01-17,2011,109,N,1,1,42247,3822872,17316998,29740,2751628,13574997
2011-01-18,2011,110,N,1,1,42025,3864897,17316998,29517,2781145,13574997
2011-01-19,2011,111,N,1,1,41478,3906375,17316998,29521,2810666,13574997
2011-01-20,2011,112,N,1,1,40497,3946872,17316998,27756,2838422,13574997
2011-01-21,2011,113,N,1,1,38500,3985372,17316998,26334,2864756,13574997
2011-01-22,2011,114,N,1,1,37410,4022782,17316998,26057,2890813,13574997
2011-01-23,2011,115,N,1,1,36845,4059627,17316998,25232,2916045,13574997
2011-01-24,2011,116,N,1,1,35212,4094839,17316998,25089,2941134,13574997
2011-01-25,2011,117,N,1,1,33860,4128699,17316998,25011,2966145,13574997
2011-01-26,2011,118,N,1,1,32673,4161372,17316998,23800,2989945,13574997
2011-01-27,2011,119,N,1,1,31574,4192946,17316998,22724,3012669,13574997
2011-01-28,2011,120,N,1,1,30872,4223818,17316998,22291,3034960,13574997
2011-01-29,2011,121,N,1,1,30268,4254086,17316998,20549,3055509,13574997
2011-01-30,2011,122,N,1,1,30325,4284411,17316998,19572,3075081,13574997
2011-01-31,2011,123,N,1,1,30449,4314860,17316998,21245,3096326,13574997
2011-02-01,2011,124,N,1,1,29897,4344757,17316998,20591,3116917,13574997
2011-02-02,2011,125,N,1,1,28999,4373756,17316998,20683,3137600,13574997
2011-02-03,2011,126,N,1,1,28763,4402519,17316998,20168,3157768,13574997
2011-02-04,2011,127,N,1,1,28227,4430746,17316998,20242,3178010,13574997
2011-02-05,2011,128,N,1,1,27611,4458357,17316998,17680,3195690,13574997
2011-02-06,2011,129,N,1,1,27281,4485638,17316998,17362,3213052,13574997
2011-02-07,2011,130,N,1,1,26668,4512306,17316998,16681,3229733,13574997
2011-02-08,2011,131,N,1,1,26727,4539033,17316998,17013,3246746,13574997
2011-02-09,2011,132,N,1,1,26281,4565314,17316998,16576,3263322,13574997
2011-02-10,2011,133,N,1,1,26596,4591910,17316998,17483,3280805,13574997
2011-02-11,2011,134,N,1,1,26375,4618285,17316998,16809,3297614,13574997
2011-02-12,2011,135,N,1,1,25973,4644258,17316998,16423,3314037,13574997
2011-02-13,2011,136,N,1,1,25493,4669751,17316998,15585,3329622,13574997
2011-02-14,2011,137,N,1,1,24787,4694538,17316998,14993,3344615,13574997
2011-02-15,2011,138,N,1,1,24753,4719291,17316998,14927,3359542,13574997
2011-02-16,2011,139,N,1,1,25898,4745189,17316998,15924,3375466,13574997
2011-02-17,2011,140,N,1,1,30607,4775796,17316998,22698,3398164,13574997
2011-02-18,2011,141,N,1,1,41121,4816917,17316998,36177,3434341,13574997
2011-02-19,2011,142,N,1,1,49530,4866447,17316998,48030,3482371,13574997
2011-02-20,2011,143,N,1,1,54776,4921223,17316998,53689,3536060,13574997
2011-02-21,2011,144,N,1,1,54364,4975587,17316998,53228,3589288,13574997
2011-02-22,2011,145,N,1,1,50356,5025943,17316998,47914,3637202,13574997
2011-02-23,2011,146,N,1,1,46391,5072334,17316998,40973,3678175,13574997
2011-02-24,2011,147,N,1,1,42542,5114876,17316998,34167,3712342,13574997
2011-02-25,2011,148,N,1,1,44080,5158956,17316998,35912,3748254,13574997
2011-02-26,2011,149,N,1,1,50829,5209785,17316998,45412,3793666,13574997
2011-02-27,2011,150,N,1,1,53870,5263655,17316998,48442,3842108,13574997
2011-02-28,2011,151,N,1,1,50644,5314299,17316998,45246,3887354,13574997
2011-03-01,2011,152,N,1,1,45895,5360194,17316998,40488,3927842,13574997
2011-03-02,2011,153,N,1,1,45217,5405411,17316998,37859,3965701,13574997
2011-03-03,2011,154,N,1,1,46093,5451504,17316998,37381,4003082,13574997
2011-03-04,2011,155,N,1,1,47006,5498510,17316998,38228,4041310,13574997
2011-03-05,2011,156,N,1,1,48749,5547259,17316998,40109,4081419,13574997
2011-03-06,2011,157,N,1,1,48990,5596249,17316998,40376,4121795,13574997
2011-03-07,2011,158,N,1,1,52242,5648491,17316998,45440,4167235,13574997
2011-03-08,2011,159,N,1,1,55517,5704008,17316998,48277,4215512,13574997
2011-03-09,2011,160,N,1,1,56526,5760534,17316998,49512,4265024,13574997
2011-03-10,2011,161,N,1,1,54095,5814629,17316998,47122,4312146,13574997
2011-03-11,2011,162,N,1,1,51197,5865826,17316998,44166,4356312,13574997
2011-03-12,2011,163,N,1,1,50104,5915930,17316998,41215,4397527,13574997
2011-03-13,2011,164,N,1,1,49865,5965795,17316998,40325,4437852,13574997
2011-03-14,2011,165,N,1,1,51154,6016949,17316998,42121,4479973,13574997
2011-03-15,2011,166,N,1,1,57168,6074117,17316998,49084,4529057,13574997
2011-03-16,2011,167,N,1,1,78672,6152789,17316998,71671,4600728,13574997
2011-03-17,2011,168,N,1,1,95855,6248644,17316998,89968,4690696,13574997
2011-03-18,2011,169,N,1,1,106479,6355123,17316998,100574,4791270,13574997
2011-03-19,2011,170,N,1,1,131626,6486749,17316998,127049,4918319,13574997
2011-03-20,2011,171,N,1,1,159869,6646618,17316998,156202,5074521,13574997
2011-03-21,2011,172,N,1,1,178760,6825378,17316998,175475,5249996,13574997
2011-03-22,2011,173,N,1,1,183213,7008591,17316998,178938,5428934,13574997
2011-03-23,2011,174,N,1,1,183070,7191661,17316998,181426,5610360,13574997
2011-03-24,2011,175,N,1,1,191363,7383024,17316998,194307,5804667,13574997
2011-03-25,2011,176,N,1,1,208587,7591611,17316998,215567,6020234,13574997
2011-03-26,2011,177,N,1,1,213620,7805231,17316998,218625,6238859,13574997
2011-03-27,2011,178,N,1,1,205391,8010622,17316998,209023,6447882,13574997
2011-03-28,2011,179,N,1,1,187578,8198200,17316998,190318,6638200,13574997
2011-03-29,2011,180,N,1,1,172766,8370966,17316998,173667,6811867,13574997
2011-03-30,2011,181,N,1,1,159340,8530306,17316998,158391,6970258,13574997
2011-03-31,2011,182,N,1,1,149970,8680276,17316998,145273,7115531,13574997
2011-04-01,2011,183,N,1,1,143261,8823537,17316998,136055,7251586,13574997
2011-04-02,2011,184,N,1,1,138450,8961987,17316998,131457,7383043,13574997
2011-04-03,2011,185,N,1,1,135947,9097934,17316998,128653,7511696,13574997
2011-04-04,2011,186,N,1,1,135061,9232995,17316998,127517,7639213,13574997
2011-04-05,2011,187,N,1,1,130232,9363227,17316998,122680,7761893,13574997
2011-04-06,2011,188,N,1,1,123580,9486807,17316998,115946,7877839,13574997
2011-04-07,2011,189,N,1,1,118801,9605608,17316998,110897,7988736,13574997
2011-04-08,2011,190,N,1,1,114355,9719963,17316998,106799,8095535,13574997
2011-04-09,2011,191,N,1,1,108588,9828551,17316998,100806,8196341,13574997
2011-04-10,2011,192,N,1,1,104439,9932990,17316998,95761,8292102,13574997
2011-04-11,2011,193,N,1,1,99822,10032812,17316998,91126,8383228,13574997
2011-04-12,2011,194,N,1,1,95428,10128240,17316998,87178,8470406,13574997
2011-04-13,2011,195,N,1,1,90528,10218768,17316998,82225,8552631,13574997
2011-04-14,2011,196,N,1,1,86022,10304790,17316998,78650,8631281,13574997
2011-04-15,2011,197,N,1,1,82459,10387249,17316998,75131,8706412,13574997
2011-04-16,2011,198,N,1,1,78875,10466124,17316998,71588,8778000,13574997
2011-04-17,2011,199,N,1,1,75913,10542037,17316998,67904,8845904,13574997
2011-04-18,2011,200,N,1,1,73408,10615445,17316998,65275,8911179,13574997
2011-04-19,2011,201,N,1,1,71798,10687243,17316998,63573,8974752,13574997
2011-04-20,2011,202,N,1,1,71889,10759132,17316998,63620,9038372,13574997
2011-04-21,2011,203,N,1,1,72598,10831730,17316998,64396,9102768,13574997
2011-04-22,2011,204,N,1,1,74603,10906333,17316998,64795,9167563,13574997
2011-04-23,2011,205,N,1,1,77527,10983860,17316998,66330,9233893,13574997
2011-04-24,2011,206,N,1,1,75990,11059850,17316998,65248,9299141,13574997
2011-04-25,2011,207,N,1,1,73501,11133351,17316998,66891,9366032,13574997
2011-04-26,2011,208,N,1,1,71523,11204874,17316998,66096,9432128,13574997
2011-04-27,2011,209,N,1,1,70958,11275832,17316998,64447,9496575,13574997
2011-04-28,2011,210,N,1,1,68764,11344596,17316998,58242,9554817,13574997
2011-04-29,2011,211,N,1,1,66010,11410606,17316998,55484,9610301,13574997
2011-04-30,2011,212,N,1,1,63311,11473917,17316998,56530,9666831,13574997
2011-05-01,2011,213,N,1,1,59985,11533902,17316998,53047,9719878,13574997
2011-05-02,2011,214,N,1,1,58127,11592029,17316998,51418,9771296,13574997
2011-05-03,2011,215,N,1,1,55748,11647777,17316998,49185,9820481,13574997
2011-05-04,2011,216,N,1,1,53740,11701517,17316998,46298,9866779,13574997
2011-05-05,2011,217,N,1,1,53474,11754991,17316998,45983,9912762,13574997
2011-05-06,2011,218,N,1,1,53562,11808553,17316998,46762,9959524,13574997
2011-05-07,2011,219,N,1,1,53356,11861909,17316998,46987,10006511,13574997
2011-05-08,2011,220,N,1,1,54402,11916311,17316998,48912,10055423,13574997
2011-05-09,2011,221,N,1,1,54351,11970662,17316998,48500,10103923,13574997
2011-05-10,2011,222,N,1,1,53730,12024392,17316998,48058,10151981,13574997
2011-05-11,2011,223,N,1,1,52972,12077364,17316998,47223,10199204,13574997
2011-05-12,2011,224,N,1,1,52084,12129448,17316998,46334,10245538,13574997
2011-05-13,2011,225,N,1,1,51080,12180528,17316998,45236,10290774,13574997
2011-05-14,2011,226,N,1,1,49854,12230382,17316998,43982,10334756,13574997
2011-05-15,2011,227,N,1,1,50745,12281127,17316998,44531,10379287,13574997
2011-05-16,2011,228,N,1,1,50991,12332118,17316998,44400,10423687,13574997
2011-05-17,2011,229,N,1,1,50641,12382759,17316998,45793,10469480,13574997
2011-05-18,2011,230,N,1,1,52134,12434893,17316998,49313,10518793,13574997
2011-05-19,2011,231,N,1,1,53247,12488140,17316998,52493,10571286,13574997
2011-05-20,2011,232,N,1,1,55031,12543171,17316998,54175,10625461,13574997
2011-05-21,2011,233,N,1,1,54919,12598090,17316998,54051,10679512,13574997
2011-05-22,2011,234,N,1,1,53626,12651716,17316998,50823,10730335,13574997
2011-05-23,2011,235,N,1,1,52978,12704694,17316998,48798,10779133,13574997
2011-05-24,2011,236,N,1,1,51844,12756538,17316998,46445,10825578,13574997
2011-05-25,2011,237,N,1,1,50094,12806632,17316998,44666,10870244,13574997
2011-05-26,2011,238,N,1,1,48885,12855517,17316998,43410,10913654,13574997
2011-05-27,2011,239,N,1,1,48220,12903737,17316998,42881,10956535,13574997
2011-05-28,2011,240,N,1,1,48064,12951801,17316998,42490,10999025,13574997
2011-05-29,2011,241,N,1,1,47611,12999412,17316998,42266,11041291,13574997
2011-05-30,2011,242,N,1,1,47709,13047121,17316998,42336,11083627,13574997
2011-05-31,2011,243,N,1,1,47468,13094589,17316998,42037,11125664,13574997
2011-06-01,2011,244,N,1,1,47840,13142429,17316998,38190,11163854,13574997
2011-06-02,2011,245,N,1,1,47951,13190380,17316998,36025,11199879,13574997
2011-06-03,2011,246,N,1,1,49397,13239777,17316998,36296,11236175,13574997
2011-06-04,2011,247,N,1,1,50147,13289924,17316998,37157,11273332,13574997
2011-06-05,2011,248,N,1,1,51314,13341238,17316998,39189,11312521,13574997
2011-06-06,2011,249,N,1,1,53468,13394706,17316998,45056,11357577,13574997
2011-06-07,2011,250,N,1,1,58349,13453055,17316998,49900,11407477,13574997
2011-06-08,2011,251,N,1,1,62674,13515729,17316998,54714,11462191,13574997
2011-06-09,2011,252,N,1,1,63890,13579619,17316998,56095,11518286,13574997
2011-06-10,2011,253,N,1,1,64866,13644485,17316998,56125,11574411,13574997
2011-06-11,2011,254,N,1,1,63899,13708384,17316998,51978,11626389,13574997
2011-06-12,2011,255,N,1,1,61250,13769634,17316998,48009,11674398,13574997
2011-06-13,2011,256,N,1,1,59588,13829222,17316998,46781,11721179,13574997
2011-06-14,2011,257,N,1,1,56776,13885998,17316998,43914,11765093,13574997
2011-06-15,2011,258,N,1,1,55794,13941792,17316998,42841,11807934,13574997
2011-06-16,2011,259,N,1,1,56819,13998611,17316998,43180,11851114,13574997
2011-06-17,2011,260,N,1,1,58370,14056981,17316998,44648,11895762,13574997
2011-06-18,2011,261,N,1,1,58010,14114991,17316998,44223,11939985,13574997
2011-06-19,2011,262,N,1,1,55906,14170897,17316998,42087,11982072,13574997
2011-06-20,2011,263,N,1,1,54797,14225694,17316998,40960,12023032,13574997
2011-06-21,2011,264,N,1,1,55065,14280759,17316998,41144,12064176,13574997
2011-06-22,2011,265,N,1,1,53875,14334634,17316998,39855,12104031,13574997
2011-06-23,2011,266,N,1,1,52394,14387028,17316998,37497,12141528,13574997
2011-06-24,2011,267,N,1,1,49282,14436310,17316998,33993,12175521,13574997
2011-06-25,2011,268,N,1,1,47120,14483430,17316998,31860,12207381,13574997
2011-06-26,2011,269,N,1,1,47731,14531161,17316998,32454,12239835,13574997
2011-06-27,2011,270,N,1,1,48806,14579967,17316998,33482,12273317,13574997
2011-06-28,2011,271,N,1,1,48868,14628835,17316998,33592,12306909,13574997
2011-06-29,2011,272,N,1,1,52522,14681357,17316998,38973,12345882,13574997
2011-06-30,2011,273,N,1,1,54359,14735716,17316998,40888,12386770,13574997
2011-07-01,2011,274,N,1,1,56355,14792071,17316998,42352,12429122,13574997
2011-07-02,2011,275,N,1,1,52956,14845027,17316998,38955,12468077,13574997
2011-07-03,2011,276,N,1,1,50857,14895884,17316998,36792,12504869,13574997
2011-07-04,2011,277,N,1,1,48871,14944755,17316998,33011,12537880,13574997
2011-07-05,2011,278,N,1,1,47449,14992204,17316998,31432,12569312,13574997
2011-07-06,2011,279,N,1,1,45720,15037924,17316998,29646,12598958,13574997
2011-07-07,2011,280,N,1,1,43743,15081667,17316998,27706,12626664,13574997
2011-07-08,2011,281,N,1,1,41816,15123483,17316998,25825,12652489,13574997
2011-07-09,2011,282,N,1,1,39578,15163061,17316998,23570,12676059,13574997
2011-07-10,2011,283,N,1,1,38502,15201563,17316998,22526,12698585,13574997
2011-07-11,2011,284,N,1,1,35336,15236899,17316998,19381,12717966,13574997
2011-07-12,2011,285,N,1,1,32461,15269360,17316998,16530,12734496,13574997
2011-07-13,2011,286,N,1,1,30857,15300217,17316998,14881,12749377,13574997
2011-07-14,2011,287,N,1,1,30524,15330741,17316998,14529,12763906,13574997
2011-07-15,2011,288,N,1,1,30592,15361333,17316998,14615,12778521,13574997
2011-07-16,2011,289,N,1,1,30651,15391984,17316998,14662,12793183,13574997
2011-07-17,2011,290,N,1,1,29990,15421974,17316998,14013,12807196,13574997
2011-07-18,2011,291,N,1,1,29524,15451498,17316998,13552,12820748,13574997
2011-07-19,2011,292,N,1,1,29696,15481194,17316998,13819,12834567,13574997
2011-07-20,2011,293,N,1,1,29102,15510296,17316998,13157,12847724,13574997
2011-07-21,2011,294,N,1,1,27251,15537547,17316998,11546,12859270,13574997
2011-07-22,2011,295,N,1,1,26039,15563586,17316998,10039,12869309,13574997
2011-07-23,2011,296,N,1,1,24968,15588554,17316998,8959,12878268,13574997
2011-07-24,2011,297,N,1,1,24369,15612923,17316998,8392,12886660,13574997
2011-07-25,2011,298,N,1,1,23952,15636875,17316998,8034,12894694,13574997
2011-07-26,2011,299,N,1,1,23583,15660458,17316998,7651,12902345,13574997
2011-07-27,2011,300,N,1,1,23070,15683528,17316998,7115,12909460,13574997
2011-07-28,2011,301,N,1,1,22521,15706049,17316998,6620,12916080,13574997
2011-07-29,2011,302,N,1,1,22065,15728114,17316998,6155,12922235,13574997
2011-07-30,2011,303,N,1,1,21803,15749917,17316998,5880,12928115,13574997
2011-07-31,2011,304,N,1,1,21810,15771727,17316998,5945,12934060,13574997
2011-08-01,2011,305,N,1,1,22208,15793935,17316998,6367,12940427,13574997
2011-08-02,2011,306,N,1,1,22541,15816476,17316998,6710,12947137,13574997
2011-08-03,2011,307,N,1,1,23315,15839791,17316998,7542,12954679,13574997
2011-08-04,2011,308,N,1,1,23464,15863255,17316998,7711,12962390,13574997
2011-08-05,2011,309,N,1,1,23849,15887104,17316998,8154,12970544,13574997
2011-08-06,2011,310,N,1,1,23537,15910641,17316998,7801,12978345,13574997
2011-08-07,2011,311,N,1,1,23645,15934286,17316998,8074,12986419,13574997
2011-08-08,2011,312,N,1,1,24338,15958624,17316998,8786,12995205,13574997
2011-08-09,2011,313,N,1,1,23437,15982061,17316998,7944,13003149,13574997
2011-08-10,2011,314,N,1,1,21865,16003926,17316998,6195,13009344,13574997
2011-08-11,2011,315,N,1,1,21864,16025790,17316998,6240,13015584,13574997
2011-08-12,2011,316,N,1,1,23237,16049027,17316998,7641,13023225,13574997
2011-08-13,2011,317,N,1,1,23071,16072098,17316998,7448,13030673,13574997
2011-08-14,2011,318,N,1,1,23000,16095098,17316998,7418,13038091,13574997
2011-08-15,2011,319,N,1,1,23610,16118708,17316998,8284,13046375,13574997
2011-08-16,2011,320,N,1,1,23199,16141907,17316998,7784,13054159,13574997
2011-08-17,2011,321,N,1,1,23028,16164935,17316998,7602,13061761,13574997
2011-08-18,2011,322,N,1,1,22936,16187871,17316998,7517,13069278,13574997
2011-08-19,2011,323,N,1,1,23249,16211120,17316998,7889,13077167,13574997
2011-08-20,2011,324,N,1,1,23141,16234261,17316998,7684,13084851,13574997
2011-08-21,2011,325,N,1,1,24083,16258344,17316998,8636,13093487,13574997
2011-08-22,2011,326,N,1,1,24758,16283102,17316998,9458,13102945,13574997
2011-08-23,2011,327,N,1,1,24815,16307917,17316998,9509,13112454,13574997
2011-08-24,2011,328,N,1,1,25176,16333093,17316998,9974,13122428,13574997
2011-08-25,2011,329,N,1,1,26217,16359310,17316998,11104,13133532,13574997
2011-08-26,2011,330,N,1,1,26669,16385979,17316998,11554,13145086,13574997
2011-08-27,2011,331,N,1,1,27508,16413487,17316998,12319,13157405,13574997
2011-08-28,2011,332,N,1,1,28157,16441644,17316998,13013,13170418,13574997
2011-08-29,2011,333,N,1,1,28372,16470016,17316998,13364,13183782,13574997
2011-08-30,2011,334,N,1,1,27577,16497593,17316998,12665,13196447,13574997
2011-08-31,2011,335,N,1,1,27216,16524809,17316998,12376,13208823,13574997
2011-09-01,2011,336,N,1,1,27345,16552154,17316998,12580,13221403,13574997
2011-09-02,2011,337,N,1,1,27083,16579237,17316998,12330,13233733,13574997
2011-09-03,2011,338,N,1,1,26979,16606216,17316998,12248,13245981,13574997
2011-09-04,2011,339,N,1,1,26820,16633036,17316998,12098,13258079,13574997
2011-09-05,2011,340,N,1,1,26672,16659708,17316998,12063,13270142,13574997
2011-09-06,2011,341,N,1,1,26222,16685930,17316998,11637,13281779,13574997
2011-09-07,2011,342,N,1,1,26326,16712256,17316998,12205,13293984,13574997
2011-09-08,2011,343,N,1,1,26304,16738560,17316998,11808,13305792,13574997
2011-09-09,2011,344,N,1,1,26368,16764928,17316998,11869,13317661,13574997
2011-09-10,2011,345,N,1,1,26320,16791248,17316998,11854,13329515,13574997
2011-09-11,2011,346,N,1,1,26215,16817463,17316998,11789,13341304,13574997
2011-09-12,2011,347,N,1,1,25949,16843412,17316998,11626,13352930,13574997
2011-09-13,2011,348,N,1,1,25114,16868526,17316998,10835,13363765,13574997
2011-09-14,2011,349,N,1,1,25353,16893879,17316998,11143,13374908,13574997
2011-09-15,2011,350,N,1,1,25973,16919852,17316998,11797,13386705,13574997
2011-09-16,2011,351,N,1,1,26784,16946636,17316998,12572,13399277,13574997
2011-09-17,2011,352,N,1,1,27278,16973914,17316998,13142,13412419,13574997
2011-09-18,2011,353,N,1,1,27334,17001248,17316998,13250,13425669,13574997
2011-09-19,2011,354,N,1,1,26554,17027802,17316998,12510,13438179,13574997
2011-09-20,2011,355,N,1,1,26205,17054007,17316998,12131,13450310,13574997
2011-09-21,2011,356,N,1,1,25932,17079939,17316998,11896,13462206,13574997
2011-09-22,2011,357,N,1,1,25869,17105808,17316998,11910,13474116,13574997
2011-09-23,2011,358,N,1,1,25508,17131316,17316998,11525,13485641,13574997
2011-09-24,2011,359,N,1,1,25483,17156799,17316998,11549,13497190,13574997
2011-09-25,2011,360,N,1,1,27360,17184159,17316998,13513,13510703,13574997
2011-09-26,2011,361,N,1,1,27097,17211256,17316998,13247,13523950,13574997
2011-09-27,2011,362,N,1,1,26526,17237782,17316998,13149,13537099,13574997
2011-09-28,2011,363,N,1,1,26358,17264140,17316998,12572,13549671,13574997
2011-09-29,2011,364,N,1,1,26107,17290247,17316998,12357,13562028,13574997
2011-09-30,2011,365,N,1,1,26751,17316998,17316998,12969,13574997,13574997
2011-10-01,2012,1,D,1,1,27751,27751,7178074,14656,14656,4073599
2011-10-02,2012,2,D,1,1,27987,55738,7178074,14770,29426,4073599
2011-10-03,2012,3,D,1,1,27802,83540,7178074,14642,44068,4073599
2011-10-04,2012,4,D,1,1,27765,111305,7178074,14869,58937,4073599
2011-10-05,2012,5,D,1,1,28113,139418,7178074,19787,78724,4073599
2011-10-06,2012,6,D,1,1,29370,168788,7178074,21240,99964,4073599
2011-10-07,2012,7,D,1,1,29617,198405,7178074,21905,121869,4073599
2011-10-08,2012,8,D,1,1,29884,228289,7178074,22839,144708,4073599
2011-10-09,2012,9,D,1,1,28964,257253,7178074,21794,166502,4073599
2011-10-10,2012,10,D,1,1,28222,285475,7178074,15641,182143,4073599
2011-10-11,2012,11,D,1,1,28173,313648,7178074,15405,197548,4073599
2011-10-12,2012,12,D,1,1,27129,340777,7178074,14377,211925,4073599
2011-10-13,2012,13,D,1,1,26163,366940,7178074,13371,225296,4073599
2011-10-14,2012,14,D,1,1,25293,392233,7178074,12491,237787,4073599
2011-10-15,2012,15,D,1,1,24197,416430,7178074,11389,249176,4073599
2011-10-16,2012,16,D,1,1,24462,440892,7178074,11663,260839,4073599
2011-10-17,2012,17,D,1,1,23789,464681,7178074,10977,271816,4073599
2011-10-18,2012,18,D,1,1,22516,487197,7178074,9724,281540,4073599
2011-10-19,2012,19,D,1,1,21254,508451,7178074,8441,289981,4073599
2011-10-20,2012,20,D,1,1,20891,529342,7178074,8077,298058,4073599
2011-10-21,2012,21,D,1,1,20344,549686,7178074,8329,306387,4073599
2011-10-22,2012,22,D,1,1,20335,570021,7178074,7554,313941,4073599
2011-10-23,2012,23,D,1,1,20440,590461,7178074,7878,321819,4073599
2011-10-24,2012,24,D,1,1,19965,610426,7178074,7206,329025,4073599
2011-10-25,2012,25,D,1,1,19729,630155,7178074,6972,335997,4073599
2011-10-26,2012,26,D,1,1,19551,649706,7178074,6722,342719,4073599
2011-10-27,2012,27,D,1,1,18866,668572,7178074,6085,348804,4073599
2011-10-28,2012,28,D,1,1,18263,686835,7178074,5445,354249,4073599
2011-10-29,2012,29,D,1,1,18558,705393,7178074,5870,360119,4073599
2011-10-30,2012,30,D,1,1,18982,724375,7178074,6224,366343,4073599
2011-10-31,2012,31,D,1,1,18662,743037,7178074,8053,374396,4073599
2011-11-01,2012,32,D,1,1,19300,762337,7178074,6491,380887,4073599
2011-11-02,2012,33,D,1,1,18081,780418,7178074,5159,386046,4073599
2011-11-03,2012,34,D,1,1,16775,797193,7178074,3925,389971,4073599
2011-11-04,2012,35,D,1,1,16576,813769,7178074,5249,395220,4073599
2011-11-05,2012,36,D,1,1,15795,829564,7178074,5892,401112,4073599
2011-11-06,2012,37,D,1,1,15578,845142,7178074,5552,406664,4073599
2011-11-07,2012,38,D,1,1,15496,860638,7178074,5767,412431,4073599
2011-11-08,2012,39,D,1,1,15185,875823,7178074,6367,418798,4073599
2011-11-09,2012,40,D,1,1,15095,890918,7178074,6330,425128,4073599
2011-11-10,2012,41,D,1,1,14624,905542,7178074,4411,429539,4073599
2011-11-11,2012,42,D,1,1,14139,919681,7178074,4427,433966,4073599
2011-11-12,2012,43,D,1,1,14544,934225,7178074,4807,438773,4073599
2011-11-13,2012,44,D,1,1,14928,949153,7178074,5197,443970,4073599
2011-11-14,2012,45,D,1,1,15206,964359,7178074,5456,449426,4073599
2011-11-15,2012,46,D,1,1,15349,979708,7178074,5606,455032,4073599
2011-11-16,2012,47,D,1,1,15353,995061,7178074,6173,461205,4073599
2011-11-17,2012,48,D,1,1,15317,1010378,7178074,7702,468907,4073599
2011-11-18,2012,49,D,1,1,15334,1025712,7178074,8036,476943,4073599
2011-11-19,2012,50,D,1,1,15669,1041381,7178074,9003,485946,4073599
2011-11-20,2012,51,D,1,1,16025,1057406,7178074,11584,497530,4073599
2011-11-21,2012,52,D,1,1,16945,1074351,7178074,12526,510056,4073599
2011-11-22,2012,53,D,1,1,17049,1091400,7178074,12664,522720,4073599
2011-11-23,2012,54,D,1,1,16706,1108106,7178074,12321,535041,4073599
2011-11-24,2012,55,D,1,1,17054,1125160,7178074,12201,547242,4073599
2011-11-25,2012,56,D,1,1,17697,1142857,7178074,11002,558244,4073599
2011-11-26,2012,57,D,1,1,18466,1161323,7178074,11783,570027,4073599
2011-11-27,2012,58,D,1,1,18567,1179890,7178074,14289,584316,4073599
2011-11-28,2012,59,D,1,1,18570,1198460,7178074,12735,597051,4073599
2011-11-29,2012,60,D,1,1,18134,1216594,7178074,12889,609940,4073599
2011-11-30,2012,61,D,1,1,17598,1234192,7178074,12538,622478,4073599
2011-12-01,2012,62,D,1,1,17093,1251285,7178074,6404,628882,4073599
2011-12-02,2012,63,D,1,1,16188,1267473,7178074,3317,632199,4073599
2011-12-03,2012,64,D,1,1,16926,1284399,7178074,5315,637514,4073599
2011-12-04,2012,65,D,1,1,16590,1300989,7178074,4778,642292,4073599
2011-12-05,2012,66,D,1,1,17048,1318037,7178074,4511,646803,4073599
2011-12-06,2012,67,D,1,1,16764,1334801,7178074,3576,650379,4073599
2011-12-07,2012,68,D,1,1,17015,1351816,7178074,4041,654420,4073599
2011-12-08,2012,69,D,1,1,17780,1369596,7178074,4790,659210,4073599
2011-12-09,2012,70,D,1,1,18137,1387733,7178074,5167,664377,4073599
2011-12-10,2012,71,D,1,1,17832,1405565,7178074,4860,669237,4073599
2011-12-11,2012,72,D,1,1,17663,1423228,7178074,4637,673874,4073599
2011-12-12,2012,73,D,1,1,18022,1441250,7178074,5194,679068,4073599
2011-12-13,2012,74,D,1,1,18409,1459659,7178074,5579,684647,4073599
2011-12-14,2012,75,D,1,1,18764,1478423,7178074,5945,690592,4073599
2011-12-15,2012,76,D,1,1,18773,1497196,7178074,6303,696895,4073599
2011-12-16,2012,77,D,1,1,19023,1516219,7178074,6572,703467,4073599
2011-12-17,2012,78,D,1,1,19303,1535522,7178074,6823,710290,4073599
2011-12-18,2012,79,D,1,1,19219,1554741,7178074,6728,717018,4073599
2011-12-19,2012,80,D,1,1,19107,1573848,7178074,6628,723646,4073599
2011-12-20,2012,81,D,1,1,18008,1591856,7178074,6418,730064,4073599
2011-12-21,2012,82,D,1,1,16690,1608546,7178074,6140,736204,4073599
2011-12-22,2012,83,D,1,1,16368,1624914,7178074,5791,741995,4073599
2011-12-23,2012,84,D,1,1,15571,1640485,7178074,6564,748559,4073599
2011-12-24,2012,85,D,1,1,15071,1655556,7178074,6110,754669,4073599
2011-12-25,2012,86,D,1,1,14390,1669946,7178074,5476,760145,4073599
2011-12-26,2012,87,D,1,1,14403,1684349,7178074,5500,765645,4073599
2011-12-27,2012,88,D,1,1,14462,1698811,7178074,5124,770769,4073599
2011-12-28,2012,89,D,1,1,14211,1713022,7178074,4467,775236,4073599
2011-12-29,2012,90,D,1,1,13984,1727006,7178074,4374,779610,4073599
2011-12-30,2012,91,D,1,1,14006,1741012,7178074,3912,783522,4073599
2011-12-31,2012,92,D,1,1,14051,1755063,7178074,5510,789032,4073599
2012-01-01,2012,93,D,1,1,13781,1768844,7178074,6518,795550,4073599
2012-01-02,2012,94,D,1,1,13446,1782290,7178074,5651,801201,4073599
2012-01-03,2012,95,D,1,1,13375,1795665,7178074,5622,806823,4073599
2012-01-04,2012,96,D,1,1,13222,1808887,7178074,5518,812341,4073599
2012-01-05,2012,97,D,1,1,12952,1821839,7178074,5299,817640,4073599
2012-01-06,2012,98,D,1,1,12524,1834363,7178074,4921,822561,4073599
2012-01-07,2012,99,D,1,1,13247,1847610,7178074,5648,828209,4073599
2012-01-08,2012,100,D,1,1,12614,1860224,7178074,5521,833730,4073599
2012-01-09,2012,101,D,1,1,13058,1873282,7178074,6060,839790,4073599
2012-01-10,2012,102,D,1,1,13443,1886725,7178074,6484,846274,4073599
2012-01-11,2012,103,D,1,1,13722,1900447,7178074,6764,853038,4073599
2012-01-12,2012,104,D,1,1,13661,1914108,7178074,6280,859318,4073599
2012-01-13,2012,105,D,1,1,13575,1927683,7178074,6180,865498,4073599
2012-01-14,2012,106,D,1,1,13489,1941172,7178074,6169,871667,4073599
2012-01-15,2012,107,D,1,1,13026,1954198,7178074,5703,877370,4073599
2012-01-16,2012,108,D,1,1,13738,1967936,7178074,6469,883839,4073599
2012-01-17,2012,109,D,1,1,13397,1981333,7178074,6132,889971,4073599
2012-01-18,2012,110,D,1,1,13206,1994539,7178074,5982,895953,4073599
2012-01-19,2012,111,D,1,1,12871,2007410,7178074,6114,902067,4073599
2012-01-20,2012,112,D,1,1,13156,2020566,7178074,9394,911461,4073599
2012-01-21,2012,113,D,1,1,16067,2036633,7178074,14433,925894,4073599
2012-01-22,2012,114,D,1,1,19677,2056310,7178074,18046,943940,4073599
2012-01-23,2012,115,D,1,1,26618,2082928,7178074,26718,970658,4073599
2012-01-24,2012,116,D,1,1,30535,2113463,7178074,31035,1001693,4073599
2012-01-25,2012,117,D,1,1,34488,2147951,7178074,32170,1033863,4073599
2012-01-26,2012,118,D,1,1,32256,2180207,7178074,27724,1061587,4073599
2012-01-27,2012,119,D,1,1,26904,2207111,7178074,22193,1083780,4073599
2012-01-28,2012,120,D,1,1,24346,2231457,7178074,17118,1100898,4073599
2012-01-29,2012,121,D,1,1,22603,2254060,7178074,15366,1116264,4073599
2012-01-30,2012,122,D,1,1,21074,2275134,7178074,13823,1130087,4073599
2012-01-31,2012,123,D,1,1,20083,2295217,7178074,12884,1142971,4073599
2012-02-01,2012,124,D,1,1,19502,2314719,7178074,12189,1155160,4073599
2012-02-02,2012,125,D,1,1,18928,2333647,7178074,11624,1166784,4073599
2012-02-03,2012,126,D,1,1,17618,2351265,7178074,10307,1177091,4073599
2012-02-04,2012,127,D,1,1,16335,2367600,7178074,9573,1186664,4073599
2012-02-05,2012,128,D,1,1,15581,2383181,7178074,9068,1195732,4073599
2012-02-06,2012,129,D,1,1,15138,2398319,7178074,9112,1204844,4073599
2012-02-07,2012,130,D,1,1,14829,2413148,7178074,8940,1213784,4073599
2012-02-08,2012,131,D,1,1,15935,2429083,7178074,12263,1226047,4073599
2012-02-09,2012,132,D,1,1,15754,2444837,7178074,12327,1238374,4073599
2012-02-10,2012,133,D,1,1,15951,2460788,7178074,12406,1250780,4073599
2012-02-11,2012,134,D,1,1,16239,2477027,7178074,13016,1263796,4073599
2012-02-12,2012,135,D,1,1,16244,2493271,7178074,12790,1276586,4073599
2012-02-13,2012,136,D,1,1,16285,2509556,7178074,13207,1289793,4073599
2012-02-14,2012,137,D,1,1,16280,2525836,7178074,12700,1302493,4073599
2012-02-15,2012,138,D,1,1,16289,2542125,7178074,11910,1314403,4073599
2012-02-16,2012,139,D,1,1,15976,2558101,7178074,11119,1325522,4073599
2012-02-17,2012,140,D,1,1,15599,2573700,7178074,11081,1336603,4073599
2012-02-18,2012,141,D,1,1,14960,2588660,7178074,9288,1345891,4073599
2012-02-19,2012,142,D,1,1,14645,2603305,7178074,10352,1356243,4073599
2012-02-20,2012,143,D,1,1,14379,2617684,7178074,10766,1367009,4073599
2012-02-21,2012,144,D,1,1,14112,2631796,7178074,10073,1377082,4073599
2012-02-22,2012,145,D,1,1,13794,2645590,7178074,10601,1387683,4073599
2012-02-23,2012,146,D,1,1,13963,2659553,7178074,11076,1398759,4073599
2012-02-24,2012,147,D,1,1,13229,2672782,7178074,9720,1408479,4073599
2012-02-25,2012,148,D,1,1,13757,2686539,7178074,10166,1418645,4073599
2012-02-26,2012,149,D,1,1,13252,2699791,7178074,9673,1428318,4073599
2012-02-27,2012,150,D,1,1,13207,2712998,7178074,8843,1437161,4073599
2012-02-28,2012,151,D,1,1,13171,2726169,7178074,8804,1445965,4073599
2012-02-29,2012,152,D,1,1,12800,2738969,7178074,10115,1456080,4073599
2012-03-01,2012,153,D,1,1,13067,2752036,7178074,10329,1466409,4073599
2012-03-02,2012,154,D,1,1,13126,2765162,7178074,11485,1477894,4073599
2012-03-03,2012,155,D,1,1,12533,2777695,7178074,10631,1488525,4073599
2012-03-04,2012,156,D,1,1,12181,2789876,7178074,10182,1498707,4073599
2012-03-05,2012,157,D,1,1,11755,2801631,7178074,7873,1506580,4073599
2012-03-06,2012,158,D,1,1,11992,2813623,7178074,8118,1514698,4073599
2012-03-07,2012,159,D,1,1,11912,2825535,7178074,8128,1522826,4073599
2012-03-08,2012,160,D,1,1,11247,2836782,7178074,7342,1530168,4073599
2012-03-09,2012,161,D,1,1,11183,2847965,7178074,7338,1537506,4073599
2012-03-10,2012,162,D,1,1,10659,2858624,7178074,6660,1544166,4073599
2012-03-11,2012,163,D,1,1,11252,2869876,7178074,7379,1551545,4073599
2012-03-12,2012,164,D,1,1,11588,2881464,7178074,7537,1559082,4073599
2012-03-13,2012,165,D,1,1,11107,2892571,7178074,7473,1566555,4073599
2012-03-14,2012,166,D,1,1,13673,2906244,7178074,11472,1578027,4073599
2012-03-15,2012,167,D,1,1,19559,2925803,7178074,17480,1595507,4073599
2012-03-16,2012,168,D,1,1,28224,2954027,7178074,28648,1624155,4073599
2012-03-17,2012,169,D,1,1,45140,2999167,7178074,46503,1670658,4073599
2012-03-18,2012,170,D,1,1,51096,3050263,7178074,51239,1721897,4073599
2012-03-19,2012,171,D,1,1,47366,3097629,7178074,46088,1767985,4073599
2012-03-20,2012,172,D,1,1,40469,3138098,7178074,38992,1806977,4073599
2012-03-21,2012,173,D,1,1,34236,3172334,7178074,29971,1836948,4073599
2012-03-22,2012,174,D,1,1,28121,3200455,7178074,22192,1859140,4073599
2012-03-23,2012,175,D,1,1,24428,3224883,7178074,19235,1878375,4073599
2012-03-24,2012,176,D,1,1,21252,3246135,7178074,16106,1894481,4073599
2012-03-25,2012,177,D,1,1,21119,3267254,7178074,18745,1913226,4073599
2012-03-26,2012,178,D,1,1,20964,3288218,7178074,18538,1931764,4073599
2012-03-27,2012,179,D,1,1,20656,3308874,7178074,20043,1951807,4073599
2012-03-28,2012,180,D,1,1,23674,3332548,7178074,26289,1978096,4073599
2012-03-29,2012,181,D,1,1,28106,3360654,7178074,30148,2008244,4073599
2012-03-30,2012,182,D,1,1,37521,3398175,7178074,34839,2043083,4073599
2012-03-31,2012,183,D,1,1,37989,3436164,7178074,36544,2079627,4073599
2012-04-01,2012,184,D,1,1,36777,3472941,7178074,37444,2117071,4073599
2012-04-02,2012,185,D,1,1,35711,3508652,7178074,33277,2150348,4073599
2012-04-03,2012,186,D,1,1,35760,3544412,7178074,33571,2183919,4073599
2012-04-04,2012,187,D,1,1,32731,3577143,7178074,30499,2214418,4073599
2012-04-05,2012,188,D,1,1,29893,3607036,7178074,26481,2240899,4073599
2012-04-06,2012,189,D,1,1,27509,3634545,7178074,23922,2264821,4073599
2012-04-07,2012,190,D,1,1,25557,3660102,7178074,21967,2286788,4073599
2012-04-08,2012,191,D,1,1,23627,3683729,7178074,18941,2305729,4073599
2012-04-09,2012,192,D,1,1,22653,3706382,7178074,17962,2323691,4073599
2012-04-10,2012,193,D,1,1,21872,3728254,7178074,17200,2340891,4073599
2012-04-11,2012,194,D,1,1,21351,3749605,7178074,17343,2358234,4073599
2012-04-12,2012,195,D,1,1,22332,3771937,7178074,22883,2381117,4073599
2012-04-13,2012,196,D,1,1,30954,3802891,7178074,34470,2415587,4073599
2012-04-14,2012,197,D,1,1,39589,3842480,7178074,43080,2458667,4073599
2012-04-15,2012,198,D,1,1,41964,3884444,7178074,44404,2503071,4073599
2012-04-16,2012,199,D,1,1,39367,3923811,7178074,41428,2544499,4073599
2012-04-17,2012,200,D,1,1,34695,3958506,7178074,32726,2577225,4073599
2012-04-18,2012,201,D,1,1,30059,3988565,7178074,24960,2602185,4073599
2012-04-19,2012,202,D,1,1,26780,4015345,7178074,21696,2623881,4073599
2012-04-20,2012,203,D,1,1,25339,4040684,7178074,20395,2644276,4073599
2012-04-21,2012,204,D,1,1,24941,4065625,7178074,20202,2664478,4073599
2012-04-22,2012,205,D,1,1,24058,4089683,7178074,20363,2684841,4073599
2012-04-23,2012,206,D,1,1,23298,4112981,7178074,19923,2704764,4073599
2012-04-24,2012,207,D,1,1,25937,4138918,7178074,22486,2727250,4073599
2012-04-25,2012,208,D,1,1,27736,4166654,7178074,27036,2754286,4073599
2012-04-26,2012,209,D,1,1,28686,4195340,7178074,28226,2782512,4073599
2012-04-27,2012,210,D,1,1,32529,4227869,7178074,32059,2814571,4073599
2012-04-28,2012,211,D,1,1,35881,4263750,7178074,35337,2849908,4073599
2012-04-29,2012,212,D,1,1,34653,4298403,7178074,34148,2884056,4073599
2012-04-30,2012,213,D,1,1,32363,4330766,7178074,29029,2913085,4073599
2012-05-01,2012,214,D,1,1,30911,4361677,7178074,26534,2939619,4073599
2012-05-02,2012,215,D,1,1,29984,4391661,7178074,25528,2965147,4073599
2012-05-03,2012,216,D,1,1,29063,4420724,7178074,24411,2989558,4073599
2012-05-04,2012,217,D,1,1,28247,4448971,7178074,23387,3012945,4073599
2012-05-05,2012,218,D,1,1,26263,4475234,7178074,21040,3033985,4073599
2012-05-06,2012,219,D,1,1,24856,4500090,7178074,19530,3053515,4073599
2012-05-07,2012,220,D,1,1,23889,4523979,7178074,18649,3072164,4073599
2012-05-08,2012,221,D,1,1,22067,4546046,7178074,18193,3090357,4073599
2012-05-09,2012,222,D,1,1,20175,4566221,7178074,16297,3106654,4073599
2012-05-10,2012,223,D,1,1,19419,4585640,7178074,15533,3122187,4073599
2012-05-11,2012,224,D,1,1,19605,4605245,7178074,15669,3137856,4073599
2012-05-12,2012,225,D,1,1,18989,4624234,7178074,14937,3152793,4073599
2012-05-13,2012,226,D,1,1,17718,4641952,7178074,11127,3163920,4073599
2012-05-14,2012,227,D,1,1,18300,4660252,7178074,11477,3175397,4073599
2012-05-15,2012,228,D,1,1,16785,4677037,7178074,9668,3185065,4073599
2012-05-16,2012,229,D,1,1,15051,4692088,7178074,7379,3192444,4073599
2012-05-17,2012,230,D,1,1,13650,4705738,7178074,5932,3198376,4073599
2012-05-18,2012,231,D,1,1,13815,4719553,7178074,6081,3204457,4073599
2012-05-19,2012,232,D,1,1,13491,4733044,7178074,6780,3211237,4073599
2012-05-20,2012,233,D,1,1,13479,4746523,7178074,6189,3217426,4073599
2012-05-21,2012,234,D,1,1,13617,4760140,7178074,6325,3223751,4073599
2012-05-22,2012,235,D,1,1,14123,4774263,7178074,6781,3230532,4073599
2012-05-23,2012,236,D,1,1,13586,4787849,7178074,6728,3237260,4073599
2012-05-24,2012,237,D,1,1,13084,4800933,7178074,8682,3245942,4073599
2012-05-25,2012,238,D,1,1,13736,4814669,7178074,9236,3255178,4073599
2012-05-26,2012,239,D,1,1,13778,4828447,7178074,9290,3264468,4073599
2012-05-27,2012,240,D,1,1,13719,4842166,7178074,9122,3273590,4073599
2012-05-28,2012,241,D,1,1,13521,4855687,7178074,8913,3282503,4073599
2012-05-29,2012,242,D,1,1,14065,4869752,7178074,6225,3288728,4073599
2012-05-30,2012,243,D,1,1,14187,4883939,7178074,6171,3294899,4073599
2012-05-31,2012,244,D,1,1,13264,4897203,7178074,5463,3300362,4073599
2012-06-01,2012,245,D,1,1,12376,4909579,7178074,5825,3306187,4073599
2012-06-02,2012,246,D,1,1,12188,4921767,7178074,5667,3311854,4073599
2012-06-03,2012,247,D,1,1,12402,4934169,7178074,5850,3317704,4073599
2012-06-04,2012,248,D,1,1,11989,4946158,7178074,5624,3323328,4073599
2012-06-05,2012,249,D,1,1,12593,4958751,7178074,6178,3329506,4073599
2012-06-06,2012,250,D,1,1,13629,4972380,7178074,7144,3336650,4073599
2012-06-07,2012,251,D,1,1,15050,4987430,7178074,7705,3344355,4073599
2012-06-08,2012,252,D,1,1,16065,5003495,7178074,8386,3352741,4073599
2012-06-09,2012,253,D,1,1,16582,5020077,7178074,8645,3361386,4073599
2012-06-10,2012,254,D,1,1,15737,5035814,7178074,7742,3369128,4073599
2012-06-11,2012,255,D,1,1,15072,5050886,7178074,7030,3376158,4073599
2012-06-12,2012,256,D,1,1,14325,5065211,7178074,6297,3382455,4073599
2012-06-13,2012,257,D,1,1,14588,5079799,7178074,6485,3388940,4073599
2012-06-14,2012,258,D,1,1,14337,5094136,7178074,8317,3397257,4073599
2012-06-15,2012,259,D,1,1,14800,5108936,7178074,8572,3405829,4073599
2012-06-16,2012,260,D,1,1,15285,5124221,7178074,8240,3414069,4073599
2012-06-17,2012,261,D,1,1,15361,5139582,7178074,8432,3422501,4073599
2012-06-18,2012,262,D,1,1,16024,5155606,7178074,9255,3431756,4073599
2012-06-19,2012,263,D,1,1,17290,5172896,7178074,10319,3442075,4073599
2012-06-20,2012,264,D,1,1,17201,5190097,7178074,10142,3452217,4073599
2012-06-21,2012,265,D,1,1,16618,5206715,7178074,9567,3461784,4073599
2012-06-22,2012,266,D,1,1,17334,5224049,7178074,9167,3470951,4073599
2012-06-23,2012,267,D,1,1,17163,5241212,7178074,8669,3479620,4073599
2012-06-24,2012,268,D,1,1,17773,5258985,7178074,9205,3488825,4073599
2012-06-25,2012,269,D,1,1,18273,5277258,7178074,9002,3497827,4073599
2012-06-26,2012,270,D,1,1,18920,5296178,7178074,9542,3507369,4073599
2012-06-27,2012,271,D,1,1,19473,5315651,7178074,10048,3517417,4073599
2012-06-28,2012,272,D,1,1,20252,5335903,7178074,10284,3527701,4073599
2012-06-29,2012,273,D,1,1,21396,5357299,7178074,10870,3538571,4073599
2012-06-30,2012,274,D,1,1,21455,5378754,7178074,10964,3549535,4073599
2012-07-01,2012,275,D,1,1,20543,5399297,7178074,5245,3554780,4073599
2012-07-02,2012,276,D,1,1,20389,5419686,7178074,6478,3561258,4073599
2012-07-03,2012,277,D,1,1,20448,5440134,7178074,5439,3566697,4073599
2012-07-04,2012,278,D,1,1,20407,5460541,7178074,6030,3572727,4073599
2012-07-05,2012,279,D,1,1,20519,5481060,7178074,6460,3579187,4073599
2012-07-06,2012,280,D,1,1,20956,5502016,7178074,6908,3586095,4073599
2012-07-07,2012,281,D,1,1,20741,5522757,7178074,6762,3592857,4073599
2012-07-08,2012,282,D,1,1,20678,5543435,7178074,6643,3599500,4073599
2012-07-09,2012,283,D,1,1,21002,5564437,7178074,6964,3606464,4073599
2012-07-10,2012,284,D,1,1,20957,5585394,7178074,6944,3613408,4073599
2012-07-11,2012,285,D,1,1,20888,5606282,7178074,6817,3620225,4073599
2012-07-12,2012,286,D,1,1,21694,5627976,7178074,7598,3627823,4073599
2012-07-13,2012,287,D,1,1,21834,5649810,7178074,7260,3635083,4073599
2012-07-14,2012,288,D,1,1,22334,5672144,7178074,6807,3641890,4073599
2012-07-15,2012,289,D,1,1,22076,5694220,7178074,6538,3648428,4073599
2012-07-16,2012,290,D,1,1,21725,5715945,7178074,6769,3655197,4073599
2012-07-17,2012,291,D,1,1,22981,5738926,7178074,7856,3663053,4073599
2012-07-18,2012,292,D,1,1,23173,5762099,7178074,7406,3670459,4073599
2012-07-19,2012,293,D,1,1,23007,5785106,7178074,7247,3677706,4073599
2012-07-20,2012,294,D,1,1,23064,5808170,7178074,7376,3685082,4073599
2012-07-21,2012,295,D,1,1,23172,5831342,7178074,7466,3692548,4073599
2012-07-22,2012,296,D,1,1,23112,5854454,7178074,7420,3699968,4073599
2012-07-23,2012,297,D,1,1,23182,5877636,7178074,7447,3707415,4073599
2012-07-24,2012,298,D,1,1,23610,5901246,7178074,8371,3715786,4073599
2012-07-25,2012,299,D,1,1,23387,5924633,7178074,8199,3723985,4073599
2012-07-26,2012,300,D,1,1,23093,5947726,7178074,8881,3732866,4073599
2012-07-27,2012,301,D,1,1,23397,5971123,7178074,9916,3742782,4073599
2012-07-28,2012,302,D,1,1,23754,5994877,7178074,10346,3753128,4073599
2012-07-29,2012,303,D,1,1,24045,6018922,7178074,10645,3763773,4073599
2012-07-30,2012,304,D,1,1,23767,6042689,7178074,9813,3773586,4073599
2012-07-31,2012,305,D,1,1,23400,6066089,7178074,9525,3783111,4073599
2012-08-01,2012,306,D,1,1,23429,6089518,7178074,9476,3792587,4073599
2012-08-02,2012,307,D,1,1,23563,6113081,7178074,8592,3801179,4073599
2012-08-03,2012,308,D,1,1,23841,6136922,7178074,7586,3808765,4073599
2012-08-04,2012,309,D,1,1,23863,6160785,7178074,7627,3816392,4073599
2012-08-05,2012,310,D,1,1,24127,6184912,7178074,7986,3824378,4073599
2012-08-06,2012,311,D,1,1,24676,6209588,7178074,8522,3832900,4073599
2012-08-07,2012,312,D,1,1,24666,6234254,7178074,9677,3842577,4073599
2012-08-08,2012,313,D,1,1,24219,6258473,7178074,8067,3850644,4073599
2012-08-09,2012,314,D,1,1,21824,6280297,7178074,5805,3856449,4073599
2012-08-10,2012,315,D,1,1,21856,6302153,7178074,6502,3862951,4073599
2012-08-11,2012,316,D,1,1,21212,6323365,7178074,5876,3868827,4073599
2012-08-12,2012,317,D,1,1,20378,6343743,7178074,5043,3873870,4073599
2012-08-13,2012,318,D,1,1,19294,6363037,7178074,3367,3877237,4073599
2012-08-14,2012,319,D,1,1,18594,6381631,7178074,2659,3879896,4073599
2012-08-15,2012,320,D,1,1,18214,6399845,7178074,2270,3882166,4073599
2012-08-16,2012,321,D,1,1,17755,6417600,7178074,1944,3884110,4073599
2012-08-17,2012,322,D,1,1,17834,6435434,7178074,2684,3886794,4073599
2012-08-18,2012,323,D,1,1,17744,6453178,7178074,3185,3889979,4073599
2012-08-19,2012,324,D,1,1,17716,6470894,7178074,3237,3893216,4073599
2012-08-20,2012,325,D,1,1,17918,6488812,7178074,3445,3896661,4073599
2012-08-21,2012,326,D,1,1,17913,6506725,7178074,3002,3899663,4073599
2012-08-22,2012,327,D,1,1,18085,6524810,7178074,2703,3902366,4073599
2012-08-23,2012,328,D,1,1,17689,6542499,7178074,2263,3904629,4073599
2012-08-24,2012,329,D,1,1,16899,6559398,7178074,2469,3907098,4073599
2012-08-25,2012,330,D,1,1,16291,6575689,7178074,2897,3909995,4073599
2012-08-26,2012,331,D,1,1,16049,6591738,7178074,3771,3913766,4073599
2012-08-27,2012,332,D,1,1,16303,6608041,7178074,3896,3917662,4073599
2012-08-28,2012,333,D,1,1,15758,6623799,7178074,2949,3920611,4073599
2012-08-29,2012,334,D,1,1,15796,6639595,7178074,2534,3923145,4073599
2012-08-30,2012,335,D,1,1,15467,6655062,7178074,2265,3925410,4073599
2012-08-31,2012,336,D,1,1,15442,6670504,7178074,1585,3926995,4073599
2012-09-01,2012,337,D,1,1,16547,6687051,7178074,3057,3930052,4073599
2012-09-02,2012,338,D,1,1,16897,6703948,7178074,3387,3933439,4073599
2012-09-03,2012,339,D,1,1,17306,6721254,7178074,3885,3937324,4073599
2012-09-04,2012,340,D,1,1,17311,6738565,7178074,2400,3939724,4073599
2012-09-05,2012,341,D,1,1,17854,6756419,7178074,3001,3942725,4073599
2012-09-06,2012,342,D,1,1,18066,6774485,7178074,3293,3946018,4073599
2012-09-07,2012,343,D,1,1,18388,6792873,7178074,3474,3949492,4073599
2012-09-08,2012,344,D,1,1,18551,6811424,7178074,3727,3953219,4073599
2012-09-09,2012,345,D,1,1,18934,6830358,7178074,4281,3957500,4073599
2012-09-10,2012,346,D,1,1,19151,6849509,7178074,5047,3962547,4073599
2012-09-11,2012,347,D,1,1,19027,6868536,7178074,5964,3968511,4073599
2012-09-12,2012,348,D,1,1,18876,6887412,7178074,5863,3974374,4073599
2012-09-13,2012,349,D,1,1,18637,6906049,7178074,5736,3980110,4073599
2012-09-14,2012,350,D,1,1,18555,6924604,7178074,6211,3986321,4073599
2012-09-15,2012,351,D,1,1,18411,6943015,7178074,6626,3992947,4073599
2012-09-16,2012,352,D,1,1,18082,6961097,7178074,6742,3999689,4073599
2012-09-17,2012,353,D,1,1,17694,6978791,7178074,6999,4006688,4073599
2012-09-18,2012,354,D,1,1,17266,6996057,7178074,6912,4013600,4073599
2012-09-19,2012,355,D,1,1,16041,7012098,7178074,5714,4019314,4073599
2012-09-20,2012,356,D,1,1,15704,7027802,7178074,6125,4025439,4073599
2012-09-21,2012,357,D,1,1,15871,7043673,7178074,6268,4031707,4073599
2012-09-22,2012,358,D,1,1,15782,7059455,7178074,6050,4037757,4073599
2012-09-23,2012,359,D,1,1,15600,7075055,7178074,5857,4043614,4073599
2012-09-24,2012,360,D,1,1,15453,7090508,7178074,5375,4048989,4073599
2012-09-25,2012,361,D,1,1,14992,7105500,7178074,4352,4053341,4073599
2012-09-26,2012,362,D,1,1,14699,7120199,7178074,4000,4057341,4073599
2012-09-27,2012,363,D,1,1,14662,7134861,7178074,4259,4061600,4073599
2012-09-28,2012,364,D,1,1,14419,7149280,7178074,3922,4065522,4073599
2012-09-29,2012,365,D,1,1,14587,7163867,7178074,4224,4069746,4073599
2012-09-30,2012,366,D,1,1,14207,7178074,7178074,3853,4073599,4073599
2012-10-01,2013,1,D,2,2,14091,14091,7312616,3888,3888,4617959
2012-10-02,2013,2,D,2,2,13981,28072,7312616,3902,7790,4617959
2012-10-03,2013,3,D,2,2,13689,41761,7312616,3646,11436,4617959
2012-10-04,2013,4,D,2,2,14200,55961,7312616,4173,15609,4617959
2012-10-05,2013,5,D,2,2,15886,71847,7312616,5385,20994,4617959
2012-10-06,2013,6,D,2,2,16023,87870,7312616,4485,25479,4617959
2012-10-07,2013,7,D,2,2,15940,103810,7312616,4509,29988,4617959
2012-10-08,2013,8,D,2,2,16053,119863,7312616,4633,34621,4617959
2012-10-09,2013,9,D,2,2,16428,136291,7312616,4454,39075,4617959
2012-10-10,2013,10,D,2,2,15641,151932,7312616,3622,42697,4617959
2012-10-11,2013,11,D,2,2,15360,167292,7312616,3353,46050,4617959
2012-10-12,2013,12,D,2,2,15770,183062,7312616,4266,50316,4617959
2012-10-13,2013,13,D,2,2,14379,197441,7312616,3889,54205,4617959
2012-10-14,2013,14,D,2,2,13246,210687,7312616,3794,57999,4617959
2012-10-15,2013,15,D,2,2,12628,223315,7312616,3634,61633,4617959
2012-10-16,2013,16,D,2,2,12396,235711,7312616,3411,65044,4617959
2012-10-17,2013,17,D,2,2,12149,247860,7312616,3657,68701,4617959
2012-10-18,2013,18,D,2,2,11946,259806,7312616,3510,72211,4617959
2012-10-19,2013,19,D,2,2,11809,271615,7312616,4036,76247,4617959
2012-10-20,2013,20,D,2,2,11682,283297,7312616,4218,80465,4617959
2012-10-21,2013,21,D,2,2,12212,295509,7312616,4737,85202,4617959
2012-10-22,2013,22,D,2,2,13431,308940,7312616,8068,93270,4617959
2012-10-23,2013,23,D,2,2,14328,323268,7312616,9661,102931,4617959
2012-10-24,2013,24,D,2,2,13896,337164,7312616,8758,111689,4617959
2012-10-25,2013,25,D,2,2,14234,351398,7312616,8109,119798,4617959
2012-10-26,2013,26,D,2,2,13442,364840,7312616,4352,124150,4617959
2012-10-27,2013,27,D,2,2,13008,377848,7312616,1902,126052,4617959
2012-10-28,2013,28,D,2,2,12366,390214,7312616,2434,128486,4617959
2012-10-29,2013,29,D,2,2,12080,402294,7312616,3215,131701,4617959
2012-10-30,2013,30,D,2,2,11883,414177,7312616,3816,135517,4617959
2012-10-31,2013,31,D,2,2,11498,425675,7312616,3267,138784,4617959
2012-11-01,2013,32,D,2,2,11927,437602,7312616,4755,143539,4617959
2012-11-02,2013,33,D,2,2,11950,449552,7312616,4786,148325,4617959
2012-11-03,2013,34,D,2,2,12231,461783,7312616,4844,153169,4617959
2012-11-04,2013,35,D,2,2,12423,474206,7312616,4836,158005,4617959
2012-11-05,2013,36,D,2,2,12212,486418,7312616,4785,162790,4617959
2012-11-06,2013,37,D,2,2,12316,498734,7312616,4204,166994,4617959
2012-11-07,2013,38,D,2,2,11745,510479,7312616,3623,170617,4617959
2012-11-08,2013,39,D,2,2,11696,522175,7312616,3859,174476,4617959
2012-11-09,2013,40,D,2,2,11843,534018,7312616,4230,178706,4617959
2012-11-10,2013,41,D,2,2,11246,545264,7312616,4120,182826,4617959
2012-11-11,2013,42,D,2,2,10884,556148,7312616,3769,186595,4617959
2012-11-12,2013,43,D,2,2,10493,566641,7312616,3369,189964,4617959
2012-11-13,2013,44,D,2,2,10115,576756,7312616,5222,195186,4617959
2012-11-14,2013,45,D,2,2,10351,587107,7312616,5561,200747,4617959
2012-11-15,2013,46,D,2,2,10496,597603,7312616,3543,204290,4617959
2012-11-16,2013,47,D,2,2,10790,608393,7312616,4541,208831,4617959
2012-11-17,2013,48,D,2,2,11168,619561,7312616,7012,215843,4617959
2012-11-18,2013,49,D,2,2,13582,633143,7312616,11466,227309,4617959
2012-11-19,2013,50,D,2,2,15444,648587,7312616,8850,236159,4617959
2012-11-20,2013,51,D,2,2,17121,665708,7312616,10498,246657,4617959
2012-11-21,2013,52,D,2,2,17418,683126,7312616,11851,258508,4617959
2012-11-22,2013,53,D,2,2,16698,699824,7312616,8835,267343,4617959
2012-11-23,2013,54,D,2,2,17710,717534,7312616,8295,275638,4617959
2012-11-24,2013,55,D,2,2,18883,736417,7312616,9963,285601,4617959
2012-11-25,2013,56,D,2,2,17168,753585,7312616,8175,293776,4617959
2012-11-26,2013,57,D,2,2,15427,769012,7312616,5071,298847,4617959
2012-11-27,2013,58,D,2,2,14388,783400,7312616,3468,302315,4617959
2012-11-28,2013,59,D,2,2,14142,797542,7312616,3580,305895,4617959
2012-11-29,2013,60,D,2,2,15730,813272,7312616,4709,310604,4617959
2012-11-30,2013,61,D,2,2,20006,833278,7312616,16931,327535,4617959
2012-12-01,2013,62,D,2,2,35206,868484,7312616,32234,359769,4617959
2012-12-02,2013,63,D,2,2,55167,923651,7312616,59683,419452,4617959
2012-12-03,2013,64,D,2,2,64070,987721,7312616,67588,487040,4617959
2012-12-04,2013,65,D,2,2,65293,1053014,7312616,68780,555820,4617959
2012-12-05,2013,66,D,2,2,63918,1116932,7312616,60915,616735,4617959
2012-12-06,2013,67,D,2,2,64435,1181367,7312616,60297,677032,4617959
2012-12-07,2013,68,D,2,2,64878,1246245,7312616,53262,730294,4617959
2012-12-08,2013,69,D,2,2,63379,1309624,7312616,56702,786996,4617959
2012-12-09,2013,70,D,2,2,59500,1369124,7312616,52821,839817,4617959
2012-12-10,2013,71,D,2,2,52878,1422002,7312616,44599,884416,4617959
2012-12-11,2013,72,D,2,2,46366,1468368,7312616,33459,917875,4617959
2012-12-12,2013,73,D,2,2,41156,1509524,7312616,28653,946528,4617959
2012-12-13,2013,74,D,2,2,36975,1546499,7312616,24486,971014,4617959
2012-12-14,2013,75,D,2,2,34123,1580622,7312616,21621,992635,4617959
2012-12-15,2013,76,D,2,2,31476,1612098,7312616,19695,1012330,4617959
2012-12-16,2013,77,D,2,2,27276,1639374,7312616,15119,1027449,4617959
2012-12-17,2013,78,D,2,2,26124,1665498,7312616,13499,1040948,4617959
2012-12-18,2013,79,D,2,2,28180,1693678,7312616,15740,1056688,4617959
2012-12-19,2013,80,D,2,2,32480,1726158,7312616,27491,1084179,4617959
2012-12-20,2013,81,D,2,2,33648,1759806,7312616,29371,1113550,4617959
2012-12-21,2013,82,D,2,2,32238,1792044,7312616,28477,1142027,4617959
2012-12-22,2013,83,D,2,2,36716,1828760,7312616,37994,1180021,4617959
2012-12-23,2013,84,D,2,2,54988,1883748,7312616,58877,1238898,4617959
2012-12-24,2013,85,D,2,2,67883,1951631,7312616,70890,1309788,4617959
2012-12-25,2013,86,D,2,2,76304,2027935,7312616,80434,1390222,4617959
2012-12-26,2013,87,D,2,2,85905,2113840,7312616,89080,1479302,4617959
2012-12-27,2013,88,D,2,2,88648,2202488,7312616,87088,1566390,4617959
2012-12-28,2013,89,D,2,2,80744,2283232,7312616,76201,1642591,4617959
2012-12-29,2013,90,D,2,2,72031,2355263,7312616,67535,1710126,4617959
2012-12-30,2013,91,D,2,2,65806,2421069,7312616,60217,1770343,4617959
2012-12-31,2013,92,D,2,2,58220,2479289,7312616,52969,1823312,4617959
2013-01-01,2013,93,D,2,2,50708,2529997,7312616,45358,1868670,4617959
2013-01-02,2013,94,D,2,2,44932,2574929,7312616,38343,1907013,4617959
2013-01-03,2013,95,D,2,2,41427,2616356,7312616,33956,1940969,4617959
2013-01-04,2013,96,D,2,2,39009,2655365,7312616,33453,1974422,4617959
2013-01-05,2013,97,D,2,2,35366,2690731,7312616,33863,2008285,4617959
2013-01-06,2013,98,D,2,2,33210,2723941,7312616,33884,2042169,4617959
2013-01-07,2013,99,D,2,2,31531,2755472,7312616,31152,2073321,4617959
2013-01-08,2013,100,D,2,2,29259,2784731,7312616,29945,2103266,4617959
2013-01-09,2013,101,D,2,2,28337,2813068,7312616,29525,2132791,4617959
2013-01-10,2013,102,D,2,2,27806,2840874,7312616,24596,2157387,4617959
2013-01-11,2013,103,D,2,2,27952,2868826,7312616,22020,2179407,4617959
2013-01-12,2013,104,D,2,2,26921,2895747,7312616,19654,2199061,4617959
2013-01-13,2013,105,D,2,2,26590,2922337,7312616,19284,2218345,4617959
2013-01-14,2013,106,D,2,2,25743,2948080,7312616,19030,2237375,4617959
2013-01-15,2013,107,D,2,2,24684,2972764,7312616,18000,2255375,4617959
2013-01-16,2013,108,D,2,2,23368,2996132,7312616,16830,2272205,4617959
2013-01-17,2013,109,D,2,2,22395,3018527,7312616,16482,2288687,4617959
2013-01-18,2013,110,D,2,2,21852,3040379,7312616,15479,2304166,4617959
2013-01-19,2013,111,D,2,2,21290,3061669,7312616,14923,2319089,4617959
2013-01-20,2013,112,D,2,2,20352,3082021,7312616,14471,2333560,4617959
2013-01-21,2013,113,D,2,2,19913,3101934,7312616,14094,2347654,4617959
2013-01-22,2013,114,D,2,2,19505,3121439,7312616,13673,2361327,4617959
2013-01-23,2013,115,D,2,2,19486,3140925,7312616,13937,2375264,4617959
2013-01-24,2013,116,D,2,2,19775,3160700,7312616,15018,2390282,4617959
2013-01-25,2013,117,D,2,2,19813,3180513,7312616,16729,2407011,4617959
2013-01-26,2013,118,D,2,2,20274,3200787,7312616,16941,2423952,4617959
2013-01-27,2013,119,D,2,2,21773,3222560,7312616,18487,2442439,4617959
2013-01-28,2013,120,D,2,2,22038,3244598,7312616,18517,2460956,4617959
2013-01-29,2013,121,D,2,2,22615,3267213,7312616,18651,2479607,4617959
2013-01-30,2013,122,D,2,2,22200,3289413,7312616,17499,2497106,4617959
2013-01-31,2013,123,D,2,2,21836,3311249,7312616,17179,2514285,4617959
2013-02-01,2013,124,D,2,2,21704,3332953,7312616,16747,2531032,4617959
2013-02-02,2013,125,D,2,2,21575,3354528,7312616,16492,2547524,4617959
2013-02-03,2013,126,D,2,2,21155,3375683,7312616,16087,2563611,4617959
2013-02-04,2013,127,D,2,2,20831,3396514,7312616,15750,2579361,4617959
2013-02-05,2013,128,D,2,2,20201,3416715,7312616,15122,2594483,4617959
2013-02-06,2013,129,D,2,2,20861,3437576,7312616,15791,2610274,4617959
2013-02-07,2013,130,D,2,2,20697,3458273,7312616,15554,2625828,4617959
2013-02-08,2013,131,D,2,2,20601,3478874,7312616,15407,2641235,4617959
2013-02-09,2013,132,D,2,2,20329,3499203,7312616,15146,2656381,4617959
2013-02-10,2013,133,D,2,2,20323,3519526,7312616,15195,2671576,4617959
2013-02-11,2013,134,D,2,2,19894,3539420,7312616,15911,2687487,4617959
2013-02-12,2013,135,D,2,2,19458,3558878,7312616,15710,2703197,4617959
2013-02-13,2013,136,D,2,2,19030,3577908,7312616,14234,2717431,4617959
2013-02-14,2013,137,D,2,2,18408,3596316,7312616,13567,2730998,4617959
2013-02-15,2013,138,D,2,2,18003,3614319,7312616,13148,2744146,4617959
2013-02-16,2013,139,D,2,2,17737,3632056,7312616,12843,2756989,4617959
2013-02-17,2013,140,D,2,2,17454,3649510,7312616,12546,2769535,4617959
2013-02-18,2013,141,D,2,2,17047,3666557,7312616,12200,2781735,4617959
2013-02-19,2013,142,D,2,2,17131,3683688,7312616,13421,2795156,4617959
2013-02-20,2013,143,D,2,2,17592,3701280,7312616,13699,2808855,4617959
2013-02-21,2013,144,D,2,2,17351,3718631,7312616,12168,2821023,4617959
2013-02-22,2013,145,D,2,2,16935,3735566,7312616,11911,2832934,4617959
2013-02-23,2013,146,D,2,2,16948,3752514,7312616,10640,2843574,4617959
2013-02-24,2013,147,D,2,2,16893,3769407,7312616,9905,2853479,4617959
2013-02-25,2013,148,D,2,2,16388,3785795,7312616,9423,2862902,4617959
2013-02-26,2013,149,D,2,2,16123,3801918,7312616,9145,2872047,4617959
2013-02-27,2013,150,D,2,2,16019,3817937,7312616,9025,2881072,4617959
2013-02-28,2013,151,D,2,2,15791,3833728,7312616,9220,2890292,4617959
2013-03-01,2013,152,D,2,2,15499,3849227,7312616,8894,2899186,4617959
2013-03-02,2013,153,D,2,2,15113,3864340,7312616,7948,2907134,4617959
2013-03-03,2013,154,D,2,2,14932,3879272,7312616,7783,2914917,4617959
2013-03-04,2013,155,D,2,2,15297,3894569,7312616,8598,2923515,4617959
2013-03-05,2013,156,D,2,2,14823,3909392,7312616,7920,2931435,4617959
2013-03-06,2013,157,D,2,2,14544,3923936,7312616,7555,2938990,4617959
2013-03-07,2013,158,D,2,2,14958,3938894,7312616,8559,2947549,4617959
2013-03-08,2013,159,D,2,2,14298,3953192,7312616,7747,2955296,4617959
2013-03-09,2013,160,D,2,2,15184,3968376,7312616,8603,2963899,4617959
2013-03-10,2013,161,D,2,2,14501,3982877,7312616,8089,2971988,4617959
2013-03-11,2013,162,D,2,2,15224,3998101,7312616,8613,2980601,4617959
2013-03-12,2013,163,D,2,2,17114,4015215,7312616,10507,2991108,4617959
2013-03-13,2013,164,D,2,2,17699,4032914,7312616,12957,3004065,4617959
2013-03-14,2013,165,D,2,2,17559,4050473,7312616,13339,3017404,4617959
2013-03-15,2013,166,D,2,2,17540,4068013,7312616,11962,3029366,4617959
2013-03-16,2013,167,D,2,2,17572,4085585,7312616,11876,3041242,4617959
2013-03-17,2013,168,D,2,2,18192,4103777,7312616,12515,3053757,4617959
2013-03-18,2013,169,D,2,2,18303,4122080,7312616,12138,3065895,4617959
2013-03-19,2013,170,D,2,2,17903,4139983,7312616,12402,3078297,4617959
2013-03-20,2013,171,D,2,2,17105,4157088,7312616,11557,3089854,4617959
2013-03-21,2013,172,D,2,2,16652,4173740,7312616,9804,3099658,4617959
2013-03-22,2013,173,D,2,2,17055,4190795,7312616,9781,3109439,4617959
2013-03-23,2013,174,D,2,2,16734,4207529,7312616,11035,3120474,4617959
2013-03-24,2013,175,D,2,2,16159,4223688,7312616,8805,3129279,4617959
2013-03-25,2013,176,D,2,2,15400,4239088,7312616,9177,3138456,4617959
2013-03-26,2013,177,D,2,2,15243,4254331,7312616,9043,3147499,4617959
2013-03-27,2013,178,D,2,2,14784,4269115,7312616,8577,3156076,4617959
2013-03-28,2013,179,D,2,2,14350,4283465,7312616,7094,3163170,4617959
2013-03-29,2013,180,D,2,2,13679,4297144,7312616,6422,3169592,4617959
2013-03-30,2013,181,D,2,2,13377,4310521,7312616,7465,3177057,4617959
2013-03-31,2013,182,D,2,2,15096,4325617,7312616,11669,3188726,4617959
2013-04-01,2013,183,D,2,2,16912,4342529,7312616,18144,3206870,4617959
2013-04-02,2013,184,D,2,2,18282,4360811,7312616,19618,3226488,4617959
2013-04-03,2013,185,D,2,2,19496,4380307,7312616,20817,3247305,4617959
2013-04-04,2013,186,D,2,2,19698,4400005,7312616,21681,3268986,4617959
2013-04-05,2013,187,D,2,2,19849,4419854,7312616,19290,3288276,4617959
2013-04-06,2013,188,D,2,2,18765,4438619,7312616,17529,3305805,4617959
2013-04-07,2013,189,D,2,2,18088,4456707,7312616,17300,3323105,4617959
2013-04-08,2013,190,D,2,2,18982,4475689,7312616,18196,3341301,4617959
2013-04-09,2013,191,D,2,2,19173,4494862,7312616,16270,3357571,4617959
2013-04-10,2013,192,D,2,2,18191,4513053,7312616,15284,3372855,4617959
2013-04-11,2013,193,D,2,2,17803,4530856,7312616,14903,3387758,4617959
2013-04-12,2013,194,D,2,2,17169,4548025,7312616,13822,3401580,4617959
2013-04-13,2013,195,D,2,2,16522,4564547,7312616,13070,3414650,4617959
2013-04-14,2013,196,D,2,2,15740,4580287,7312616,12293,3426943,4617959
2013-04-15,2013,197,D,2,2,15412,4595699,7312616,12087,3439030,4617959
2013-04-16,2013,198,D,2,2,15318,4611017,7312616,11913,3450943,4617959
2013-04-17,2013,199,D,2,2,14011,4625028,7312616,10600,3461543,4617959
2013-04-18,2013,200,D,2,2,12865,4637893,7312616,9450,3470993,4617959
2013-04-19,2013,201,D,2,2,12209,4650102,7312616,8489,3479482,4617959
2013-04-20,2013,202,D,2,2,11707,4661809,7312616,7724,3487206,4617959
2013-04-21,2013,203,D,2,2,11215,4673024,7312616,6924,3494130,4617959
2013-04-22,2013,204,D,2,2,11005,4684029,7312616,6713,3500843,4617959
2013-04-23,2013,205,D,2,2,10780,4694809,7312616,6376,3507219,4617959
2013-04-24,2013,206,D,2,2,10462,4705271,7312616,5968,3513187,4617959
2013-04-25,2013,207,D,2,2,11373,4716644,7312616,7580,3520767,4617959
2013-04-26,2013,208,D,2,2,12603,4729247,7312616,8810,3529577,4617959
2013-04-27,2013,209,D,2,2,14046,4743293,7312616,10248,3539825,4617959
2013-04-28,2013,210,D,2,2,15774,4759067,7312616,11894,3551719,4617959
2013-04-29,2013,211,D,2,2,16737,4775804,7312616,11458,3563177,4617959
2013-04-30,2013,212,D,2,2,17445,4793249,7312616,11520,3574697,4617959
2013-05-01,2013,213,D,2,2,17598,4810847,7312616,11416,3586113,4617959
2013-05-02,2013,214,D,2,2,16665,4827512,7312616,10802,3596915,4617959
2013-05-03,2013,215,D,2,2,15321,4842833,7312616,9411,3606326,4617959
2013-05-04,2013,216,D,2,2,14456,4857289,7312616,9173,3615499,4617959
2013-05-05,2013,217,D,2,2,13663,4870952,7312616,8805,3624304,4617959
2013-05-06,2013,218,D,2,2,13393,4884345,7312616,9139,3633443,4617959
2013-05-07,2013,219,D,2,2,13503,4897848,7312616,9343,3642786,4617959
2013-05-08,2013,220,D,2,2,14313,4912161,7312616,10141,3652927,4617959
2013-05-09,2013,221,D,2,2,15671,4927832,7312616,11427,3664354,4617959
2013-05-10,2013,222,D,2,2,16323,4944155,7312616,11855,3676209,4617959
2013-05-11,2013,223,D,2,2,16585,4960740,7312616,11998,3688207,4617959
2013-05-12,2013,224,D,2,2,15909,4976649,7312616,11263,3699470,4617959
2013-05-13,2013,225,D,2,2,15817,4992466,7312616,11371,3710841,4617959
2013-05-14,2013,226,D,2,2,14960,5007426,7312616,10359,3721200,4617959
2013-05-15,2013,227,D,2,2,14429,5021855,7312616,9858,3731058,4617959
2013-05-16,2013,228,D,2,2,13509,5035364,7312616,9036,3740094,4617959
2013-05-17,2013,229,D,2,2,13916,5049280,7312616,9736,3749830,4617959
2013-05-18,2013,230,D,2,2,14341,5063621,7312616,10095,3759925,4617959
2013-05-19,2013,231,D,2,2,14581,5078202,7312616,10267,3770192,4617959
2013-05-20,2013,232,D,2,2,14432,5092634,7312616,10219,3780411,4617959
2013-05-21,2013,233,D,2,2,13503,5106137,7312616,9169,3789580,4617959
2013-05-22,2013,234,D,2,2,13997,5120134,7312616,9661,3799241,4617959
2013-05-23,2013,235,D,2,2,13660,5133794,7312616,9237,3808478,4617959
2013-05-24,2013,236,D,2,2,13704,5147498,7312616,9241,3817719,4617959
2013-05-25,2013,237,D,2,2,13624,5161122,7312616,9044,3826763,4617959
2013-05-26,2013,238,D,2,2,13625,5174747,7312616,9128,3835891,4617959
2013-05-27,2013,239,D,2,2,14063,5188810,7312616,9519,3845410,4617959
2013-05-28,2013,240,D,2,2,14249,5203059,7312616,9668,3855078,4617959
2013-05-29,2013,241,D,2,2,14597,5217656,7312616,10042,3865120,4617959
2013-05-30,2013,242,D,2,2,15516,5233172,7312616,10828,3875948,4617959
2013-05-31,2013,243,D,2,2,15588,5248760,7312616,10853,3886801,4617959
2013-06-01,2013,244,D,2,2,15006,5263766,7312616,9243,3896044,4617959
2013-06-02,2013,245,D,2,2,14230,5277996,7312616,8407,3904451,4617959
2013-06-03,2013,246,D,2,2,12786,5290782,7312616,7133,3911584,4617959
2013-06-04,2013,247,D,2,2,12649,5303431,7312616,7222,3918806,4617959
2013-06-05,2013,248,D,2,2,12691,5316122,7312616,7411,3926217,4617959
2013-06-06,2013,249,D,2,2,12661,5328783,7312616,7159,3933376,4617959
2013-06-07,2013,250,D,2,2,12685,5341468,7312616,7386,3940762,4617959
2013-06-08,2013,251,D,2,2,12167,5353635,7312616,6855,3947617,4617959
2013-06-09,2013,252,D,2,2,12759,5366394,7312616,7385,3955002,4617959
2013-06-10,2013,253,D,2,2,14375,5380769,7312616,8863,3963865,4617959
2013-06-11,2013,254,D,2,2,14103,5394872,7312616,6848,3970713,4617959
2013-06-12,2013,255,D,2,2,14259,5409131,7312616,7443,3978156,4617959
2013-06-13,2013,256,D,2,2,15222,5424353,7312616,8339,3986495,4617959
2013-06-14,2013,257,D,2,2,15443,5439796,7312616,7825,3994320,4617959
2013-06-15,2013,258,D,2,2,14527,5454323,7312616,6838,4001158,4617959
2013-06-16,2013,259,D,2,2,14251,5468574,7312616,7104,4008262,4617959
2013-06-17,2013,260,D,2,2,13833,5482407,7312616,7355,4015617,4617959
2013-06-18,2013,261,D,2,2,13366,5495773,7312616,7227,4022844,4617959
2013-06-19,2013,262,D,2,2,14583,5510356,7312616,8593,4031437,4617959
2013-06-20,2013,263,D,2,2,13739,5524095,7312616,6487,4037924,4617959
2013-06-21,2013,264,D,2,2,13491,5537586,7312616,6974,4044898,4617959
2013-06-22,2013,265,D,2,2,13626,5551212,7312616,8053,4052951,4617959
2013-06-23,2013,266,D,2,2,14046,5565258,7312616,8453,4061404,4617959
2013-06-24,2013,267,D,2,2,15229,5580487,7312616,8369,4069773,4617959
2013-06-25,2013,268,D,2,2,15862,5596349,7312616,7971,4077744,4617959
2013-06-26,2013,269,D,2,2,17311,5613660,7312616,8892,4086636,4617959
2013-06-27,2013,270,D,2,2,18960,5632620,7312616,8973,4095609,4617959
2013-06-28,2013,271,D,2,2,20490,5653110,7312616,9506,4105115,4617959
2013-06-29,2013,272,D,2,2,20952,5674062,7312616,9405,4114520,4617959
2013-06-30,2013,273,D,2,2,20718,5694780,7312616,9342,4123862,4617959
2013-07-01,2013,274,D,2,2,20722,5715502,7312616,7358,4131220,4617959
2013-07-02,2013,275,D,2,2,19928,5735430,7312616,5730,4136950,4617959
2013-07-03,2013,276,D,2,2,19929,5755359,7312616,5662,4142612,4617959
2013-07-04,2013,277,D,2,2,19255,5774614,7312616,4505,4147117,4617959
2013-07-05,2013,278,D,2,2,18457,5793071,7312616,4676,4151793,4617959
2013-07-06,2013,279,D,2,2,18826,5811897,7312616,5349,4157142,4617959
2013-07-07,2013,280,D,2,2,19413,5831310,7312616,5889,4163031,4617959
2013-07-08,2013,281,D,2,2,19350,5850660,7312616,4220,4167251,4617959
2013-07-09,2013,282,D,2,2,19201,5869861,7312616,5244,4172495,4617959
2013-07-10,2013,283,D,2,2,18846,5888707,7312616,4905,4177400,4617959
2013-07-11,2013,284,D,2,2,18781,5907488,7312616,5345,4182745,4617959
2013-07-12,2013,285,D,2,2,18706,5926194,7312616,5225,4187970,4617959
2013-07-13,2013,286,D,2,2,18851,5945045,7312616,5373,4193343,4617959
2013-07-14,2013,287,D,2,2,18712,5963757,7312616,5254,4198597,4617959
2013-07-15,2013,288,D,2,2,18454,5982211,7312616,4983,4203580,4617959
2013-07-16,2013,289,D,2,2,18432,6000643,7312616,4978,4208558,4617959
2013-07-17,2013,290,D,2,2,18883,6019526,7312616,5909,4214467,4617959
2013-07-18,2013,291,D,2,2,18676,6038202,7312616,5701,4220168,4617959
2013-07-19,2013,292,D,2,2,18740,6056942,7312616,5769,4225937,4617959
2013-07-20,2013,293,D,2,2,18694,6075636,7312616,5372,4231309,4617959
2013-07-21,2013,294,D,2,2,18488,6094124,7312616,5071,4236380,4617959
2013-07-22,2013,295,D,2,2,18657,6112781,7312616,5651,4242031,4617959
2013-07-23,2013,296,D,2,2,19172,6131953,7312616,5972,4248003,4617959
2013-07-24,2013,297,D,2,2,19308,6151261,7312616,5383,4253386,4617959
2013-07-25,2013,298,D,2,2,19128,6170389,7312616,5257,4258643,4617959
2013-07-26,2013,299,D,2,2,19085,6189474,7312616,5908,4264551,4617959
2013-07-27,2013,300,D,2,2,18965,6208439,7312616,6200,4270751,4617959
2013-07-28,2013,301,D,2,2,18799,6227238,7312616,6032,4276783,4617959
2013-07-29,2013,302,D,2,2,18836,6246074,7312616,5227,4282010,4617959
2013-07-30,2013,303,D,2,2,19295,6265369,7312616,5718,4287728,4617959
2013-07-31,2013,304,D,2,2,18411,6283780,7312616,4884,4292612,4617959
2013-08-01,2013,305,D,2,2,18167,6301947,7312616,5127,4297739,4617959
2013-08-02,2013,306,D,2,2,18411,6320358,7312616,6065,4303804,4617959
2013-08-03,2013,307,D,2,2,18235,6338593,7312616,6203,4310007,4617959
2013-08-04,2013,308,D,2,2,18013,6356606,7312616,5939,4315946,4617959
2013-08-05,2013,309,D,2,2,18118,6374724,7312616,5179,4321125,4617959
2013-08-06,2013,310,D,2,2,17997,6392721,7312616,5044,4326169,4617959
2013-08-07,2013,311,D,2,2,17747,6410468,7312616,4885,4331054,4617959
2013-08-08,2013,312,D,2,2,17963,6428431,7312616,5099,4336153,4617959
2013-08-09,2013,313,D,2,2,17407,6445838,7312616,4547,4340700,4617959
2013-08-10,2013,314,D,2,2,18100,6463938,7312616,5149,4345849,4617959
2013-08-11,2013,315,D,2,2,18446,6482384,7312616,5079,4350928,4617959
2013-08-12,2013,316,D,2,2,18495,6500879,7312616,5309,4356237,4617959
2013-08-13,2013,317,D,2,2,18853,6519732,7312616,5720,4361957,4617959
2013-08-14,2013,318,D,2,2,18740,6538472,7312616,6164,4368121,4617959
2013-08-15,2013,319,D,2,2,19038,6557510,7312616,5865,4373986,4617959
2013-08-16,2013,320,D,2,2,19457,6576967,7312616,5203,4379189,4617959
2013-08-17,2013,321,D,2,2,19561,6596528,7312616,5225,4384414,4617959
2013-08-18,2013,322,D,2,2,19745,6616273,7312616,5042,4389456,4617959
2013-08-19,2013,323,D,2,2,19270,6635543,7312616,4105,4393561,4617959
2013-08-20,2013,324,D,2,2,18654,6654197,7312616,3404,4396965,4617959
2013-08-21,2013,325,D,2,2,18792,6672989,7312616,4098,4401063,4617959
2013-08-22,2013,326,D,2,2,19131,6692120,7312616,4500,4405563,4617959
2013-08-23,2013,327,D,2,2,19598,6711718,7312616,4450,4410013,4617959
2013-08-24,2013,328,D,2,2,19598,6731316,7312616,4437,4414450,4617959
2013-08-25,2013,329,D,2,2,20111,6751427,7312616,4870,4419320,4617959
2013-08-26,2013,330,D,2,2,20017,6771444,7312616,4986,4424306,4617959
2013-08-27,2013,331,D,2,2,19815,6791259,7312616,4644,4428950,4617959
2013-08-28,2013,332,D,2,2,19575,6810834,7312616,4460,4433410,4617959
2013-08-29,2013,333,D,2,2,19317,6830151,7312616,5427,4438837,4617959
2013-08-30,2013,334,D,2,2,19226,6849377,7312616,5902,4444739,4617959
2013-08-31,2013,335,D,2,2,18772,6868149,7312616,5467,4450206,4617959
2013-09-01,2013,336,D,2,2,18253,6886402,7312616,4948,4455154,4617959
2013-09-02,2013,337,D,2,2,18016,6904418,7312616,4931,4460085,4617959
2013-09-03,2013,338,D,2,2,17684,6922102,7312616,6050,4466135,4617959
2013-09-04,2013,339,D,2,2,17520,6939622,7312616,6004,4472139,4617959
2013-09-05,2013,340,D,2,2,17691,6957313,7312616,6205,4478344,4617959
2013-09-06,2013,341,D,2,2,17851,6975164,7312616,6420,4484764,4617959
2013-09-07,2013,342,D,2,2,17681,6992845,7312616,5910,4490674,4617959
2013-09-08,2013,343,D,2,2,17552,7010397,7312616,6105,4496779,4617959
2013-09-09,2013,344,D,2,2,17095,7027492,7312616,5723,4502502,4617959
2013-09-10,2013,345,D,2,2,16118,7043610,7312616,5693,4508195,4617959
2013-09-11,2013,346,D,2,2,16175,7059785,7312616,6923,4515118,4617959
2013-09-12,2013,347,D,2,2,15506,7075291,7312616,6629,4521747,4617959
2013-09-13,2013,348,D,2,2,14879,7090170,7312616,6042,4527789,4617959
2013-09-14,2013,349,D,2,2,14485,7104655,7312616,6732,4534521,4617959
2013-09-15,2013,350,D,2,2,14286,7118941,7312616,6831,4541352,4617959
2013-09-16,2013,351,D,2,2,14490,7133431,7312616,6626,4547978,4617959
2013-09-17,2013,352,D,2,2,13827,7147258,7312616,5934,4553912,4617959
2013-09-18,2013,353,D,2,2,13509,7160767,7312616,5672,4559584,4617959
2013-09-19,2013,354,D,2,2,12982,7173749,7312616,4571,4564155,4617959
2013-09-20,2013,355,D,2,2,11868,7185617,7312616,3469,4567624,4617959
2013-09-21,2013,356,D,2,2,12048,7197665,7312616,6172,4573796,4617959
2013-09-22,2013,357,D,2,2,12755,7210420,7312616,6738,4580534,4617959
2013-09-23,2013,358,D,2,2,12952,7223372,7312616,5632,4586166,4617959
2013-09-24,2013,359,D,2,2,12993,7236365,7312616,5367,4591533,4617959
2013-09-25,2013,360,D,2,2,12974,7249339,7312616,5209,4596742,4617959
2013-09-26,2013,361,D,2,2,13182,7262521,7312616,3280,4600022,4617959
2013-09-27,2013,362,D,2,2,12831,7275352,7312616,4480,4604502,4617959
2013-09-28,2013,363,D,2,2,12729,7288081,7312616,4404,4608906,4617959
2013-09-29,2013,364,D,2,2,12546,7300627,7312616,4760,4613666,4617959
2013-09-30,2013,365,D,2,2,11989,7312616,7312616,4293,4617959,4617959
2013-10-01,2014,1,D,3,3+,11542,11542,3801343,4384,4384,2162936
2013-10-02,2014,2,D,3,3+,10901,22443,3801343,3777,8161,2162936
2013-10-03,2014,3,D,3,3+,11103,33546,3801343,4774,12935,2162936
2013-10-04,2014,4,D,3,3+,10462,44008,3801343,3624,16559,2162936
2013-10-05,2014,5,D,3,3+,10074,54082,3801343,3723,20282,2162936
2013-10-06,2014,6,D,3,3+,10056,64138,3801343,3736,24018,2162936
2013-10-07,2014,7,D,3,3+,9848,73986,3801343,3527,27545,2162936
2013-10-08,2014,8,D,3,3+,10316,84302,3801343,4516,32061,2162936
2013-10-09,2014,9,D,3,3+,10128,94430,3801343,4326,36387,2162936
2013-10-10,2014,10,D,3,3+,10022,104452,3801343,4251,40638,2162936
2013-10-11,2014,11,D,3,3+,10003,114455,3801343,4257,44895,2162936
2013-10-12,2014,12,D,3,3+,10035,124490,3801343,4291,49186,2162936
2013-10-13,2014,13,D,3,3+,10242,134732,3801343,4455,53641,2162936
2013-10-14,2014,14,D,3,3+,9561,144293,3801343,3821,57462,2162936
2013-10-15,2014,15,D,3,3+,9555,153848,3801343,3921,61383,2162936
2013-10-16,2014,16,D,3,3+,9484,163332,3801343,3816,65199,2162936
2013-10-17,2014,17,D,3,3+,9153,172485,3801343,3425,68624,2162936
2013-10-18,2014,18,D,3,3+,8846,181331,3801343,3173,71797,2162936
2013-10-19,2014,19,D,3,3+,8601,189932,3801343,3188,74985,2162936
2013-10-20,2014,20,D,3,3+,8364,198296,3801343,2991,77976,2162936
2013-10-21,2014,21,D,3,3+,8346,206642,3801343,3002,80978,2162936
2013-10-22,2014,22,D,3,3+,8734,215376,3801343,3372,84350,2162936
2013-10-23,2014,23,D,3,3+,8302,223678,3801343,3625,87975,2162936
2013-10-24,2014,24,D,3,3+,9006,232684,3801343,4627,92602,2162936
2013-10-25,2014,25,D,3,3+,9897,242581,3801343,5522,98124,2162936
2013-10-26,2014,26,D,3,3+,9872,252453,3801343,5511,103635,2162936
2013-10-27,2014,27,D,3,3+,8636,261089,3801343,4277,107912,2162936
2013-10-28,2014,28,D,3,3+,10877,271966,3801343,6994,114906,2162936
2013-10-29,2014,29,D,3,3+,10900,282866,3801343,7235,122141,2162936
2013-10-30,2014,30,D,3,3+,10682,293548,3801343,5952,128093,2162936
2013-10-31,2014,31,D,3,3+,10733,304281,3801343,4386,132479,2162936
2013-11-01,2014,32,D,3,3+,10732,315013,3801343,5541,138020,2162936
2013-11-02,2014,33,D,3,3+,10650,325663,3801343,4957,142977,2162936
2013-11-03,2014,34,D,3,3+,11854,337517,3801343,6066,149043,2162936
2013-11-04,2014,35,D,3,3+,11350,348867,3801343,4570,153613,2162936
2013-11-05,2014,36,D,3,3+,11082,359949,3801343,4213,157826,2162936
2013-11-06,2014,37,D,3,3+,10659,370608,3801343,3783,161609,2162936
2013-11-07,2014,38,D,3,3+,10381,380989,3801343,3096,164705,2162936
2013-11-08,2014,39,D,3,3+,10584,391573,3801343,3698,168403,2162936
2013-11-09,2014,40,D,3,3+,10444,402017,3801343,3535,171938,2162936
2013-11-10,2014,41,D,3,3+,10392,412409,3801343,3985,175923,2162936
2013-11-11,2014,42,D,3,3+,10472,422881,3801343,4216,180139,2162936
2013-11-12,2014,43,D,3,3+,10000,432881,3801343,3616,183755,2162936
2013-11-13,2014,44,D,3,3+,9706,442587,3801343,3326,187081,2162936
2013-11-14,2014,45,D,3,3+,9511,452098,3801343,3152,190233,2162936
2013-11-15,2014,46,D,3,3+,9446,461544,3801343,3407,193640,2162936
2013-11-16,2014,47,D,3,3+,9394,470938,3801343,3535,197175,2162936
2013-11-17,2014,48,D,3,3+,9501,480439,3801343,3657,200832,2162936
2013-11-18,2014,49,D,3,3+,9336,489775,3801343,3473,204305,2162936
2013-11-19,2014,50,D,3,3+,9414,499189,3801343,5404,209709,2162936
2013-11-20,2014,51,D,3,3+,9692,508881,3801343,10494,220203,2162936
2013-11-21,2014,52,D,3,3+,11094,519975,3801343,12426,232629,2162936
2013-11-22,2014,53,D,3,3+,11111,531086,3801343,12738,245367,2162936
2013-11-23,2014,54,D,3,3+,10781,541867,3801343,12415,257782,2162936
2013-11-24,2014,55,D,3,3+,10725,552592,3801343,10525,268307,2162936
2013-11-25,2014,56,D,3,3+,10358,562950,3801343,6145,274452,2162936
2013-11-26,2014,57,D,3,3+,9931,572881,3801343,5494,279946,2162936
2013-11-27,2014,58,D,3,3+,9691,582572,3801343,5200,285146,2162936
2013-11-28,2014,59,D,3,3+,9307,591879,3801343,4748,289894,2162936
2013-11-29,2014,60,D,3,3+,9475,601354,3801343,4913,294807,2162936
2013-11-30,2014,61,D,3,3+,9331,610685,3801343,4711,299518,2162936
2013-12-01,2014,62,D,3,3+,9282,619967,3801343,4616,304134,2162936
2013-12-02,2014,63,D,3,3+,9106,629073,3801343,4440,308574,2162936
2013-12-03,2014,64,D,3,3+,9268,638341,3801343,4615,313189,2162936
2013-12-04,2014,65,D,3,3+,9594,647935,3801343,5196,318385,2162936
2013-12-05,2014,66,D,3,3+,9322,657257,3801343,4909,323294,2162936
2013-12-06,2014,67,D,3,3+,9165,666422,3801343,6544,329838,2162936
2013-12-07,2014,68,D,3,3+,9689,676111,3801343,7474,337312,2162936
2013-12-08,2014,69,D,3,3+,10184,686295,3801343,7970,345282,2162936
2013-12-09,2014,70,D,3,3+,10163,696458,3801343,7650,352932,2162936
2013-12-10,2014,71,D,3,3+,9919,706377,3801343,7369,360301,2162936
2013-12-11,2014,72,D,3,3+,9674,716051,3801343,5289,365590,2162936
2013-12-12,2014,73,D,3,3+,9449,725500,3801343,4590,370180,2162936
2013-12-13,2014,74,D,3,3+,9458,734958,3801343,4311,374491,2162936
2013-12-14,2014,75,D,3,3+,9456,744414,3801343,4308,378799,2162936
2013-12-15,2014,76,D,3,3+,9443,753857,3801343,4290,383089,2162936
2013-12-16,2014,77,D,3,3+,9371,763228,3801343,4035,387124,2162936
2013-12-17,2014,78,D,3,3+,9284,772512,3801343,3948,391072,2162936
2013-12-18,2014,79,D,3,3+,9191,781703,3801343,3904,394976,2162936
2013-12-19,2014,80,D,3,3+,10134,791837,3801343,4854,399830,2162936
2013-12-20,2014,81,D,3,3+,9292,801129,3801343,4009,403839,2162936
2013-12-21,2014,82,D,3,3+,9629,810758,3801343,4385,408224,2162936
2013-12-22,2014,83,D,3,3+,9825,820583,3801343,4601,412825,2162936
2013-12-23,2014,84,D,3,3+,9683,830266,3801343,4513,417338,2162936
2013-12-24,2014,85,D,3,3+,9615,839881,3801343,4448,421786,2162936
2013-12-25,2014,86,D,3,3+,9725,849606,3801343,4607,426393,2162936
2013-12-26,2014,87,D,3,3+,9479,859085,3801343,4356,430749,2162936
2013-12-27,2014,88,D,3,3+,9288,868373,3801343,4215,434964,2162936
2013-12-28,2014,89,D,3,3+,9051,877424,3801343,4476,439440,2162936
2013-12-29,2014,90,D,3,3+,9066,886490,3801343,4534,443974,2162936
2013-12-30,2014,91,D,3,3+,8785,895275,3801343,4303,448277,2162936
2013-12-31,2014,92,D,3,3+,8765,904040,3801343,4728,453005,2162936
2014-01-01,2014,93,D,3,3+,8936,912976,3801343,5105,458110,2162936
2014-01-02,2014,94,D,3,3+,9040,922016,3801343,5256,463366,2162936
2014-01-03,2014,95,D,3,3+,8813,930829,3801343,5080,468446,2162936
2014-01-04,2014,96,D,3,3+,8898,939727,3801343,5229,473675,2162936
2014-01-05,2014,97,D,3,3+,9080,948807,3801343,5547,479222,2162936
2014-01-06,2014,98,D,3,3+,9014,957821,3801343,5469,484691,2162936
2014-01-07,2014,99,D,3,3+,8685,966506,3801343,5178,489869,2162936
2014-01-08,2014,100,D,3,3+,8492,974998,3801343,4987,494856,2162936
2014-01-09,2014,101,D,3,3+,7907,982905,3801343,4935,499791,2162936
2014-01-10,2014,102,D,3,3+,7568,990473,3801343,4638,504429,2162936
2014-01-11,2014,103,D,3,3+,6911,997384,3801343,3976,508405,2162936
2014-01-12,2014,104,D,3,3+,7613,1004997,3801343,4719,513124,2162936
2014-01-13,2014,105,D,3,3+,7162,1012159,3801343,4398,517522,2162936
2014-01-14,2014,106,D,3,3+,7070,1019229,3801343,4221,521743,2162936
2014-01-15,2014,107,D,3,3+,7216,1026445,3801343,4270,526013,2162936
2014-01-16,2014,108,D,3,3+,6995,1033440,3801343,4227,530240,2162936
2014-01-17,2014,109,D,3,3+,6942,1040382,3801343,4191,534431,2162936
2014-01-18,2014,110,D,3,3+,6720,1047102,3801343,4029,538460,2162936
2014-01-19,2014,111,D,3,3+,6863,1053965,3801343,4173,542633,2162936
2014-01-20,2014,112,D,3,3+,7050,1061015,3801343,4353,546986,2162936
2014-01-21,2014,113,D,3,3+,6966,1067981,3801343,4337,551323,2162936
2014-01-22,2014,114,D,3,3+,6634,1074615,3801343,4011,555334,2162936
2014-01-23,2014,115,D,3,3+,6963,1081578,3801343,4400,559734,2162936
2014-01-24,2014,116,D,3,3+,7097,1088675,3801343,4533,564267,2162936
2014-01-25,2014,117,D,3,3+,7003,1095678,3801343,4409,568676,2162936
2014-01-26,2014,118,D,3,3+,6714,1102392,3801343,4426,573102,2162936
2014-01-27,2014,119,D,3,3+,6663,1109055,3801343,4725,577827,2162936
2014-01-28,2014,120,D,3,3+,6779,1115834,3801343,5175,583002,2162936
2014-01-29,2014,121,D,3,3+,6797,1122631,3801343,5211,588213,2162936
2014-01-30,2014,122,D,3,3+,7067,1129698,3801343,5935,594148,2162936
2014-01-31,2014,123,D,3,3+,8097,1137795,3801343,7050,601198,2162936
2014-02-01,2014,124,D,3,3+,8341,1146136,3801343,7231,608429,2162936
2014-02-02,2014,125,D,3,3+,7996,1154132,3801343,7978,616407,2162936
2014-02-03,2014,126,D,3,3+,7824,1161956,3801343,7893,624300,2162936
2014-02-04,2014,127,D,3,3+,8142,1170098,3801343,7658,631958,2162936
2014-02-05,2014,128,D,3,3+,8258,1178356,3801343,7793,639751,2162936
2014-02-06,2014,129,D,3,3+,8908,1187264,3801343,9828,649579,2162936
2014-02-07,2014,130,D,3,3+,8891,1196155,3801343,10495,660074,2162936
2014-02-08,2014,131,D,3,3+,9809,1205964,3801343,14144,674218,2162936
2014-02-09,2014,132,D,3,3+,15897,1221861,3801343,22887,697105,2162936
2014-02-10,2014,133,D,3,3+,22450,1244311,3801343,29536,726641,2162936
2014-02-11,2014,134,D,3,3+,25099,1269410,3801343,27892,754533,2162936
2014-02-12,2014,135,D,3,3+,25841,1295251,3801343,25281,779814,2162936
2014-02-13,2014,136,D,3,3+,21542,1316793,3801343,18241,798055,2162936
2014-02-14,2014,137,D,3,3+,17050,1333843,3801343,10578,808633,2162936
2014-02-15,2014,138,D,3,3+,14359,1348202,3801343,7859,816492,2162936
2014-02-16,2014,139,D,3,3+,13716,1361918,3801343,7203,823695,2162936
2014-02-17,2014,140,D,3,3+,12898,1374816,3801343,6384,830079,2162936
2014-02-18,2014,141,D,3,3+,12037,1386853,3801343,6022,836101,2162936
2014-02-19,2014,142,D,3,3+,11418,1398271,3801343,6439,842540,2162936
2014-02-20,2014,143,D,3,3+,10809,1409080,3801343,6434,848974,2162936
2014-02-21,2014,144,D,3,3+,10211,1419291,3801343,6551,855525,2162936
2014-02-22,2014,145,D,3,3+,9496,1428787,3801343,5812,861337,2162936
2014-02-23,2014,146,D,3,3+,8736,1437523,3801343,6406,867743,2162936
2014-02-24,2014,147,D,3,3+,8340,1445863,3801343,5924,873667,2162936
2014-02-25,2014,148,D,3,3+,7832,1453695,3801343,5353,879020,2162936
2014-02-26,2014,149,D,3,3+,7869,1461564,3801343,7484,886504,2162936
2014-02-27,2014,150,D,3,3+,8148,1469712,3801343,7757,894261,2162936
2014-02-28,2014,151,D,3,3+,10416,1480128,3801343,16646,910907,2162936
2014-03-01,2014,152,D,3,3+,16972,1497100,3801343,23168,934075,2162936
2014-03-02,2014,153,D,3,3+,22313,1519413,3801343,25999,960074,2162936
2014-03-03,2014,154,D,3,3+,22901,1542314,3801343,25125,985199,2162936
2014-03-04,2014,155,D,3,3+,21201,1563515,3801343,23273,1008472,2162936
2014-03-05,2014,156,D,3,3+,21513,1585028,3801343,16776,1025248,2162936
2014-03-06,2014,157,D,3,3+,28478,1613506,3801343,23833,1049081,2162936
2014-03-07,2014,158,D,3,3+,30030,1643536,3801343,24393,1073474,2162936
2014-03-08,2014,159,D,3,3+,27609,1671145,3801343,20970,1094444,2162936
2014-03-09,2014,160,D,3,3+,24587,1695732,3801343,17964,1112408,2162936
2014-03-10,2014,161,D,3,3+,21562,1717294,3801343,13759,1126167,2162936
2014-03-11,2014,162,D,3,3+,19294,1736588,3801343,11269,1137436,2162936
2014-03-12,2014,163,D,3,3+,23015,1759603,3801343,15408,1152844,2162936
2014-03-13,2014,164,D,3,3+,24092,1783695,3801343,15733,1168577,2162936
2014-03-14,2014,165,D,3,3+,20977,1804672,3801343,13392,1181969,2162936
2014-03-15,2014,166,D,3,3+,17037,1821709,3801343,9272,1191241,2162936
2014-03-16,2014,167,D,3,3+,14312,1836021,3801343,6242,1197483,2162936
2014-03-17,2014,168,D,3,3+,12885,1848906,3801343,6125,1203608,2162936
2014-03-18,2014,169,D,3,3+,11598,1860504,3801343,4536,1208144,2162936
2014-03-19,2014,170,D,3,3+,10493,1870997,3801343,4173,1212317,2162936
2014-03-20,2014,171,D,3,3+,9447,1880444,3801343,3761,1216078,2162936
2014-03-21,2014,172,D,3,3+,9086,1889530,3801343,4876,1220954,2162936
2014-03-22,2014,173,D,3,3+,9260,1898790,3801343,5416,1226370,2162936
2014-03-23,2014,174,D,3,3+,9290,1908080,3801343,5919,1232289,2162936
2014-03-24,2014,175,D,3,3+,9081,1917161,3801343,5889,1238178,2162936
2014-03-25,2014,176,D,3,3+,8266,1925427,3801343,4623,1242801,2162936
2014-03-26,2014,177,D,3,3+,7898,1933325,3801343,6302,1249103,2162936
2014-03-27,2014,178,D,3,3+,8821,1942146,3801343,7866,1256969,2162936
2014-03-28,2014,179,D,3,3+,8820,1950966,3801343,7874,1264843,2162936
2014-03-29,2014,180,D,3,3+,9217,1960183,3801343,11909,1276752,2162936
2014-03-30,2014,181,D,3,3+,10801,1970984,3801343,13504,1290256,2162936
2014-03-31,2014,182,D,3,3+,13263,1984247,3801343,15068,1305324,2162936
2014-04-01,2014,183,D,3,3+,19219,2003466,3801343,21490,1326814,2162936
2014-04-02,2014,184,D,3,3+,20490,2023956,3801343,21009,1347823,2162936
2014-04-03,2014,185,D,3,3+,19734,2043690,3801343,16523,1364346,2162936
2014-04-04,2014,186,D,3,3+,18823,2062513,3801343,15524,1379870,2162936
2014-04-05,2014,187,D,3,3+,17082,2079595,3801343,12593,1392463,2162936
2014-04-06,2014,188,D,3,3+,15240,2094835,3801343,8039,1400502,2162936
2014-04-07,2014,189,D,3,3+,13603,2108438,3801343,6152,1406654,2162936
2014-04-08,2014,190,D,3,3+,12043,2120481,3801343,5016,1411670,2162936
2014-04-09,2014,191,D,3,3+,11306,2131787,3801343,4624,1416294,2162936
2014-04-10,2014,192,D,3,3+,10893,2142680,3801343,4093,1420387,2162936
2014-04-11,2014,193,D,3,3+,10352,2153032,3801343,3518,1423905,2162936
2014-04-12,2014,194,D,3,3+,10362,2163394,3801343,3505,1427410,2162936
2014-04-13,2014,195,D,3,3+,10884,2174278,3801343,4619,1432029,2162936
2014-04-14,2014,196,D,3,3+,10147,2184425,3801343,4278,1436307,2162936
2014-04-15,2014,197,D,3,3+,9706,2194131,3801343,5580,1441887,2162936
2014-04-16,2014,198,D,3,3+,9687,2203818,3801343,4622,1446509,2162936
2014-04-17,2014,199,D,3,3+,9609,2213427,3801343,5993,1452502,2162936
2014-04-18,2014,200,D,3,3+,10408,2223835,3801343,5651,1458153,2162936
2014-04-19,2014,201,D,3,3+,10597,2234432,3801343,5971,1464124,2162936
2014-04-20,2014,202,D,3,3+,11192,2245624,3801343,6489,1470613,2162936
2014-04-21,2014,203,D,3,3+,10529,2256153,3801343,5619,1476232,2162936
2014-04-22,2014,204,D,3,3+,10984,2267137,3801343,5946,1482178,2162936
2014-04-23,2014,205,D,3,3+,11567,2278704,3801343,6402,1488580,2162936
2014-04-24,2014,206,D,3,3+,10306,2289010,3801343,5381,1493961,2162936
2014-04-25,2014,207,D,3,3+,10161,2299171,3801343,8862,1502823,2162936
2014-04-26,2014,208,D,3,3+,10352,2309523,3801343,8943,1511766,2162936
2014-04-27,2014,209,D,3,3+,10349,2319872,3801343,9083,1520849,2162936
2014-04-28,2014,210,D,3,3+,10409,2330281,3801343,9061,1529910,2162936
2014-04-29,2014,211,D,3,3+,9817,2340098,3801343,8452,1538362,2162936
2014-04-30,2014,212,D,3,3+,9404,2349502,3801343,4344,1542706,2162936
2014-05-01,2014,213,D,3,3+,9161,2358663,3801343,4374,1547080,2162936
2014-05-02,2014,214,D,3,3+,8593,2367256,3801343,3507,1550587,2162936
2014-05-03,2014,215,D,3,3+,7837,2375093,3801343,3094,1553681,2162936
2014-05-04,2014,216,D,3,3+,8379,2383472,3801343,3642,1557323,2162936
2014-05-05,2014,217,D,3,3+,8240,2391712,3801343,4961,1562284,2162936
2014-05-06,2014,218,D,3,3+,8593,2400305,3801343,4982,1567266,2162936
2014-05-07,2014,219,D,3,3+,8101,2408406,3801343,4432,1571698,2162936
2014-05-08,2014,220,D,3,3+,7515,2415921,3801343,3857,1575555,2162936
2014-05-09,2014,221,D,3,3+,7940,2423861,3801343,4265,1579820,2162936
2014-05-10,2014,222,D,3,3+,8600,2432461,3801343,4839,1584659,2162936
2014-05-11,2014,223,D,3,3+,8630,2441091,3801343,4945,1589604,2162936
2014-05-12,2014,224,D,3,3+,8410,2449501,3801343,4737,1594341,2162936
2014-05-13,2014,225,D,3,3+,8165,2457666,3801343,4328,1598669,2162936
2014-05-14,2014,226,D,3,3+,7887,2465553,3801343,4015,1602684,2162936
2014-05-15,2014,227,D,3,3+,7398,2472951,3801343,3513,1606197,2162936
2014-05-16,2014,228,D,3,3+,7515,2480466,3801343,3574,1609771,2162936
2014-05-17,2014,229,D,3,3+,7868,2488334,3801343,3953,1613724,2162936
2014-05-18,2014,230,D,3,3+,7469,2495803,3801343,3577,1617301,2162936
2014-05-19,2014,231,D,3,3+,7681,2503484,3801343,4005,1621306,2162936
2014-05-20,2014,232,D,3,3+,8714,2512198,3801343,4961,1626267,2162936
2014-05-21,2014,233,D,3,3+,8192,2520390,3801343,4323,1630590,2162936
2014-05-22,2014,234,D,3,3+,7935,2528325,3801343,4060,1634650,2162936
2014-05-23,2014,235,D,3,3+,7971,2536296,3801343,3952,1638602,2162936
2014-05-24,2014,236,D,3,3+,7969,2544265,3801343,3872,1642474,2162936
2014-05-25,2014,237,D,3,3+,8165,2552430,3801343,4074,1646548,2162936
2014-05-26,2014,238,D,3,3+,7969,2560399,3801343,3846,1650394,2162936
2014-05-27,2014,239,D,3,3+,8117,2568516,3801343,4071,1654465,2162936
2014-05-28,2014,240,D,3,3+,8666,2577182,3801343,4479,1658944,2162936
2014-05-29,2014,241,D,3,3+,8584,2585766,3801343,4364,1663308,2162936
2014-05-30,2014,242,D,3,3+,8809,2594575,3801343,4295,1667603,2162936
2014-05-31,2014,243,D,3,3+,9051,2603626,3801343,4509,1672112,2162936
2014-06-01,2014,244,D,3,3+,8737,2612363,3801343,4153,1676265,2162936
2014-06-02,2014,245,D,3,3+,8673,2621036,3801343,4214,1680479,2162936
2014-06-03,2014,246,D,3,3+,9746,2630782,3801343,5243,1685722,2162936
2014-06-04,2014,247,D,3,3+,9599,2640381,3801343,5067,1690789,2162936
2014-06-05,2014,248,D,3,3+,9596,2649977,3801343,4982,1695771,2162936
2014-06-06,2014,249,D,3,3+,9861,2659838,3801343,5223,1700994,2162936
2014-06-07,2014,250,D,3,3+,9670,2669508,3801343,5291,1706285,2162936
2014-06-08,2014,251,D,3,3+,9677,2679185,3801343,5381,1711666,2162936
2014-06-09,2014,252,D,3,3+,9144,2688329,3801343,4738,1716404,2162936
2014-06-10,2014,253,D,3,3+,8607,2696936,3801343,4167,1720571,2162936
2014-06-11,2014,254,D,3,3+,8745,2705681,3801343,4282,1724853,2162936
2014-06-12,2014,255,D,3,3+,9121,2714802,3801343,4579,1729432,2162936
2014-06-13,2014,256,D,3,3+,9711,2724513,3801343,5121,1734553,2162936
2014-06-14,2014,257,D,3,3+,9239,2733752,3801343,4615,1739168,2162936
2014-06-15,2014,258,D,3,3+,9714,2743466,3801343,5040,1744208,2162936
2014-06-16,2014,259,D,3,3+,10341,2753807,3801343,5600,1749808,2162936
2014-06-17,2014,260,D,3,3+,11341,2765148,3801343,6540,1756348,2162936
2014-06-18,2014,261,D,3,3+,11196,2776344,3801343,6330,1762678,2162936
2014-06-19,2014,262,D,3,3+,11034,2787378,3801343,6162,1768840,2162936
2014-06-20,2014,263,D,3,3+,10817,2798195,3801343,5875,1774715,2162936
2014-06-21,2014,264,D,3,3+,10795,2808990,3801343,5804,1780519,2162936
2014-06-22,2014,265,D,3,3+,10595,2819585,3801343,5568,1786087,2162936
2014-06-23,2014,266,D,3,3+,10766,2830351,3801343,5706,1791793,2162936
2014-06-24,2014,267,D,3,3+,10852,2841203,3801343,5792,1797585,2162936
2014-06-25,2014,268,D,3,3+,11313,2852516,3801343,6160,1803745,2162936
2014-06-26,2014,269,D,3,3+,11722,2864238,3801343,6573,1810318,2162936
2014-06-27,2014,270,D,3,3+,11675,2875913,3801343,6482,1816800,2162936
2014-06-28,2014,271,D,3,3+,11792,2887705,3801343,6501,1823301,2162936
2014-06-29,2014,272,D,3,3+,11686,2899391,3801343,5806,1829107,2162936
2014-06-30,2014,273,D,3,3+,11089,2910480,3801343,5186,1834293,2162936
2014-07-01,2014,274,D,3,3+,10682,2921162,3801343,4302,1838595,2162936
2014-07-02,2014,275,D,3,3+,11084,2932246,3801343,4660,1843255,2162936
2014-07-03,2014,276,D,3,3+,10744,2942990,3801343,4255,1847510,2162936
2014-07-04,2014,277,D,3,3+,10384,2953374,3801343,3898,1851408,2162936
2014-07-05,2014,278,D,3,3+,10160,2963534,3801343,3636,1855044,2162936
2014-07-06,2014,279,D,3,3+,9954,2973488,3801343,3417,1858461,2162936
2014-07-07,2014,280,D,3,3+,10117,2983605,3801343,3554,1862015,2162936
2014-07-08,2014,281,D,3,3+,10187,2993792,3801343,3633,1865648,2162936
2014-07-09,2014,282,D,3,3+,10325,3004117,3801343,3769,1869417,2162936
2014-07-10,2014,283,D,3,3+,10225,3014342,3801343,4229,1873646,2162936
2014-07-11,2014,284,D,3,3+,10518,3024860,3801343,4195,1877841,2162936
2014-07-12,2014,285,D,3,3+,10409,3035269,3801343,3844,1881685,2162936
2014-07-13,2014,286,D,3,3+,10286,3045555,3801343,4289,1885974,2162936
2014-07-14,2014,287,D,3,3+,10438,3055993,3801343,3981,1889955,2162936
2014-07-15,2014,288,D,3,3+,10618,3066611,3801343,3935,1893890,2162936
2014-07-16,2014,289,D,3,3+,10271,3076882,3801343,4514,1898404,2162936
2014-07-17,2014,290,D,3,3+,10383,3087265,3801343,4054,1902458,2162936
2014-07-18,2014,291,D,3,3+,10428,3097693,3801343,3858,1906316,2162936
2014-07-19,2014,292,D,3,3+,10151,3107844,3801343,4464,1910780,2162936
2014-07-20,2014,293,D,3,3+,10236,3118080,3801343,4127,1914907,2162936
2014-07-21,2014,294,D,3,3+,10421,3128501,3801343,4048,1918955,2162936
2014-07-22,2014,295,D,3,3+,10427,3138928,3801343,4647,1923602,2162936
2014-07-23,2014,296,D,3,3+,10801,3149729,3801343,4700,1928302,2162936
2014-07-24,2014,297,D,3,3+,11209,3160938,3801343,4786,1933088,2162936
2014-07-25,2014,298,D,3,3+,10925,3171863,3801343,5075,1938163,2162936
2014-07-26,2014,299,D,3,3+,10367,3182230,3801343,4188,1942351,2162936
2014-07-27,2014,300,D,3,3+,10135,3192365,3801343,3668,1946019,2162936
2014-07-28,2014,301,D,3,3+,10131,3202496,3801343,4394,1950413,2162936
2014-07-29,2014,302,D,3,3+,10150,3212646,3801343,4010,1954423,2162936
2014-07-30,2014,303,D,3,3+,9672,3222318,3801343,3286,1957709,2162936
2014-07-31,2014,304,D,3,3+,9499,3231817,3801343,3218,1960927,2162936
2014-08-01,2014,305,D,3,3+,9165,3240982,3801343,2962,1963889,2162936
2014-08-02,2014,306,D,3,3+,9074,3250056,3801343,2618,1966507,2162936
2014-08-03,2014,307,D,3,3+,8946,3259002,3801343,3320,1969827,2162936
2014-08-04,2014,308,D,3,3+,9354,3268356,3801343,3268,1973095,2162936
2014-08-05,2014,309,D,3,3+,9994,3278350,3801343,3749,1976844,2162936
2014-08-06,2014,310,D,3,3+,9877,3288227,3801343,4196,1981040,2162936
2014-08-07,2014,311,D,3,3+,10281,3298508,3801343,4330,1985370,2162936
2014-08-08,2014,312,D,3,3+,10997,3309505,3801343,4775,1990145,2162936
2014-08-09,2014,313,D,3,3+,11004,3320509,3801343,4900,1995045,2162936
2014-08-10,2014,314,D,3,3+,11028,3331537,3801343,3780,1998825,2162936
2014-08-11,2014,315,D,3,3+,10518,3342055,3801343,3090,2001915,2162936
2014-08-12,2014,316,D,3,3+,9850,3351905,3801343,3033,2004948,2162936
2014-08-13,2014,317,D,3,3+,9549,3361454,3801343,2366,2007314,2162936
2014-08-14,2014,318,D,3,3+,9802,3371256,3801343,2401,2009715,2162936
2014-08-15,2014,319,D,3,3+,9429,3380685,3801343,3501,2013216,2162936
2014-08-16,2014,320,D,3,3+,9101,3389786,3801343,2671,2015887,2162936
2014-08-17,2014,321,D,3,3+,9030,3398816,3801343,2343,2018230,2162936
2014-08-18,2014,322,D,3,3+,8857,3407673,3801343,3226,2021456,2162936
2014-08-19,2014,323,D,3,3+,8760,3416433,3801343,3354,2024810,2162936
2014-08-20,2014,324,D,3,3+,8848,3425281,3801343,3160,2027970,2162936
2014-08-21,2014,325,D,3,3+,9039,3434320,3801343,3999,2031969,2162936
2014-08-22,2014,326,D,3,3+,8557,3442877,3801343,3167,2035136,2162936
2014-08-23,2014,327,D,3,3+,9296,3452173,3801343,3603,2038739,2162936
2014-08-24,2014,328,D,3,3+,8836,3461009,3801343,4020,2042759,2162936
2014-08-25,2014,329,D,3,3+,9042,3470051,3801343,3808,2046567,2162936
2014-08-26,2014,330,D,3,3+,9278,3479329,3801343,3365,2049932,2162936
2014-08-27,2014,331,D,3,3+,9369,3488698,3801343,3534,2053466,2162936
2014-08-28,2014,332,D,3,3+,9289,3497987,3801343,3118,2056584,2162936
2014-08-29,2014,333,D,3,3+,9565,3507552,3801343,3170,2059754,2162936
2014-08-30,2014,334,D,3,3+,9961,3517513,3801343,3963,2063717,2162936
2014-08-31,2014,335,D,3,3+,10129,3527642,3801343,3187,2066904,2162936
2014-09-01,2014,336,D,3,3+,9780,3537422,3801343,3129,2070033,2162936
2014-09-02,2014,337,D,3,3+,9326,3546748,3801343,3205,2073238,2162936
2014-09-03,2014,338,D,3,3+,9722,3556470,3801343,3333,2076571,2162936
2014-09-04,2014,339,D,3,3+,10009,3566479,3801343,3921,2080492,2162936
2014-09-05,2014,340,D,3,3+,10183,3576662,3801343,4732,2085224,2162936
2014-09-06,2014,341,D,3,3+,10007,3586669,3801343,3234,2088458,2162936
2014-09-07,2014,342,D,3,3+,9629,3596298,3801343,2634,2091092,2162936
2014-09-08,2014,343,D,3,3+,9359,3605657,3801343,4691,2095783,2162936
2014-09-09,2014,344,D,3,3+,9775,3615432,3801343,4571,2100354,2162936
2014-09-10,2014,345,D,3,3+,9599,3625031,3801343,2628,2102982,2162936
2014-09-11,2014,346,D,3,3+,9747,3634778,3801343,4067,2107049,2162936
2014-09-12,2014,347,D,3,3+,9678,3644456,3801343,2971,2110020,2162936
2014-09-13,2014,348,D,3,3+,9578,3654034,3801343,3058,2113078,2162936
2014-09-14,2014,349,D,3,3+,9539,3663573,3801343,1741,2114819,2162936
2014-09-15,2014,350,D,3,3+,9230,3672803,3801343,1981,2116800,2162936
2014-09-16,2014,351,D,3,3+,9402,3682205,3801343,2750,2119550,2162936
2014-09-17,2014,352,D,3,3+,9021,3691226,3801343,2941,2122491,2162936
2014-09-18,2014,353,D,3,3+,9231,3700457,3801343,3439,2125930,2162936
2014-09-19,2014,354,D,3,3+,8713,3709170,3801343,2972,2128902,2162936
2014-09-20,2014,355,D,3,3+,8524,3717694,3801343,2781,2131683,2162936
2014-09-21,2014,356,D,3,3+,8470,3726164,3801343,2809,2134492,2162936
2014-09-22,2014,357,D,3,3+,8752,3734916,3801343,3144,2137636,2162936
2014-09-23,2014,358,D,3,3+,8444,3743360,3801343,2836,2140472,2162936
2014-09-24,2014,359,D,3,3+,8277,3751637,3801343,2658,2143130,2162936
2014-09-25,2014,360,D,3,3+,8490,3760127,3801343,4543,2147673,2162936
2014-09-26,2014,361,D,3,3+,8320,3768447,3801343,3386,2151059,2162936
2014-09-27,2014,362,D,3,3+,8501,3776948,3801343,3645,2154704,2162936
2014-09-28,2014,363,D,3,3+,8438,3785386,3801343,3554,2158258,2162936
2014-09-29,2014,364,D,3,3+,7893,3793279,3801343,3058,2161316,2162936
2014-09-30,2014,365,D,3,3+,8064,3801343,3801343,1620,2162936,2162936
2014-10-01,2015,1,D,4,3+,8389,8389,4709866,3662,3662,3139152
2014-10-02,2015,2,D,4,3+,8202,16591,4709866,3496,7158,3139152
2014-10-03,2015,3,D,4,3+,8849,25440,4709866,4190,11348,3139152
2014-10-04,2015,4,D,4,3+,8255,33695,4709866,4207,15555,3139152
2014-10-05,2015,5,D,4,3+,8169,41864,4709866,4407,19962,3139152
2014-10-06,2015,6,D,4,3+,8122,49986,4709866,4322,24284,3139152
2014-10-07,2015,7,D,4,3+,7993,57979,4709866,4259,28543,3139152
2014-10-08,2015,8,D,4,3+,7977,65956,4709866,4724,33267,3139152
2014-10-09,2015,9,D,4,3+,7788,73744,4709866,5133,38400,3139152
2014-10-10,2015,10,D,4,3+,7412,81156,4709866,4491,42891,3139152
2014-10-11,2015,11,D,4,3+,7102,88258,4709866,3953,46844,3139152
2014-10-12,2015,12,D,4,3+,7414,95672,4709866,4856,51700,3139152
2014-10-13,2015,13,D,4,3+,6571,102243,4709866,3681,55381,3139152
2014-10-14,2015,14,D,4,3+,6364,108607,4709866,3302,58683,3139152
2014-10-15,2015,15,D,4,3+,7620,116227,4709866,5169,63852,3139152
2014-10-16,2015,16,D,4,3+,6831,123058,4709866,3961,67813,3139152
2014-10-17,2015,17,D,4,3+,6882,129940,4709866,3744,71557,3139152
2014-10-18,2015,18,D,4,3+,6703,136643,4709866,4538,76095,3139152
2014-10-19,2015,19,D,4,3+,6489,143132,4709866,3660,79755,3139152
2014-10-20,2015,20,D,4,3+,6319,149451,4709866,3259,83014,3139152
2014-10-21,2015,21,D,4,3+,7846,157297,4709866,5543,88557,3139152
2014-10-22,2015,22,D,4,3+,6946,164243,4709866,4163,92720,3139152
2014-10-23,2015,23,D,4,3+,6819,171062,4709866,3840,96560,3139152
2014-10-24,2015,24,D,4,3+,7464,178526,4709866,5039,101599,3139152
2014-10-25,2015,25,D,4,3+,7438,185964,4709866,4633,106232,3139152
2014-10-26,2015,26,D,4,3+,8847,194811,4709866,5796,112028,3139152
2014-10-27,2015,27,D,4,3+,9464,204275,4709866,7231,119259,3139152
2014-10-28,2015,28,D,4,3+,9180,213455,4709866,6421,125680,3139152
2014-10-29,2015,29,D,4,3+,9612,223067,4709866,6710,132390,3139152
2014-10-30,2015,30,D,4,3+,8656,231723,4709866,5763,138153,3139152
2014-10-31,2015,31,D,4,3+,9701,241424,4709866,8186,146339,3139152
2014-11-01,2015,32,D,4,3+,9666,251090,4709866,7872,154211,3139152
2014-11-02,2015,33,D,4,3+,10346,261436,4709866,8536,162747,3139152
2014-11-03,2015,34,D,4,3+,10443,271879,4709866,8165,170912,3139152
2014-11-04,2015,35,D,4,3+,10726,282605,4709866,8453,179365,3139152
2014-11-05,2015,36,D,4,3+,10499,293104,4709866,6847,186212,3139152
2014-11-06,2015,37,D,4,3+,10129,303233,4709866,6261,192473,3139152
2014-11-07,2015,38,D,4,3+,9555,312788,4709866,5683,198156,3139152
2014-11-08,2015,39,D,4,3+,9569,322357,4709866,6239,204395,3139152
2014-11-09,2015,40,D,4,3+,8787,331144,4709866,4968,209363,3139152
2014-11-10,2015,41,D,4,3+,8824,339968,4709866,4990,214353,3139152
2014-11-11,2015,42,D,4,3+,9113,349081,4709866,5302,219655,3139152
2014-11-12,2015,43,D,4,3+,9016,358097,4709866,5218,224873,3139152
2014-11-13,2015,44,D,4,3+,9125,367222,4709866,6427,231300,3139152
2014-11-14,2015,45,D,4,3+,8717,375939,4709866,5508,236808,3139152
2014-11-15,2015,46,D,4,3+,9005,384944,4709866,6091,242899,3139152
2014-11-16,2015,47,D,4,3+,8897,393841,4709866,5618,248517,3139152
2014-11-17,2015,48,D,4,3+,8705,402546,4709866,5452,253969,3139152
2014-11-18,2015,49,D,4,3+,8506,411052,4709866,3324,257293,3139152
2014-11-19,2015,50,D,4,3+,8352,419404,4709866,3946,261239,3139152
2014-11-20,2015,51,D,4,3+,8465,427869,4709866,4540,265779,3139152
2014-11-21,2015,52,D,4,3+,8611,436480,4709866,4419,270198,3139152
2014-11-22,2015,53,D,4,3+,8233,444713,4709866,4740,274938,3139152
2014-11-23,2015,54,D,4,3+,9040,453753,4709866,5781,280719,3139152
2014-11-24,2015,55,D,4,3+,8999,462752,4709866,4584,285303,3139152
2014-11-25,2015,56,D,4,3+,10217,472969,4709866,5221,290524,3139152
2014-11-26,2015,57,D,4,3+,9533,482502,4709866,3971,294495,3139152
2014-11-27,2015,58,D,4,3+,8873,491375,4709866,2557,297052,3139152
2014-11-28,2015,59,D,4,3+,8913,500288,4709866,2611,299663,3139152
2014-11-29,2015,60,D,4,3+,9483,509771,4709866,3685,303348,3139152
2014-11-30,2015,61,D,4,3+,9547,519318,4709866,6002,309350,3139152
2014-12-01,2015,62,D,4,3+,9768,529086,4709866,6159,315509,3139152
2014-12-02,2015,63,D,4,3+,10376,539462,4709866,12446,327955,3139152
2014-12-03,2015,64,D,4,3+,13307,552769,4709866,17889,345844,3139152
2014-12-04,2015,65,D,4,3+,18086,570855,4709866,22137,367981,3139152
2014-12-05,2015,66,D,4,3+,24362,595217,4709866,26305,394286,3139152
2014-12-06,2015,67,D,4,3+,29954,625171,4709866,32443,426729,3139152
2014-12-07,2015,68,D,4,3+,27603,652774,4709866,23919,450648,3139152
2014-12-08,2015,69,D,4,3+,26603,679377,4709866,19458,470106,3139152
2014-12-09,2015,70,D,4,3+,24744,704121,4709866,15317,485423,3139152
2014-12-10,2015,71,D,4,3+,21240,725361,4709866,10722,496145,3139152
2014-12-11,2015,72,D,4,3+,19158,744519,4709866,18050,514195,3139152
2014-12-12,2015,73,D,4,3+,31653,776172,4709866,32032,546227,3139152
2014-12-13,2015,74,D,4,3+,48310,824482,4709866,47803,594030,3139152
2014-12-14,2015,75,D,4,3+,51835,876317,4709866,51664,645694,3139152
2014-12-15,2015,76,D,4,3+,57933,934250,4709866,58997,704691,3139152
2014-12-16,2015,77,D,4,3+,59890,994140,4709866,55882,760573,3139152
2014-12-17,2015,78,D,4,3+,57846,1051986,4709866,52660,813233,3139152
2014-12-18,2015,79,D,4,3+,55814,1107800,4709866,51793,865026,3139152
2014-12-19,2015,80,D,4,3+,56825,1164625,4709866,53648,918674,3139152
2014-12-20,2015,81,D,4,3+,57359,1221984,4709866,53735,972409,3139152
2014-12-21,2015,82,D,4,3+,56874,1278858,4709866,50770,1023179,3139152
2014-12-22,2015,83,D,4,3+,56857,1335715,4709866,50148,1073327,3139152
2014-12-23,2015,84,D,4,3+,56126,1391841,4709866,48600,1121927,3139152
2014-12-24,2015,85,D,4,3+,53003,1444844,4709866,44684,1166611,3139152
2014-12-25,2015,86,D,4,3+,46901,1491745,4709866,38463,1205074,3139152
2014-12-26,2015,87,D,4,3+,40673,1532418,4709866,32420,1237494,3139152
2014-12-27,2015,88,D,4,3+,37221,1569639,4709866,29119,1266613,3139152
2014-12-28,2015,89,D,4,3+,33400,1603039,4709866,25705,1292318,3139152
2014-12-29,2015,90,D,4,3+,30122,1633161,4709866,21981,1314299,3139152
2014-12-30,2015,91,D,4,3+,27117,1660278,4709866,18616,1332915,3139152
2014-12-31,2015,92,D,4,3+,23605,1683883,4709866,15150,1348065,3139152
2015-01-01,2015,93,D,4,3+,20348,1704231,4709866,12876,1360941,3139152
2015-01-02,2015,94,D,4,3+,17907,1722138,4709866,10485,1371426,3139152
2015-01-03,2015,95,D,4,3+,16593,1738731,4709866,9209,1380635,3139152
2015-01-04,2015,96,D,4,3+,15066,1753797,4709866,7762,1388397,3139152
2015-01-05,2015,97,D,4,3+,15055,1768852,4709866,7794,1396191,3139152
2015-01-06,2015,98,D,4,3+,14101,1782953,4709866,7465,1403656,3139152
2015-01-07,2015,99,D,4,3+,13353,1796306,4709866,6146,1409802,3139152
2015-01-08,2015,100,D,4,3+,13073,1809379,4709866,5878,1415680,3139152
2015-01-09,2015,101,D,4,3+,13556,1822935,4709866,6269,1421949,3139152
2015-01-10,2015,102,D,4,3+,13381,1836316,4709866,6259,1428208,3139152
2015-01-11,2015,103,D,4,3+,12544,1848860,4709866,5342,1433550,3139152
2015-01-12,2015,104,D,4,3+,12801,1861661,4709866,5700,1439250,3139152
2015-01-13,2015,105,D,4,3+,12538,1874199,4709866,5496,1444746,3139152
2015-01-14,2015,106,D,4,3+,11983,1886182,4709866,4935,1449681,3139152
2015-01-15,2015,107,D,4,3+,11253,1897435,4709866,4433,1454114,3139152
2015-01-16,2015,108,D,4,3+,10749,1908184,4709866,4677,1458791,3139152
2015-01-17,2015,109,D,4,3+,10817,1919001,4709866,4923,1463714,3139152
2015-01-18,2015,110,D,4,3+,10645,1929646,4709866,4705,1468419,3139152
2015-01-19,2015,111,D,4,3+,11134,1940780,4709866,5217,1473636,3139152
2015-01-20,2015,112,D,4,3+,10927,1951707,4709866,4984,1478620,3139152
2015-01-21,2015,113,D,4,3+,11017,1962724,4709866,5339,1483959,3139152
2015-01-22,2015,114,D,4,3+,11034,1973758,4709866,5170,1489129,3139152
2015-01-23,2015,115,D,4,3+,10687,1984445,4709866,4668,1493797,3139152
2015-01-24,2015,116,D,4,3+,10703,1995148,4709866,4882,1498679,3139152
2015-01-25,2015,117,D,4,3+,10707,2005855,4709866,4983,1503662,3139152
2015-01-26,2015,118,D,4,3+,10738,2016593,4709866,5113,1508775,3139152
2015-01-27,2015,119,D,4,3+,11666,2028259,4709866,6173,1514948,3139152
2015-01-28,2015,120,D,4,3+,11009,2039268,4709866,5432,1520380,3139152
2015-01-29,2015,121,D,4,3+,10907,2050175,4709866,5321,1525701,3139152
2015-01-30,2015,122,D,4,3+,10473,2060648,4709866,4811,1530512,3139152
2015-01-31,2015,123,D,4,3+,10588,2071236,4709866,5145,1535657,3139152
2015-02-01,2015,124,D,4,3+,10015,2081251,4709866,5599,1541256,3139152
2015-02-02,2015,125,D,4,3+,10288,2091539,4709866,5853,1547109,3139152
2015-02-03,2015,126,D,4,3+,10591,2102130,4709866,6154,1553263,3139152
2015-02-04,2015,127,D,4,3+,10416,2112546,4709866,6972,1560235,3139152
2015-02-05,2015,128,D,4,3+,11120,2123666,4709866,7561,1567796,3139152
2015-02-06,2015,129,D,4,3+,11252,2134918,4709866,10434,1578230,3139152
2015-02-07,2015,130,D,4,3+,16135,2151053,4709866,16125,1594355,3139152
2015-02-08,2015,131,D,4,3+,23900,2174953,4709866,25076,1619431,3139152
2015-02-09,2015,132,D,4,3+,40058,2215011,4709866,40632,1660063,3139152
2015-02-10,2015,133,D,4,3+,40379,2255390,4709866,40894,1700957,3139152
2015-02-11,2015,134,D,4,3+,40711,2296101,4709866,37715,1738672,3139152
2015-02-12,2015,135,D,4,3+,40025,2336126,4709866,34501,1773173,3139152
2015-02-13,2015,136,D,4,3+,37288,2373414,4709866,29472,1802645,3139152
2015-02-14,2015,137,D,4,3+,32854,2406268,4709866,26143,1828788,3139152
2015-02-15,2015,138,D,4,3+,28746,2435014,4709866,21526,1850314,3139152
2015-02-16,2015,139,D,4,3+,24864,2459878,4709866,17644,1867958,3139152
2015-02-17,2015,140,D,4,3+,21814,2481692,4709866,15173,1883131,3139152
2015-02-18,2015,141,D,4,3+,19825,2501517,4709866,13735,1896866,3139152
2015-02-19,2015,142,D,4,3+,18550,2520067,4709866,12412,1909278,3139152
2015-02-20,2015,143,D,4,3+,17518,2537585,4709866,11424,1920702,3139152
2015-02-21,2015,144,D,4,3+,17033,2554618,4709866,10334,1931036,3139152
2015-02-22,2015,145,D,4,3+,15965,2570583,4709866,9802,1940838,3139152
2015-02-23,2015,146,D,4,3+,15571,2586154,4709866,10487,1951325,3139152
2015-02-24,2015,147,D,4,3+,14883,2601037,4709866,9809,1961134,3139152
2015-02-25,2015,148,D,4,3+,14259,2615296,4709866,9180,1970314,3139152
2015-02-26,2015,149,D,4,3+,13905,2629201,4709866,8027,1978341,3139152
2015-02-27,2015,150,D,4,3+,12802,2642003,4709866,6185,1984526,3139152
2015-02-28,2015,151,D,4,3+,12956,2654959,4709866,6342,1990868,3139152
2015-03-01,2015,152,D,4,3+,11740,2666699,4709866,5091,1995959,3139152
2015-03-02,2015,153,D,4,3+,11160,2677859,4709866,4935,2000894,3139152
2015-03-03,2015,154,D,4,3+,11316,2689175,4709866,5197,2006091,3139152
2015-03-04,2015,155,D,4,3+,11434,2700609,4709866,5337,2011428,3139152
2015-03-05,2015,156,D,4,3+,11815,2712424,4709866,5948,2017376,3139152
2015-03-06,2015,157,D,4,3+,10941,2723365,4709866,5240,2022616,3139152
2015-03-07,2015,158,D,4,3+,10694,2734059,4709866,4912,2027528,3139152
2015-03-08,2015,159,D,4,3+,10375,2744434,4709866,5056,2032584,3139152
2015-03-09,2015,160,D,4,3+,10140,2754574,4709866,4681,2037265,3139152
2015-03-10,2015,161,D,4,3+,10274,2764848,4709866,4833,2042098,3139152
2015-03-11,2015,162,D,4,3+,10545,2775393,4709866,6387,2048485,3139152
2015-03-12,2015,163,D,4,3+,10915,2786308,4709866,6629,2055114,3139152
2015-03-13,2015,164,D,4,3+,10141,2796449,4709866,6000,2061114,3139152
2015-03-14,2015,165,D,4,3+,9564,2806013,4709866,5339,2066453,3139152
2015-03-15,2015,166,D,4,3+,8961,2814974,4709866,4730,2071183,3139152
2015-03-16,2015,167,D,4,3+,10246,2825220,4709866,6281,2077464,3139152
2015-03-17,2015,168,D,4,3+,8866,2834086,4709866,5376,2082840,3139152
2015-03-18,2015,169,D,4,3+,10311,2844397,4709866,7219,2090059,3139152
2015-03-19,2015,170,D,4,3+,9913,2854310,4709866,6605,2096664,3139152
2015-03-20,2015,171,D,4,3+,9405,2863715,4709866,6209,2102873,3139152
2015-03-21,2015,172,D,4,3+,9742,2873457,4709866,6513,2109386,3139152
2015-03-22,2015,173,D,4,3+,8898,2882355,4709866,5572,2114958,3139152
2015-03-23,2015,174,D,4,3+,9840,2892195,4709866,6521,2121479,3139152
2015-03-24,2015,175,D,4,3+,10553,2902748,4709866,7188,2128667,3139152
2015-03-25,2015,176,D,4,3+,11002,2913750,4709866,7642,2136309,3139152
2015-03-26,2015,177,D,4,3+,11210,2924960,4709866,7813,2144122,3139152
2015-03-27,2015,178,D,4,3+,10300,2935260,4709866,6878,2151000,3139152
2015-03-28,2015,179,D,4,3+,11353,2946613,4709866,7897,2158897,3139152
2015-03-29,2015,180,D,4,3+,9941,2956554,4709866,6475,2165372,3139152
2015-03-30,2015,181,D,4,3+,9359,2965913,4709866,5875,2171247,3139152
2015-03-31,2015,182,D,4,3+,8770,2974683,4709866,5272,2176519,3139152
2015-04-01,2015,183,D,4,3+,9179,2983862,4709866,5804,2182323,3139152
2015-04-02,2015,184,D,4,3+,8977,2992839,4709866,5615,2187938,3139152
2015-04-03,2015,185,D,4,3+,7838,3000677,4709866,4460,2192398,3139152
2015-04-04,2015,186,D,4,3+,7854,3008531,4709866,4408,2196806,3139152
2015-04-05,2015,187,D,4,3+,8812,3017343,4709866,5583,2202389,3139152
2015-04-06,2015,188,D,4,3+,9634,3026977,4709866,6420,2208809,3139152
2015-04-07,2015,189,D,4,3+,9900,3036877,4709866,10840,2219649,3139152
2015-04-08,2015,190,D,4,3+,11403,3048280,4709866,12283,2231932,3139152
2015-04-09,2015,191,D,4,3+,9793,3058073,4709866,10653,2242585,3139152
2015-04-10,2015,192,D,4,3+,9225,3067298,4709866,9885,2252470,3139152
2015-04-11,2015,193,D,4,3+,9815,3077113,4709866,10521,2262991,3139152
2015-04-12,2015,194,D,4,3+,9858,3086971,4709866,6395,2269386,3139152
2015-04-13,2015,195,D,4,3+,9736,3096707,4709866,6325,2275711,3139152
2015-04-14,2015,196,D,4,3+,10683,3107390,4709866,7395,2283106,3139152
2015-04-15,2015,197,D,4,3+,11028,3118418,4709866,7475,2290581,3139152
2015-04-16,2015,198,D,4,3+,9788,3128206,4709866,6216,2296797,3139152
2015-04-17,2015,199,D,4,3+,9594,3137800,4709866,5997,2302794,3139152
2015-04-18,2015,200,D,4,3+,8715,3146515,4709866,5133,2307927,3139152
2015-04-19,2015,201,D,4,3+,8370,3154885,4709866,4774,2312701,3139152
2015-04-20,2015,202,D,4,3+,9322,3164207,4709866,5681,2318382,3139152
2015-04-21,2015,203,D,4,3+,8990,3173197,4709866,5403,2323785,3139152
2015-04-22,2015,204,D,4,3+,8662,3181859,4709866,5077,2328862,3139152
2015-04-23,2015,205,D,4,3+,7489,3189348,4709866,4007,2332869,3139152
2015-04-24,2015,206,D,4,3+,7216,3196564,4709866,4010,2336879,3139152
2015-04-25,2015,207,D,4,3+,8574,3205138,4709866,7922,2344801,3139152
2015-04-26,2015,208,D,4,3+,9338,3214476,4709866,8567,2353368,3139152
2015-04-27,2015,209,D,4,3+,8870,3223346,4709866,8074,2361442,3139152
2015-04-28,2015,210,D,4,3+,8292,3231638,4709866,7371,2368813,3139152
2015-04-29,2015,211,D,4,3+,8559,3240197,4709866,7433,2376246,3139152
2015-04-30,2015,212,D,4,3+,8455,3248652,4709866,4821,2381067,3139152
2015-05-01,2015,213,D,4,3+,7561,3256213,4709866,4216,2385283,3139152
2015-05-02,2015,214,D,4,3+,6780,3262993,4709866,3618,2388901,3139152
2015-05-03,2015,215,D,4,3+,7001,3269994,4709866,4361,2393262,3139152
2015-05-04,2015,216,D,4,3+,7803,3277797,4709866,4744,2398006,3139152
2015-05-05,2015,217,D,4,3+,9271,3287068,4709866,6527,2404533,3139152
2015-05-06,2015,218,D,4,3+,8758,3295826,4709866,5689,2410222,3139152
2015-05-07,2015,219,D,4,3+,8948,3304774,4709866,6262,2416484,3139152
2015-05-08,2015,220,D,4,3+,8504,3313278,4709866,5340,2421824,3139152
2015-05-09,2015,221,D,4,3+,9185,3322463,4709866,6498,2428322,3139152
2015-05-10,2015,222,D,4,3+,8282,3330745,4709866,5199,2433521,3139152
2015-05-11,2015,223,D,4,3+,9602,3340347,4709866,6737,2440258,3139152
2015-05-12,2015,224,D,4,3+,9936,3350283,4709866,6616,2446874,3139152
2015-05-13,2015,225,D,4,3+,9376,3359659,4709866,6404,2453278,3139152
2015-05-14,2015,226,D,4,3+,9822,3369481,4709866,6438,2459716,3139152
2015-05-15,2015,227,D,4,3+,9373,3378854,4709866,6380,2466096,3139152
2015-05-16,2015,228,D,4,3+,9539,3388393,4709866,6072,2472168,3139152
2015-05-17,2015,229,D,4,3+,9603,3397996,4709866,6554,2478722,3139152
2015-05-18,2015,230,D,4,3+,9766,3407762,4709866,6238,2484960,3139152
2015-05-19,2015,231,D,4,3+,10304,3418066,4709866,6973,2491933,3139152
2015-05-20,2015,232,D,4,3+,10316,3428382,4709866,6910,2498843,3139152
2015-05-21,2015,233,D,4,3+,10875,3439257,4709866,7475,2506318,3139152
2015-05-22,2015,234,D,4,3+,10728,3449985,4709866,7283,2513601,3139152
2015-05-23,2015,235,D,4,3+,10775,3460760,4709866,7273,2520874,3139152
2015-05-24,2015,236,D,4,3+,9942,3470702,4709866,6409,2527283,3139152
2015-05-25,2015,237,D,4,3+,10405,3481107,4709866,6833,2534116,3139152
2015-05-26,2015,238,D,4,3+,10235,3491342,4709866,6165,2540281,3139152
2015-05-27,2015,239,D,4,3+,10212,3501554,4709866,6081,2546362,3139152
2015-05-28,2015,240,D,4,3+,9398,3510952,4709866,4974,2551336,3139152
2015-05-29,2015,241,D,4,3+,8978,3519930,4709866,4997,2556333,3139152
2015-05-30,2015,242,D,4,3+,8523,3528453,4709866,4068,2560401,3139152
2015-05-31,2015,243,D,4,3+,7910,3536363,4709866,3842,2564243,3139152
2015-06-01,2015,244,D,4,3+,8741,3545104,4709866,4600,2568843,3139152
2015-06-02,2015,245,D,4,3+,8740,3553844,4709866,5050,2573893,3139152
2015-06-03,2015,246,D,4,3+,9485,3563329,4709866,5216,2579109,3139152
2015-06-04,2015,247,D,4,3+,9224,3572553,4709866,5484,2584593,3139152
2015-06-05,2015,248,D,4,3+,9579,3582132,4709866,5301,2589894,3139152
2015-06-06,2015,249,D,4,3+,9235,3591367,4709866,5340,2595234,3139152
2015-06-07,2015,250,D,4,3+,9279,3600646,4709866,4861,2600095,3139152
2015-06-08,2015,251,D,4,3+,10466,3611112,4709866,6510,2606605,3139152
2015-06-09,2015,252,D,4,3+,9697,3620809,4709866,5225,2611830,3139152
2015-06-10,2015,253,D,4,3+,10390,3631199,4709866,7234,2619064,3139152
2015-06-11,2015,254,D,4,3+,9099,3640298,4709866,5323,2624387,3139152
2015-06-12,2015,255,D,4,3+,8843,3649141,4709866,5477,2629864,3139152
2015-06-13,2015,256,D,4,3+,8321,3657462,4709866,4425,2634289,3139152
2015-06-14,2015,257,D,4,3+,8471,3665933,4709866,5005,2639294,3139152
2015-06-15,2015,258,D,4,3+,8491,3674424,4709866,3624,2642918,3139152
2015-06-16,2015,259,D,4,3+,8635,3683059,4709866,4218,2647136,3139152
2015-06-17,2015,260,D,4,3+,9573,3692632,4709866,4635,2651771,3139152
2015-06-18,2015,261,D,4,3+,8745,3701377,4709866,4243,2656014,3139152
2015-06-19,2015,262,D,4,3+,9214,3710591,4709866,4303,2660317,3139152
2015-06-20,2015,263,D,4,3+,9165,3719756,4709866,4456,2664773,3139152
2015-06-21,2015,264,D,4,3+,8482,3728238,4709866,3732,2668505,3139152
2015-06-22,2015,265,D,4,3+,9802,3738040,4709866,4961,2673466,3139152
2015-06-23,2015,266,D,4,3+,9299,3747339,4709866,4449,2677915,3139152
2015-06-24,2015,267,D,4,3+,8874,3756213,4709866,3994,2681909,3139152
2015-06-25,2015,268,D,4,3+,10177,3766390,4709866,5210,2687119,3139152
2015-06-26,2015,269,D,4,3+,9668,3776058,4709866,4633,2691752,3139152
2015-06-27,2015,270,D,4,3+,9103,3785161,4709866,3974,2695726,3139152
2015-06-28,2015,271,D,4,3+,8969,3794130,4709866,3845,2699571,3139152
2015-06-29,2015,272,D,4,3+,9640,3803770,4709866,4568,2704139,3139152
2015-06-30,2015,273,D,4,3+,9069,3812839,4709866,3998,2708137,3139152
2015-07-01,2015,274,D,4,3+,8632,3821471,4709866,3463,2711600,3139152
2015-07-02,2015,275,D,4,3+,8621,3830092,4709866,3439,2715039,3139152
2015-07-03,2015,276,D,4,3+,8802,3838894,4709866,3580,2718619,3139152
2015-07-04,2015,277,D,4,3+,9078,3847972,4709866,3860,2722479,3139152
2015-07-05,2015,278,D,4,3+,9542,3857514,4709866,4283,2726762,3139152
2015-07-06,2015,279,D,4,3+,9851,3867365,4709866,4587,2731349,3139152
2015-07-07,2015,280,D,4,3+,9711,3877076,4709866,4581,2735930,3139152
2015-07-08,2015,281,D,4,3+,9150,3886226,4709866,4023,2739953,3139152
2015-07-09,2015,282,D,4,3+,10319,3896545,4709866,5208,2745161,3139152
2015-07-10,2015,283,D,4,3+,10439,3906984,4709866,5341,2750502,3139152
2015-07-11,2015,284,D,4,3+,10309,3917293,4709866,5222,2755724,3139152
2015-07-12,2015,285,D,4,3+,10856,3928149,4709866,5770,2761494,3139152
2015-07-13,2015,286,D,4,3+,10722,3938871,4709866,5652,2767146,3139152
2015-07-14,2015,287,D,4,3+,10260,3949131,4709866,5184,2772330,3139152
2015-07-15,2015,288,D,4,3+,10383,3959514,4709866,5304,2777634,3139152
2015-07-16,2015,289,D,4,3+,10399,3969913,4709866,5339,2782973,3139152
2015-07-17,2015,290,D,4,3+,10687,3980600,4709866,5612,2788585,3139152
2015-07-18,2015,291,D,4,3+,10499,3991099,4709866,5413,2793998,3139152
2015-07-19,2015,292,D,4,3+,10954,4002053,4709866,5850,2799848,3139152
2015-07-20,2015,293,D,4,3+,10358,4012411,4709866,5308,2805156,3139152
2015-07-21,2015,294,D,4,3+,10183,4022594,4709866,5119,2810275,3139152
2015-07-22,2015,295,D,4,3+,9619,4032213,4709866,4806,2815081,3139152
2015-07-23,2015,296,D,4,3+,9446,4041659,4709866,4630,2819711,3139152
2015-07-24,2015,297,D,4,3+,9945,4051604,4709866,4781,2824492,3139152
2015-07-25,2015,298,D,4,3+,9555,4061159,4709866,4445,2828937,3139152
2015-07-26,2015,299,D,4,3+,9289,4070448,4709866,4185,2833122,3139152
2015-07-27,2015,300,D,4,3+,10144,4080592,4709866,5049,2838171,3139152
2015-07-28,2015,301,D,4,3+,9903,4090495,4709866,4849,2843020,3139152
2015-07-29,2015,302,D,4,3+,9729,4100224,4709866,4657,2847677,3139152
2015-07-30,2015,303,D,4,3+,9059,4109283,4709866,3982,2851659,3139152
2015-07-31,2015,304,D,4,3+,9189,4118472,4709866,4149,2855808,3139152
2015-08-01,2015,305,D,4,3+,9228,4127700,4709866,4181,2859989,3139152
2015-08-02,2015,306,D,4,3+,9186,4136886,4709866,4156,2864145,3139152
2015-08-03,2015,307,D,4,3+,9199,4146085,4709866,4190,2868335,3139152
2015-08-04,2015,308,D,4,3+,9310,4155395,4709866,4336,2872671,3139152
2015-08-05,2015,309,D,4,3+,9988,4165383,4709866,5088,2877759,3139152
2015-08-06,2015,310,D,4,3+,9649,4175032,4709866,4746,2882505,3139152
2015-08-07,2015,311,D,4,3+,10358,4185390,4709866,5484,2887989,3139152
2015-08-08,2015,312,D,4,3+,10051,4195441,4709866,5165,2893154,3139152
2015-08-09,2015,313,D,4,3+,9841,4205282,4709866,5014,2898168,3139152
2015-08-10,2015,314,D,4,3+,9522,4214804,4709866,4690,2902858,3139152
2015-08-11,2015,315,D,4,3+,9722,4224526,4709866,4938,2907796,3139152
2015-08-12,2015,316,D,4,3+,9750,4234276,4709866,4973,2912769,3139152
2015-08-13,2015,317,D,4,3+,9342,4243618,4709866,4623,2917392,3139152
2015-08-14,2015,318,D,4,3+,9849,4253467,4709866,5186,2922578,3139152
2015-08-15,2015,319,D,4,3+,9732,4263199,4709866,5066,2927644,3139152
2015-08-16,2015,320,D,4,3+,9365,4272564,4709866,4722,2932366,3139152
2015-08-17,2015,321,D,4,3+,8981,4281545,4709866,4227,2936593,3139152
2015-08-18,2015,322,D,4,3+,8343,4289888,4709866,3672,2940265,3139152
2015-08-19,2015,323,D,4,3+,7761,4297649,4709866,2990,2943255,3139152
2015-08-20,2015,324,D,4,3+,8722,4306371,4709866,3954,2947209,3139152
2015-08-21,2015,325,D,4,3+,8952,4315323,4709866,4248,2951457,3139152
2015-08-22,2015,326,D,4,3+,9227,4324550,4709866,4588,2956045,3139152
2015-08-23,2015,327,D,4,3+,9633,4334183,4709866,5011,2961056,3139152
2015-08-24,2015,328,D,4,3+,10255,4344438,4709866,5715,2966771,3139152
2015-08-25,2015,329,D,4,3+,10617,4355055,4709866,5707,2972478,3139152
2015-08-26,2015,330,D,4,3+,10187,4365242,4709866,4781,2977259,3139152
2015-08-27,2015,331,D,4,3+,10538,4375780,4709866,5039,2982298,3139152
2015-08-28,2015,332,D,4,3+,10571,4386351,4709866,3137,2985435,3139152
2015-08-29,2015,333,D,4,3+,10732,4397083,4709866,3268,2988703,3139152
2015-08-30,2015,334,D,4,3+,10726,4407809,4709866,3095,2991798,3139152
2015-08-31,2015,335,D,4,3+,10558,4418367,4709866,2582,2994380,3139152
2015-09-01,2015,336,D,4,3+,10254,4428621,4709866,3394,2997774,3139152
2015-09-02,2015,337,D,4,3+,10278,4438899,4709866,4144,3001918,3139152
2015-09-03,2015,338,D,4,3+,10505,4449404,4709866,4406,3006324,3139152
2015-09-04,2015,339,D,4,3+,10300,4459704,4709866,4256,3010580,3139152
2015-09-05,2015,340,D,4,3+,10931,4470635,4709866,4913,3015493,3139152
2015-09-06,2015,341,D,4,3+,10698,4481333,4709866,4730,3020223,3139152
2015-09-07,2015,342,D,4,3+,10636,4491969,4709866,4691,3024914,3139152
2015-09-08,2015,343,D,4,3+,10142,4502111,4709866,4260,3029174,3139152
2015-09-09,2015,344,D,4,3+,9844,4511955,4709866,3974,3033148,3139152
2015-09-10,2015,345,D,4,3+,9816,4521771,4709866,3978,3037126,3139152
2015-09-11,2015,346,D,4,3+,9735,4531506,4709866,4109,3041235,3139152
2015-09-12,2015,347,D,4,3+,9577,4541083,4709866,4145,3045380,3139152
2015-09-13,2015,348,D,4,3+,9426,4550509,4709866,4053,3049433,3139152
2015-09-14,2015,349,D,4,3+,9472,4559981,4709866,4153,3053586,3139152
2015-09-15,2015,350,D,4,3+,10094,4570075,4709866,4893,3058479,3139152
2015-09-16,2015,351,D,4,3+,10578,4580653,4709866,5488,3063967,3139152
2015-09-17,2015,352,D,4,3+,10353,4591006,4709866,5315,3069282,3139152
2015-09-18,2015,353,D,4,3+,9929,4600935,4709866,4974,3074256,3139152
2015-09-19,2015,354,D,4,3+,9834,4610769,4709866,4990,3079246,3139152
2015-09-20,2015,355,D,4,3+,9835,4620604,4709866,5740,3084986,3139152
2015-09-21,2015,356,D,4,3+,9574,4630178,4709866,5940,3090926,3139152
2015-09-22,2015,357,D,4,3+,9578,4639756,4709866,5990,3096916,3139152
2015-09-23,2015,358,D,4,3+,9176,4648932,4709866,5586,3102502,3139152
2015-09-24,2015,359,D,4,3+,8809,4657741,4709866,5282,3107784,3139152
2015-09-25,2015,360,D,4,3+,8629,4666370,4709866,5145,3112929,3139152
2015-09-26,2015,361,D,4,3+,8958,4675328,4709866,5437,3118366,3139152
2015-09-27,2015,362,D,4,3+,8476,4683804,4709866,5034,3123400,3139152
2015-09-28,2015,363,D,4,3+,8568,4692372,4709866,5103,3128503,3139152
2015-09-29,2015,364,D,4,3+,8572,4700944,4709866,5143,3133646,3139152
2015-09-30,2015,365,D,4,3+,8922,4709866,4709866,5506,3139152,3139152
2015-10-01,2016,1,D,5,3+,8250,8250,7992679,6437,6437,5742161
2015-10-02,2016,2,D,5,3+,8120,16370,7992679,6360,12797,5742161
2015-10-03,2016,3,D,5,3+,7674,24044,7992679,5980,18777,5742161
2015-10-04,2016,4,D,5,3+,7888,31932,7992679,6190,24967,5742161
2015-10-05,2016,5,D,5,3+,7932,39864,7992679,6261,31228,5742161
2015-10-06,2016,6,D,5,3+,7973,47837,7992679,4701,35929,5742161
2015-10-07,2016,7,D,5,3+,7966,55803,7992679,4733,40662,5742161
2015-10-08,2016,8,D,5,3+,8008,63811,7992679,4762,45424,5742161
2015-10-09,2016,9,D,5,3+,7924,71735,7992679,4704,50128,5742161
2015-10-10,2016,10,D,5,3+,7655,79390,7992679,4516,54644,5742161
2015-10-11,2016,11,D,5,3+,7878,87268,7992679,3958,58602,5742161
2015-10-12,2016,12,D,5,3+,8068,95336,7992679,4135,62737,5742161
2015-10-13,2016,13,D,5,3+,7815,103151,7992679,3867,66604,5742161
2015-10-14,2016,14,D,5,3+,7557,110708,7992679,3645,70249,5742161
2015-10-15,2016,15,D,5,3+,7615,118323,7992679,3685,73934,5742161
2015-10-16,2016,16,D,5,3+,7693,126016,7992679,4018,77952,5742161
2015-10-17,2016,17,D,5,3+,7931,133947,7992679,4277,82229,5742161
2015-10-18,2016,18,D,5,3+,8048,141995,7992679,5048,87277,5742161
2015-10-19,2016,19,D,5,3+,8105,150100,7992679,5323,92600,5742161
2015-10-20,2016,20,D,5,3+,7974,158074,7992679,5137,97737,5742161
2015-10-21,2016,21,D,5,3+,7625,165699,7992679,4493,102230,5742161
2015-10-22,2016,22,D,5,3+,7692,173391,7992679,4489,106719,5742161
2015-10-23,2016,23,D,5,3+,7665,181056,7992679,4490,111209,5742161
2015-10-24,2016,24,D,5,3+,7297,188353,7992679,4135,115344,5742161
2015-10-25,2016,25,D,5,3+,6998,195351,7992679,3827,119171,5742161
2015-10-26,2016,26,D,5,3+,7344,202695,7992679,4198,123369,5742161
2015-10-27,2016,27,D,5,3+,7583,210278,7992679,4426,127795,5742161
2015-10-28,2016,28,D,5,3+,8037,218315,7992679,4910,132705,5742161
2015-10-29,2016,29,D,5,3+,8105,226420,7992679,5040,137745,5742161
2015-10-30,2016,30,D,5,3+,7888,234308,7992679,4832,142577,5742161
2015-10-31,2016,31,D,5,3+,7594,241902,7992679,4288,146865,5742161
2015-11-01,2016,32,D,5,3+,7737,249639,7992679,4838,151703,5742161
2015-11-02,2016,33,D,5,3+,8171,257810,7992679,9889,161592,5742161
2015-11-03,2016,34,D,5,3+,8619,266429,7992679,9470,171062,5742161
2015-11-04,2016,35,D,5,3+,8658,275087,7992679,9381,180443,5742161
2015-11-05,2016,36,D,5,3+,7846,282933,7992679,8155,188598,5742161
2015-11-06,2016,37,D,5,3+,7343,290276,7992679,7198,195796,5742161
2015-11-07,2016,38,D,5,3+,7040,297316,7992679,2310,198106,5742161
2015-11-08,2016,39,D,5,3+,6913,304229,7992679,2889,200995,5742161
2015-11-09,2016,40,D,5,3+,7232,311461,7992679,4836,205831,5742161
2015-11-10,2016,41,D,5,3+,7658,319119,7992679,5263,211094,5742161
2015-11-11,2016,42,D,5,3+,7809,326928,7992679,5414,216508,5742161
2015-11-12,2016,43,D,5,3+,7400,334328,7992679,5238,221746,5742161
2015-11-13,2016,44,D,5,3+,7267,341595,7992679,4433,226179,5742161
2015-11-14,2016,45,D,5,3+,6890,348485,7992679,2451,228630,5742161
2015-11-15,2016,46,D,5,3+,6973,355458,7992679,3376,232006,5742161
2015-11-16,2016,47,D,5,3+,7895,363353,7992679,4309,236315,5742161
2015-11-17,2016,48,D,5,3+,7367,370720,7992679,4072,240387,5742161
2015-11-18,2016,49,D,5,3+,6998,377718,7992679,3720,244107,5742161
2015-11-19,2016,50,D,5,3+,6893,384611,7992679,3529,247636,5742161
2015-11-20,2016,51,D,5,3+,6753,391364,7992679,2453,250089,5742161
2015-11-21,2016,52,D,5,3+,6711,398075,7992679,2410,252499,5742161
2015-11-22,2016,53,D,5,3+,6517,404592,7992679,3513,256012,5742161
2015-11-23,2016,54,D,5,3+,6322,410914,7992679,3324,259336,5742161
2015-11-24,2016,55,D,5,3+,6724,417638,7992679,4204,263540,5742161
2015-11-25,2016,56,D,5,3+,7167,424805,7992679,4614,268154,5742161
2015-11-26,2016,57,D,5,3+,7299,432104,7992679,4757,272911,5742161
2015-11-27,2016,58,D,5,3+,7210,439314,7992679,4629,277540,5742161
2015-11-28,2016,59,D,5,3+,7023,446337,7992679,4404,281944,5742161
2015-11-29,2016,60,D,5,3+,7079,453416,7992679,3983,285927,5742161
2015-11-30,2016,61,D,5,3+,7157,460573,7992679,4010,289937,5742161
2015-12-01,2016,62,D,5,3+,7312,467885,7992679,4272,294209,5742161
2015-12-02,2016,63,D,5,3+,7344,475229,7992679,4705,298914,5742161
2015-12-03,2016,64,D,5,3+,7496,482725,7992679,5544,304458,5742161
2015-12-04,2016,65,D,5,3+,8169,490894,7992679,6099,310557,5742161
2015-12-05,2016,66,D,5,3+,8411,499305,7992679,6313,316870,5742161
2015-12-06,2016,67,D,5,3+,8439,507744,7992679,6360,323230,5742161
2015-12-07,2016,68,D,5,3+,8731,516475,7992679,6603,329833,5742161
2015-12-08,2016,69,D,5,3+,8797,525272,7992679,5969,335802,5742161
2015-12-09,2016,70,D,5,3+,8862,534134,7992679,6047,341849,5742161
2015-12-10,2016,71,D,5,3+,8585,542719,7992679,6839,348688,5742161
2015-12-11,2016,72,D,5,3+,9205,551924,7992679,8397,357085,5742161
2015-12-12,2016,73,D,5,3+,10162,562086,7992679,9356,366441,5742161
2015-12-13,2016,74,D,5,3+,11039,573125,7992679,12535,378976,5742161
2015-12-14,2016,75,D,5,3+,11686,584811,7992679,13129,392105,5742161
2015-12-15,2016,76,D,5,3+,11088,595899,7992679,11404,403509,5742161
2015-12-16,2016,77,D,5,3+,11248,607147,7992679,10534,414043,5742161
2015-12-17,2016,78,D,5,3+,10431,617578,7992679,9141,423184,5742161
2015-12-18,2016,79,D,5,3+,9198,626776,7992679,6336,429520,5742161
2015-12-19,2016,80,D,5,3+,9129,635905,7992679,7437,436957,5742161
2015-12-20,2016,81,D,5,3+,10513,646418,7992679,9056,446013,5742161
2015-12-21,2016,82,D,5,3+,13654,660072,7992679,14539,460552,5742161
2015-12-22,2016,83,D,5,3+,18208,678280,7992679,17944,478496,5742161
2015-12-23,2016,84,D,5,3+,20382,698662,7992679,18226,496722,5742161
2015-12-24,2016,85,D,5,3+,24569,723231,7992679,21379,518101,5742161
2015-12-25,2016,86,D,5,3+,24302,747533,7992679,20983,539084,5742161
2015-12-26,2016,87,D,5,3+,19747,767280,7992679,14134,553218,5742161
2015-12-27,2016,88,D,5,3+,15578,782858,7992679,8011,561229,5742161
2015-12-28,2016,89,D,5,3+,13003,795861,7992679,5922,567151,5742161
2015-12-29,2016,90,D,5,3+,11737,807598,7992679,3563,570714,5742161
2015-12-30,2016,91,D,5,3+,10808,818406,7992679,3070,573784,5742161
2015-12-31,2016,92,D,5,3+,9992,828398,7992679,2860,576644,5742161
2016-01-01,2016,93,D,5,3+,9448,837846,7992679,3611,580255,5742161
2016-01-02,2016,94,D,5,3+,8886,846732,7992679,3790,584045,5742161
2016-01-03,2016,95,D,5,3+,8419,855151,7992679,4240,588285,5742161
2016-01-04,2016,96,D,5,3+,8369,863520,7992679,5405,593690,5742161
2016-01-05,2016,97,D,5,3+,9483,873003,7992679,11263,604953,5742161
2016-01-06,2016,98,D,5,3+,12021,885024,7992679,13227,618180,5742161
2016-01-07,2016,99,D,5,3+,18151,903175,7992679,19416,637596,5742161
2016-01-08,2016,100,D,5,3+,25720,928895,7992679,27181,664777,5742161
2016-01-09,2016,101,D,5,3+,27326,956221,7992679,27455,692232,5742161
2016-01-10,2016,102,D,5,3+,23812,980033,7992679,18049,710281,5742161
2016-01-11,2016,103,D,5,3+,20376,1000409,7992679,13359,723640,5742161
2016-01-12,2016,104,D,5,3+,18852,1019261,7992679,11869,735509,5742161
2016-01-13,2016,105,D,5,3+,17572,1036833,7992679,10470,745979,5742161
2016-01-14,2016,106,D,5,3+,16799,1053632,7992679,10444,756423,5742161
2016-01-15,2016,107,D,5,3+,18979,1072611,7992679,15007,771430,5742161
2016-01-16,2016,108,D,5,3+,23799,1096410,7992679,20483,791913,5742161
2016-01-17,2016,109,D,5,3+,27658,1124068,7992679,27424,819337,5742161
2016-01-18,2016,110,D,5,3+,33104,1157172,7992679,33377,852714,5742161
2016-01-19,2016,111,D,5,3+,39887,1197059,7992679,40792,893506,5742161
2016-01-20,2016,112,D,5,3+,45720,1242779,7992679,45990,939496,5742161
2016-01-21,2016,113,D,5,3+,50624,1293403,7992679,50085,989581,5742161
2016-01-22,2016,114,D,5,3+,54405,1347808,7992679,51570,1041151,5742161
2016-01-23,2016,115,D,5,3+,56382,1404190,7992679,53300,1094451,5742161
2016-01-24,2016,116,D,5,3+,54983,1459173,7992679,51241,1145692,5742161
2016-01-25,2016,117,D,5,3+,53748,1512921,7992679,49853,1195545,5742161
2016-01-26,2016,118,D,5,3+,52445,1565366,7992679,48338,1243883,5742161
2016-01-27,2016,119,D,5,3+,49265,1614631,7992679,44133,1288016,5742161
2016-01-28,2016,120,D,5,3+,44054,1658685,7992679,38454,1326470,5742161
2016-01-29,2016,121,D,5,3+,38017,1696702,7992679,33137,1359607,5742161
2016-01-30,2016,122,D,5,3+,39372,1736074,7992679,34843,1394450,5742161
2016-01-31,2016,123,D,5,3+,43281,1779355,7992679,38917,1433367,5742161
2016-02-01,2016,124,D,5,3+,46301,1825656,7992679,42029,1475396,5742161
2016-02-02,2016,125,D,5,3+,45318,1870974,7992679,42112,1517508,5742161
2016-02-03,2016,126,D,5,3+,41427,1912401,7992679,37565,1555073,5742161
2016-02-04,2016,127,D,5,3+,35721,1948122,7992679,31614,1586687,5742161
2016-02-05,2016,128,D,5,3+,30916,1979038,7992679,26809,1613496,5742161
2016-02-06,2016,129,D,5,3+,27250,2006288,7992679,22876,1636372,5742161
2016-02-07,2016,130,D,5,3+,24362,2030650,7992679,19882,1656254,5742161
2016-02-08,2016,131,D,5,3+,22132,2052782,7992679,17501,1673755,5742161
2016-02-09,2016,132,D,5,3+,20802,2073584,7992679,15524,1689279,5742161
2016-02-10,2016,133,D,5,3+,20559,2094143,7992679,15027,1704306,5742161
2016-02-11,2016,134,D,5,3+,20297,2114440,7992679,14052,1718358,5742161
2016-02-12,2016,135,D,5,3+,19606,2134046,7992679,12781,1731139,5742161
2016-02-13,2016,136,D,5,3+,19159,2153205,7992679,12263,1743402,5742161
2016-02-14,2016,137,D,5,3+,18895,2172100,7992679,12014,1755416,5742161
2016-02-15,2016,138,D,5,3+,18356,2190456,7992679,11537,1766953,5742161
2016-02-16,2016,139,D,5,3+,17319,2207775,7992679,10474,1777427,5742161
2016-02-17,2016,140,D,5,3+,16634,2224409,7992679,12411,1789838,5742161
2016-02-18,2016,141,D,5,3+,17915,2242324,7992679,13917,1803755,5742161
2016-02-19,2016,142,D,5,3+,18349,2260673,7992679,14354,1818109,5742161
2016-02-20,2016,143,D,5,3+,18615,2279288,7992679,14612,1832721,5742161
2016-02-21,2016,144,D,5,3+,19330,2298618,7992679,15313,1848034,5742161
2016-02-22,2016,145,D,5,3+,19860,2318478,7992679,13306,1861340,5742161
2016-02-23,2016,146,D,5,3+,21297,2339775,7992679,14471,1875811,5742161
2016-02-24,2016,147,D,5,3+,22068,2361843,7992679,15287,1891098,5742161
2016-02-25,2016,148,D,5,3+,21092,2382935,7992679,14283,1905381,5742161
2016-02-26,2016,149,D,5,3+,19672,2402607,7992679,12879,1918260,5742161
2016-02-27,2016,150,D,5,3+,18543,2421150,7992679,11760,1930020,5742161
2016-02-28,2016,151,D,5,3+,17588,2438738,7992679,10816,1940836,5742161
2016-02-29,2016,152,D,5,3+,16868,2455606,7992679,10017,1950853,5742161
2016-03-01,2016,153,D,5,3+,15920,2471526,7992679,9092,1959945,5742161
2016-03-02,2016,154,D,5,3+,15197,2486723,7992679,8488,1968433,5742161
2016-03-03,2016,155,D,5,3+,15015,2501738,7992679,8331,1976764,5742161
2016-03-04,2016,156,D,5,3+,15925,2517663,7992679,10619,1987383,5742161
2016-03-05,2016,157,D,5,3+,19672,2537335,7992679,18640,2006023,5742161
2016-03-06,2016,158,D,5,3+,31757,2569092,7992679,33154,2039177,5742161
2016-03-07,2016,159,D,5,3+,47436,2616528,7992679,51560,2090737,5742161
2016-03-08,2016,160,D,5,3+,59451,2675979,7992679,63475,2154212,5742161
2016-03-09,2016,161,D,5,3+,68122,2744101,7992679,70363,2224575,5742161
2016-03-10,2016,162,D,5,3+,70741,2814842,7992679,68295,2292870,5742161
2016-03-11,2016,163,D,5,3+,72629,2887471,7992679,69509,2362379,5742161
2016-03-12,2016,164,D,5,3+,80328,2967799,7992679,74739,2437118,5742161
2016-03-13,2016,165,D,5,3+,97609,3065408,7992679,93914,2531032,5742161
2016-03-14,2016,166,D,5,3+,152309,3217717,7992679,148085,2679117,5742161
2016-03-15,2016,167,D,5,3+,169451,3387168,7992679,164899,2844016,5742161
2016-03-16,2016,168,D,5,3+,145345,3532513,7992679,137885,2981901,5742161
2016-03-17,2016,169,D,5,3+,117657,3650170,7992679,110218,3092119,5742161
2016-03-18,2016,170,D,5,3+,99243,3749413,7992679,90615,3182734,5742161
2016-03-19,2016,171,D,5,3+,86210,3835623,7992679,77627,3260361,5742161
2016-03-20,2016,172,D,5,3+,77580,3913203,7992679,69175,3329536,5742161
2016-03-21,2016,173,D,5,3+,73622,3986825,7992679,65448,3394984,5742161
2016-03-22,2016,174,D,5,3+,71899,4058724,7992679,63916,3458900,5742161
2016-03-23,2016,175,D,5,3+,70592,4129316,7992679,63485,3522385,5742161
2016-03-24,2016,176,D,5,3+,68993,4198309,7992679,62972,3585357,5742161
2016-03-25,2016,177,D,5,3+,65626,4263935,7992679,59699,3645056,5742161
2016-03-26,2016,178,D,5,3+,62638,4326573,7992679,56763,3701819,5742161
2016-03-27,2016,179,D,5,3+,59710,4386283,7992679,54402,3756221,5742161
2016-03-28,2016,180,D,5,3+,55241,4441524,7992679,49756,3805977,5742161
2016-03-29,2016,181,D,5,3+,50062,4491586,7992679,44704,3850681,5742161
2016-03-30,2016,182,D,5,3+,44590,4536176,7992679,39260,3889941,5742161
2016-03-31,2016,183,D,5,3+,39575,4575751,7992679,34197,3924138,5742161
2016-04-01,2016,184,D,5,3+,35475,4611226,7992679,32003,3956141,5742161
2016-04-02,2016,185,D,5,3+,32067,4643293,7992679,28623,3984764,5742161
2016-04-03,2016,186,D,5,3+,29306,4672599,7992679,25828,4010592,5742161
2016-04-04,2016,187,D,5,3+,27500,4700099,7992679,23926,4034518,5742161
2016-04-05,2016,188,D,5,3+,26385,4726484,7992679,22806,4057324,5742161
2016-04-06,2016,189,D,5,3+,25576,4752060,7992679,21991,4079315,5742161
2016-04-07,2016,190,D,5,3+,24749,4776809,7992679,21160,4100475,5742161
2016-04-08,2016,191,D,5,3+,23858,4800667,7992679,21135,4121610,5742161
2016-04-09,2016,192,D,5,3+,23576,4824243,7992679,27766,4149376,5742161
2016-04-10,2016,193,D,5,3+,24251,4848494,7992679,29575,4178951,5742161
2016-04-11,2016,194,D,5,3+,24265,4872759,7992679,29575,4208526,5742161
2016-04-12,2016,195,D,5,3+,24079,4896838,7992679,29413,4237939,5742161
2016-04-13,2016,196,D,5,3+,23480,4920318,7992679,27842,4265781,5742161
2016-04-14,2016,197,D,5,3+,22839,4943157,7992679,20773,4286554,5742161
2016-04-15,2016,198,D,5,3+,22690,4965847,7992679,19466,4306020,5742161
2016-04-16,2016,199,D,5,3+,22304,4988151,7992679,19095,4325115,5742161
2016-04-17,2016,200,D,5,3+,22419,5010570,7992679,19208,4344323,5742161
2016-04-18,2016,201,D,5,3+,22935,5033505,7992679,19715,4364038,5742161
2016-04-19,2016,202,D,5,3+,22000,5055505,7992679,18321,4382359,5742161
2016-04-20,2016,203,D,5,3+,20287,5075792,7992679,16600,4398959,5742161
2016-04-21,2016,204,D,5,3+,19601,5095393,7992679,15933,4414892,5742161
2016-04-22,2016,205,D,5,3+,19491,5114884,7992679,17617,4432509,5742161
2016-04-23,2016,206,D,5,3+,19778,5134662,7992679,17913,4450422,5742161
2016-04-24,2016,207,D,5,3+,19645,5154307,7992679,16642,4467064,5742161
2016-04-25,2016,208,D,5,3+,19637,5173944,7992679,17091,4484155,5742161
2016-04-26,2016,209,D,5,3+,18609,5192553,7992679,16095,4500250,5742161
2016-04-27,2016,210,D,5,3+,18031,5210584,7992679,13682,4513932,5742161
2016-04-28,2016,211,D,5,3+,17628,5228212,7992679,13233,4527165,5742161
2016-04-29,2016,212,D,5,3+,16699,5244911,7992679,12295,4539460,5742161
2016-04-30,2016,213,D,5,3+,15793,5260704,7992679,10895,4550355,5742161
2016-05-01,2016,214,D,5,3+,15185,5275889,7992679,10300,4560655,5742161
2016-05-02,2016,215,D,5,3+,14251,5290140,7992679,9359,4570014,5742161
2016-05-03,2016,216,D,5,3+,13422,5303562,7992679,8481,4578495,5742161
2016-05-04,2016,217,D,5,3+,13809,5317371,7992679,8844,4587339,5742161
2016-05-05,2016,218,D,5,3+,14421,5331792,7992679,9401,4596740,5742161
2016-05-06,2016,219,D,5,3+,15022,5346814,7992679,11869,4608609,5742161
2016-05-07,2016,220,D,5,3+,15934,5362748,7992679,12962,4621571,5742161
2016-05-08,2016,221,D,5,3+,17176,5379924,7992679,14185,4635756,5742161
2016-05-09,2016,222,D,5,3+,18138,5398062,7992679,15179,4650935,5742161
2016-05-10,2016,223,D,5,3+,18852,5416914,7992679,16325,4667260,5742161
2016-05-11,2016,224,D,5,3+,19685,5436599,7992679,15071,4682331,5742161
2016-05-12,2016,225,D,5,3+,19392,5455991,7992679,14264,4696595,5742161
2016-05-13,2016,226,D,5,3+,18127,5474118,7992679,12915,4709510,5742161
2016-05-14,2016,227,D,5,3+,17422,5491540,7992679,12191,4721701,5742161
2016-05-15,2016,228,D,5,3+,16789,5508329,7992679,11704,4733405,5742161
2016-05-16,2016,229,D,5,3+,16283,5524612,7992679,10962,4744367,5742161
2016-05-17,2016,230,D,5,3+,15986,5540598,7992679,11632,4755999,5742161
2016-05-18,2016,231,D,5,3+,15437,5556035,7992679,11831,4767830,5742161
2016-05-19,2016,232,D,5,3+,15072,5571107,7992679,11519,4779349,5742161
2016-05-20,2016,233,D,5,3+,15522,5586629,7992679,11966,4791315,5742161
2016-05-21,2016,234,D,5,3+,16569,5603198,7992679,13940,4805255,5742161
2016-05-22,2016,235,D,5,3+,17372,5620570,7992679,13320,4818575,5742161
2016-05-23,2016,236,D,5,3+,17971,5638541,7992679,13454,4832029,5742161
2016-05-24,2016,237,D,5,3+,18528,5657069,7992679,14046,4846075,5742161
2016-05-25,2016,238,D,5,3+,18700,5675769,7992679,15027,4861102,5742161
2016-05-26,2016,239,D,5,3+,18078,5693847,7992679,13498,4874600,5742161
2016-05-27,2016,240,D,5,3+,16655,5710502,7992679,12041,4886641,5742161
2016-05-28,2016,241,D,5,3+,15669,5726171,7992679,10972,4897613,5742161
2016-05-29,2016,242,D,5,3+,15023,5741194,7992679,10250,4907863,5742161
2016-05-30,2016,243,D,5,3+,14640,5755834,7992679,9823,4917686,5742161
2016-05-31,2016,244,D,5,3+,14321,5770155,7992679,9447,4927133,5742161
2016-06-01,2016,245,D,5,3+,13689,5783844,7992679,6857,4933990,5742161
2016-06-02,2016,246,D,5,3+,13251,5797095,7992679,7173,4941163,5742161
2016-06-03,2016,247,D,5,3+,13095,5810190,7992679,6975,4948138,5742161
2016-06-04,2016,248,D,5,3+,13534,5823724,7992679,7967,4956105,5742161
2016-06-05,2016,249,D,5,3+,14413,5838137,7992679,7489,4963594,5742161
2016-06-06,2016,250,D,5,3+,14795,5852932,7992679,7012,4970606,5742161
2016-06-07,2016,251,D,5,3+,15072,5868004,7992679,6944,4977550,5742161
2016-06-08,2016,252,D,5,3+,15098,5883102,7992679,6731,4984281,5742161
2016-06-09,2016,253,D,5,3+,15154,5898256,7992679,6863,4991144,5742161
2016-06-10,2016,254,D,5,3+,15366,5913622,7992679,6664,4997808,5742161
2016-06-11,2016,255,D,5,3+,15077,5928699,7992679,6396,5004204,5742161
2016-06-12,2016,256,D,5,3+,14459,5943158,7992679,5892,5010096,5742161
2016-06-13,2016,257,D,5,3+,14403,5957561,7992679,6206,5016302,5742161
2016-06-14,2016,258,D,5,3+,14570,5972131,7992679,7488,5023790,5742161
2016-06-15,2016,259,D,5,3+,14651,5986782,7992679,7412,5031202,5742161
2016-06-16,2016,260,D,5,3+,14980,6001762,7992679,7493,5038695,5742161
2016-06-17,2016,261,D,5,3+,14945,6016707,7992679,6554,5045249,5742161
2016-06-18,2016,262,D,5,3+,15219,6031926,7992679,7078,5052327,5742161
2016-06-19,2016,263,D,5,3+,15522,6047448,7992679,7049,5059376,5742161
2016-06-20,2016,264,D,5,3+,16443,6063891,7992679,7796,5067172,5742161
2016-06-21,2016,265,D,5,3+,17452,6081343,7992679,7736,5074908,5742161
2016-06-22,2016,266,D,5,3+,17706,6099049,7992679,6848,5081756,5742161
2016-06-23,2016,267,D,5,3+,17722,6116771,7992679,6915,5088671,5742161
2016-06-24,2016,268,D,5,3+,17510,6134281,7992679,6676,5095347,5742161
2016-06-25,2016,269,D,5,3+,17038,6151319,7992679,6394,5101741,5742161
2016-06-26,2016,270,D,5,3+,16747,6168066,7992679,6746,5108487,5742161
2016-06-27,2016,271,D,5,3+,16644,6184710,7992679,6840,5115327,5742161
2016-06-28,2016,272,D,5,3+,16278,6200988,7992679,6745,5122072,5742161
2016-06-29,2016,273,D,5,3+,16857,6217845,7992679,8109,5130181,5742161
2016-06-30,2016,274,D,5,3+,18274,6236119,7992679,8423,5138604,5742161
2016-07-01,2016,275,D,5,3+,18291,6254410,7992679,6394,5144998,5742161
2016-07-02,2016,276,D,5,3+,18298,6272708,7992679,6015,5151013,5742161
2016-07-03,2016,277,D,5,3+,18429,6291137,7992679,7310,5158323,5742161
2016-07-04,2016,278,D,5,3+,18594,6309731,7992679,6763,5165086,5742161
2016-07-05,2016,279,D,5,3+,18986,6328717,7992679,6880,5171966,5742161
2016-07-06,2016,280,D,5,3+,19351,6348068,7992679,6952,5178918,5742161
2016-07-07,2016,281,D,5,3+,19320,6367388,7992679,6559,5185477,5742161
2016-07-08,2016,282,D,5,3+,19324,6386712,7992679,6560,5192037,5742161
2016-07-09,2016,283,D,5,3+,19231,6405943,7992679,6482,5198519,5742161
2016-07-10,2016,284,D,5,3+,19487,6425430,7992679,6707,5205226,5742161
2016-07-11,2016,285,D,5,3+,19878,6445308,7992679,7187,5212413,5742161
2016-07-12,2016,286,D,5,3+,19898,6465206,7992679,7122,5219535,5742161
2016-07-13,2016,287,D,5,3+,19929,6485135,7992679,6305,5225840,5742161
2016-07-14,2016,288,D,5,3+,19961,6505096,7992679,6334,5232174,5742161
2016-07-15,2016,289,D,5,3+,19709,6524805,7992679,6082,5238256,5742161
2016-07-16,2016,290,D,5,3+,19554,6544359,7992679,9777,5248033,5742161
2016-07-17,2016,291,D,5,3+,19606,6563965,7992679,10016,5258049,5742161
2016-07-18,2016,292,D,5,3+,19947,6583912,7992679,13750,5271799,5742161
2016-07-19,2016,293,D,5,3+,20220,6604132,7992679,14082,5285881,5742161
2016-07-20,2016,294,D,5,3+,20112,6624244,7992679,13010,5298891,5742161
2016-07-21,2016,295,D,5,3+,20204,6644448,7992679,10808,5309699,5742161
2016-07-22,2016,296,D,5,3+,20271,6664719,7992679,8890,5318589,5742161
2016-07-23,2016,297,D,5,3+,20321,6685040,7992679,8943,5327532,5742161
2016-07-24,2016,298,D,5,3+,20497,6705537,7992679,9117,5336649,5742161
2016-07-25,2016,299,D,5,3+,20693,6726230,7992679,8880,5345529,5742161
2016-07-26,2016,300,D,5,3+,20739,6746969,7992679,8252,5353781,5742161
2016-07-27,2016,301,D,5,3+,20628,6767597,7992679,8143,5361924,5742161
2016-07-28,2016,302,D,5,3+,20528,6788125,7992679,8090,5370014,5742161
2016-07-29,2016,303,D,5,3+,20674,6808799,7992679,8241,5378255,5742161
2016-07-30,2016,304,D,5,3+,20777,6829576,7992679,8135,5386390,5742161
2016-07-31,2016,305,D,5,3+,20642,6850218,7992679,8027,5394417,5742161
2016-08-01,2016,306,D,5,3+,20693,6870911,7992679,7421,5401838,5742161
2016-08-02,2016,307,D,5,3+,20673,6891584,7992679,7382,5409220,5742161
2016-08-03,2016,308,D,5,3+,20519,6912103,7992679,7293,5416513,5742161
2016-08-04,2016,309,D,5,3+,20364,6932467,7992679,7112,5423625,5742161
2016-08-05,2016,310,D,5,3+,20614,6953081,7992679,7417,5431042,5742161
2016-08-06,2016,311,D,5,3+,20557,6973638,7992679,8089,5439131,5742161
2016-08-07,2016,312,D,5,3+,20520,6994158,7992679,8090,5447221,5742161
2016-08-08,2016,313,D,5,3+,20704,7014862,7992679,9768,5456989,5742161
2016-08-09,2016,314,D,5,3+,20568,7035430,7992679,8177,5465166,5742161
2016-08-10,2016,315,D,5,3+,20593,7056023,7992679,8195,5473361,5742161
2016-08-11,2016,316,D,5,3+,20824,7076847,7992679,8474,5481835,5742161
2016-08-12,2016,317,D,5,3+,20927,7097774,7992679,8567,5490402,5742161
2016-08-13,2016,318,D,5,3+,21036,7118810,7992679,8059,5498461,5742161
2016-08-14,2016,319,D,5,3+,20788,7139598,7992679,7858,5506319,5742161
2016-08-15,2016,320,D,5,3+,20607,7160205,7992679,7670,5513989,5742161
2016-08-16,2016,321,D,5,3+,20410,7180615,7992679,5755,5519744,5742161
2016-08-17,2016,322,D,5,3+,20087,7200702,7992679,5340,5525084,5742161
2016-08-18,2016,323,D,5,3+,19303,7220005,7992679,4661,5529745,5742161
2016-08-19,2016,324,D,5,3+,18782,7238787,7992679,4144,5533889,5742161
2016-08-20,2016,325,D,5,3+,18467,7257254,7992679,3847,5537736,5742161
2016-08-21,2016,326,D,5,3+,18243,7275497,7992679,3645,5541381,5742161
2016-08-22,2016,327,D,5,3+,18348,7293845,7992679,3786,5545167,5742161
2016-08-23,2016,328,D,5,3+,18516,7312361,7992679,3945,5549112,5742161
2016-08-24,2016,329,D,5,3+,18690,7331051,7992679,4077,5553189,5742161
2016-08-25,2016,330,D,5,3+,18799,7349850,7992679,4164,5557353,5742161
2016-08-26,2016,331,D,5,3+,18870,7368720,7992679,4286,5561639,5742161
2016-08-27,2016,332,D,5,3+,19159,7387879,7992679,4623,5566262,5742161
2016-08-28,2016,333,D,5,3+,19425,7407304,7992679,4923,5571185,5742161
2016-08-29,2016,334,D,5,3+,19850,7427154,7992679,5382,5576567,5742161
2016-08-30,2016,335,D,5,3+,19818,7446972,7992679,4943,5581510,5742161
2016-08-31,2016,336,D,5,3+,19925,7466897,7992679,4958,5586468,5742161
2016-09-01,2016,337,D,5,3+,20126,7487023,7992679,5127,5591595,5742161
2016-09-02,2016,338,D,5,3+,20155,7507178,7992679,5167,5596762,5742161
2016-09-03,2016,339,D,5,3+,19976,7527154,7992679,5062,5601824,5742161
2016-09-04,2016,340,D,5,3+,19736,7546890,7992679,4833,5606657,5742161
2016-09-05,2016,341,D,5,3+,19652,7566542,7992679,4826,5611483,5742161
2016-09-06,2016,342,D,5,3+,19420,7585962,7992679,4636,5616119,5742161
2016-09-07,2016,343,D,5,3+,19211,7605173,7992679,4469,5620588,5742161
2016-09-08,2016,344,D,5,3+,19319,7624492,7992679,4625,5625213,5742161
2016-09-09,2016,345,D,5,3+,19426,7643918,7992679,6512,5631725,5742161
2016-09-10,2016,346,D,5,3+,19079,7662997,7992679,7503,5639228,5742161
2016-09-11,2016,347,D,5,3+,18682,7681679,7992679,7179,5646407,5742161
2016-09-12,2016,348,D,5,3+,18538,7700217,7992679,7090,5653497,5742161
2016-09-13,2016,349,D,5,3+,18550,7718767,7992679,8166,5661663,5742161
2016-09-14,2016,350,D,5,3+,18324,7737091,7992679,8507,5670170,5742161
2016-09-15,2016,351,D,5,3+,17950,7755041,7992679,7181,5677351,5742161
2016-09-16,2016,352,D,5,3+,17851,7772892,7992679,6064,5683415,5742161
2016-09-17,2016,353,D,5,3+,17631,7790523,7992679,5399,5688814,5742161
2016-09-18,2016,354,D,5,3+,17296,7807819,7992679,5124,5693938,5742161
2016-09-19,2016,355,D,5,3+,16948,7824767,7992679,4308,5698246,5742161
2016-09-20,2016,356,D,5,3+,16461,7841228,7992679,3825,5702071,5742161
2016-09-21,2016,357,D,5,3+,16144,7857372,7992679,3511,5705582,5742161
2016-09-22,2016,358,D,5,3+,16376,7873748,7992679,4265,5709847,5742161
2016-09-23,2016,359,D,5,3+,16179,7889927,7992679,4274,5714121,5742161
2016-09-24,2016,360,D,5,3+,15789,7905716,7992679,3954,5718075,5742161
2016-09-25,2016,361,D,5,3+,15208,7920924,7992679,3427,5721502,5742161
2016-09-26,2016,362,D,5,3+,14868,7935792,7992679,3581,5725083,5742161
2016-09-27,2016,363,D,5,3+,14623,7950415,7992679,4320,5729403,5742161
2016-09-28,2016,364,D,5,3+,14190,7964605,7992679,3911,5733314,5742161
2016-09-29,2016,365,D,5,3+,14068,7978673,7992679,4526,5737840,5742161
2016-09-30,2016,366,D,5,3+,14006,7992679,7992679,4321,5742161,5742161
2016-10-01,2017,1,N,1,1,14180,14180,27980567,4749,4749,24519132
2016-10-02,2017,2,N,1,1,14186,28366,27980567,4895,9644,24519132
2016-10-03,2017,3,N,1,1,14447,42813,27980567,5270,14914,24519132
2016-10-04,2017,4,N,1,1,14474,57287,27980567,5193,20107,24519132
2016-10-05,2017,5,N,1,1,14094,71381,27980567,4953,25060,24519132
2016-10-06,2017,6,N,1,1,13700,85081,27980567,4604,29664,24519132
2016-10-07,2017,7,N,1,1,13280,98361,27980567,4182,33846,24519132
2016-10-08,2017,8,N,1,1,12861,111222,27980567,3753,37599,24519132
2016-10-09,2017,9,N,1,1,12574,123796,27980567,3473,41072,24519132
2016-10-10,2017,10,N,1,1,12529,136325,27980567,3980,45052,24519132
2016-10-11,2017,11,N,1,1,12538,148863,27980567,4474,49526,24519132
2016-10-12,2017,12,N,1,1,12737,161600,27980567,4658,54184,24519132
2016-10-13,2017,13,N,1,1,12085,173685,27980567,4569,58753,24519132
2016-10-14,2017,14,N,1,1,11687,185372,27980567,8077,66830,24519132
2016-10-15,2017,15,N,1,1,11581,196953,27980567,8891,75721,24519132
2016-10-16,2017,16,N,1,1,12965,209918,27980567,17146,92867,24519132
2016-10-17,2017,17,N,1,1,14632,224550,27980567,18813,111680,24519132
2016-10-18,2017,18,N,1,1,14504,239054,27980567,18741,130421,24519132
2016-10-19,2017,19,N,1,1,13778,252832,27980567,14359,144780,24519132
2016-10-20,2017,20,N,1,1,13070,265902,27980567,11488,156268,24519132
2016-10-21,2017,21,N,1,1,12014,277916,27980567,3528,159796,24519132
2016-10-22,2017,22,N,1,1,11573,289489,27980567,2808,162604,24519132
2016-10-23,2017,23,N,1,1,11364,300853,27980567,2588,165192,24519132
2016-10-24,2017,24,N,1,1,11339,312192,27980567,3028,168220,24519132
2016-10-25,2017,25,N,1,1,11496,323688,27980567,3408,171628,24519132
2016-10-26,2017,26,N,1,1,12029,335717,27980567,3952,175580,24519132
2016-10-27,2017,27,N,1,1,13178,348895,27980567,7159,182739,24519132
2016-10-28,2017,28,N,1,1,15729,364624,27980567,11602,194341,24519132
2016-10-29,2017,29,N,1,1,16987,381611,27980567,12927,207268,24519132
2016-10-30,2017,30,N,1,1,17670,399281,27980567,14073,221341,24519132
2016-10-31,2017,31,N,1,1,18828,418109,27980567,14722,236063,24519132
2016-11-01,2017,32,N,1,1,18819,436928,27980567,12919,248982,24519132
2016-11-02,2017,33,N,1,1,19520,456448,27980567,9543,258525,24519132
2016-11-03,2017,34,N,1,1,20470,476918,27980567,9951,268476,24519132
2016-11-04,2017,35,N,1,1,20481,497399,27980567,8905,277381,24519132
2016-11-05,2017,36,N,1,1,19183,516582,27980567,7331,284712,24519132
2016-11-06,2017,37,N,1,1,17424,534006,27980567,4771,289483,24519132
2016-11-07,2017,38,N,1,1,15772,549778,27980567,3014,292497,24519132
2016-11-08,2017,39,N,1,1,14413,564191,27980567,2370,294867,24519132
2016-11-09,2017,40,N,1,1,14214,578405,27980567,4180,299047,24519132
2016-11-10,2017,41,N,1,1,13630,592035,27980567,4511,303558,24519132
2016-11-11,2017,42,N,1,1,12873,604908,27980567,4511,308069,24519132
2016-11-12,2017,43,N,1,1,12510,617418,27980567,5158,313227,24519132
2016-11-13,2017,44,N,1,1,12491,629909,27980567,6713,319940,24519132
2016-11-14,2017,45,N,1,1,12329,642238,27980567,6547,326487,24519132
2016-11-15,2017,46,N,1,1,12106,654344,27980567,6811,333298,24519132
2016-11-16,2017,47,N,1,1,12740,667084,27980567,7432,340730,24519132
2016-11-17,2017,48,N,1,1,12707,679791,27980567,7426,348156,24519132
2016-11-18,2017,49,N,1,1,12247,692038,27980567,6937,355093,24519132
2016-11-19,2017,50,N,1,1,12258,704296,27980567,7640,362733,24519132
2016-11-20,2017,51,N,1,1,13723,718019,27980567,11094,373827,24519132
2016-11-21,2017,52,N,1,1,16178,734197,27980567,13043,386870,24519132
2016-11-22,2017,53,N,1,1,20693,754890,27980567,14966,401836,24519132
2016-11-23,2017,54,N,1,1,23532,778422,27980567,15819,417655,24519132
2016-11-24,2017,55,N,1,1,22662,801084,27980567,14283,431938,24519132
2016-11-25,2017,56,N,1,1,20776,821860,27980567,10293,442231,24519132
2016-11-26,2017,57,N,1,1,19473,841333,27980567,10118,452349,24519132
2016-11-27,2017,58,N,1,1,19801,861134,27980567,10243,462592,24519132
2016-11-28,2017,59,N,1,1,20201,881335,27980567,10138,472730,24519132
2016-11-29,2017,60,N,1,1,21494,902829,27980567,11422,484152,24519132
2016-11-30,2017,61,N,1,1,22125,924954,27980567,11980,496132,24519132
2016-12-01,2017,62,N,1,1,20731,945685,27980567,9007,505139,24519132
2016-12-02,2017,63,N,1,1,19308,964993,27980567,6631,511770,24519132
2016-12-03,2017,64,N,1,1,17910,982903,27980567,4990,516760,24519132
2016-12-04,2017,65,N,1,1,16875,999778,27980567,3930,520690,24519132
2016-12-05,2017,66,N,1,1,16123,1015901,27980567,3132,523822,24519132
2016-12-06,2017,67,N,1,1,15472,1031373,27980567,4084,527906,24519132
2016-12-07,2017,68,N,1,1,15625,1046998,27980567,5830,533736,24519132
2016-12-08,2017,69,N,1,1,15532,1062530,27980567,6429,540165,24519132
2016-12-09,2017,70,N,1,1,15775,1078305,27980567,7253,547418,24519132
2016-12-10,2017,71,N,1,1,19781,1098086,27980567,9891,557309,24519132
2016-12-11,2017,72,N,1,1,33141,1131227,27980567,23497,580806,24519132
2016-12-12,2017,73,N,1,1,42621,1173848,27980567,31361,612167,24519132
2016-12-13,2017,74,N,1,1,45505,1219353,27980567,33804,645971,24519132
2016-12-14,2017,75,N,1,1,46916,1266269,27980567,34288,680259,24519132
2016-12-15,2017,76,N,1,1,55834,1322103,27980567,44627,724886,24519132
2016-12-16,2017,77,N,1,1,77369,1399472,27980567,67416,792302,24519132
2016-12-17,2017,78,N,1,1,84615,1484087,27980567,75679,867981,24519132
2016-12-18,2017,79,N,1,1,98315,1582402,27980567,89611,957592,24519132
2016-12-19,2017,80,N,1,1,103721,1686123,27980567,95120,1052712,24519132
2016-12-20,2017,81,N,1,1,89828,1775951,27980567,80772,1133484,24519132
2016-12-21,2017,82,N,1,1,77610,1853561,27980567,68410,1201894,24519132
2016-12-22,2017,83,N,1,1,69114,1922675,27980567,59923,1261817,24519132
2016-12-23,2017,84,N,1,1,60786,1983461,27980567,54863,1316680,24519132
2016-12-24,2017,85,N,1,1,53700,2037161,27980567,47777,1364457,24519132
2016-12-25,2017,86,N,1,1,49615,2086776,27980567,43724,1408181,24519132
2016-12-26,2017,87,N,1,1,47733,2134509,27980567,41868,1450049,24519132
2016-12-27,2017,88,N,1,1,44710,2179219,27980567,38698,1488747,24519132
2016-12-28,2017,89,N,1,1,40545,2219764,27980567,30871,1519618,24519132
2016-12-29,2017,90,N,1,1,36979,2256743,27980567,27427,1547045,24519132
2016-12-30,2017,91,N,1,1,33551,2290294,27980567,24079,1571124,24519132
2016-12-31,2017,92,N,1,1,30442,2320736,27980567,21244,1592368,24519132
2017-01-01,2017,93,N,1,1,28271,2349007,27980567,21077,1613445,24519132
2017-01-02,2017,94,N,1,1,25914,2374921,27980567,19011,1632456,24519132
2017-01-03,2017,95,N,1,1,24503,2399424,27980567,19274,1651730,24519132
2017-01-04,2017,96,N,1,1,30856,2430280,27980567,25657,1677387,24519132
2017-01-05,2017,97,N,1,1,47426,2477706,27980567,42285,1719672,24519132
2017-01-06,2017,98,N,1,1,64203,2541909,27980567,57647,1777319,24519132
2017-01-07,2017,99,N,1,1,77304,2619213,27980567,72749,1850068,24519132
2017-01-08,2017,100,N,1,1,96922,2716135,27980567,93957,1944025,24519132
2017-01-09,2017,101,N,1,1,137038,2853173,27980567,134579,2078604,24519132
2017-01-10,2017,102,N,1,1,210832,3064005,27980567,212791,2291395,24519132
2017-01-11,2017,103,N,1,1,301371,3365376,27980567,306201,2597596,24519132
2017-01-12,2017,104,N,1,1,301906,3667282,27980567,302679,2900275,24519132
2017-01-13,2017,105,N,1,1,259417,3926699,27980567,254534,3154809,24519132
2017-01-14,2017,106,N,1,1,229272,4155971,27980567,222769,3377578,24519132
2017-01-15,2017,107,N,1,1,210694,4366665,27980567,199771,3577349,24519132
2017-01-16,2017,108,N,1,1,196365,4563030,27980567,182535,3759884,24519132
2017-01-17,2017,109,N,1,1,173763,4736793,27980567,158660,3918544,24519132
2017-01-18,2017,110,N,1,1,156556,4893349,27980567,146630,4065174,24519132
2017-01-19,2017,111,N,1,1,161690,5055039,27980567,151751,4216925,24519132
2017-01-20,2017,112,N,1,1,169479,5224518,27980567,164588,4381513,24519132
2017-01-21,2017,113,N,1,1,185153,5409671,27980567,182382,4563895,24519132
2017-01-22,2017,114,N,1,1,191539,5601210,27980567,193265,4757160,24519132
2017-01-23,2017,115,N,1,1,203056,5804266,27980567,200317,4957477,24519132
2017-01-24,2017,116,N,1,1,193655,5997921,27980567,190698,5148175,24519132
2017-01-25,2017,117,N,1,1,185345,6183266,27980567,177343,5325518,24519132
2017-01-26,2017,118,N,1,1,169691,6352957,27980567,160339,5485857,24519132
2017-01-27,2017,119,N,1,1,152161,6505118,27980567,138278,5624135,24519132
2017-01-28,2017,120,N,1,1,136346,6641464,27980567,120860,5744995,24519132
2017-01-29,2017,121,N,1,1,126272,6767736,27980567,110782,5855777,24519132
2017-01-30,2017,122,N,1,1,118197,6885933,27980567,102683,5958460,24519132
2017-01-31,2017,123,N,1,1,111783,6997716,27980567,96310,6054770,24519132
2017-02-01,2017,124,N,1,1,109695,7107411,27980567,94624,6149394,24519132
2017-02-02,2017,125,N,1,1,111385,7218796,27980567,97314,6246708,24519132
2017-02-03,2017,126,N,1,1,113836,7332632,27980567,103423,6350131,24519132
2017-02-04,2017,127,N,1,1,125858,7458490,27980567,115833,6465964,24519132
2017-02-05,2017,128,N,1,1,144893,7603383,27980567,134954,6600918,24519132
2017-02-06,2017,129,N,1,1,163260,7766643,27980567,158554,6759472,24519132
2017-02-07,2017,130,N,1,1,212639,7979282,27980567,209980,6969452,24519132
2017-02-08,2017,131,N,1,1,277192,8256474,27980567,272694,7242146,24519132
2017-02-09,2017,132,N,1,1,297014,8553488,27980567,295248,7537394,24519132
2017-02-10,2017,133,N,1,1,365223,8918711,27980567,366479,7903873,24519132
2017-02-11,2017,134,N,1,1,378580,9297291,27980567,374553,8278426,24519132
2017-02-12,2017,135,N,1,1,364884,9662175,27980567,357409,8635835,24519132
2017-02-13,2017,136,N,1,1,328088,9990263,27980567,318962,8954797,24519132
2017-02-14,2017,137,N,1,1,316599,10306862,27980567,304919,9259716,24519132
2017-02-15,2017,138,N,1,1,325788,10632650,27980567,311582,9571298,24519132
2017-02-16,2017,139,N,1,1,320052,10952702,27980567,306770,9878068,24519132
2017-02-17,2017,140,N,1,1,324358,11277060,27980567,314226,10192294,24519132
2017-02-18,2017,141,N,1,1,332678,11609738,27980567,325751,10518045,24519132
2017-02-19,2017,142,N,1,1,319504,11929242,27980567,313292,10831337,24519132
2017-02-20,2017,143,N,1,1,311047,12240289,27980567,313348,11144685,24519132
2017-02-21,2017,144,N,1,1,364489,12604778,27980567,369202,11513887,24519132
2017-02-22,2017,145,N,1,1,367755,12972533,27980567,371737,11885624,24519132
2017-02-23,2017,146,N,1,1,333499,13306032,27980567,337352,12222976,24519132
2017-02-24,2017,147,N,1,1,306502,13612534,27980567,309775,12532751,24519132
2017-02-25,2017,148,N,1,1,285336,13897870,27980567,280079,12812830,24519132
2017-02-26,2017,149,N,1,1,275153,14173023,27980567,267121,13079951,24519132
2017-02-27,2017,150,N,1,1,269381,14442404,27980567,260913,13340864,24519132
2017-02-28,2017,151,N,1,1,254701,14697105,27980567,245975,13586839,24519132
2017-03-01,2017,152,N,1,1,210753,14907858,27980567,202136,13788975,24519132
2017-03-02,2017,153,N,1,1,190416,15098274,27980567,182073,13971048,24519132
2017-03-03,2017,154,N,1,1,176172,15274446,27980567,168699,14139747,24519132
2017-03-04,2017,155,N,1,1,168105,15442551,27980567,161863,14301610,24519132
2017-03-05,2017,156,N,1,1,160920,15603471,27980567,155940,14457550,24519132
2017-03-06,2017,157,N,1,1,148709,15752180,27980567,143976,14601526,24519132
2017-03-07,2017,158,N,1,1,137817,15889997,27980567,132887,14734413,24519132
2017-03-08,2017,159,N,1,1,129166,16019163,27980567,124165,14858578,24519132
2017-03-09,2017,160,N,1,1,122246,16141409,27980567,117314,14975892,24519132
2017-03-10,2017,161,N,1,1,115050,16256459,27980567,108877,15084769,24519132
2017-03-11,2017,162,N,1,1,110682,16367141,27980567,104227,15188996,24519132
2017-03-12,2017,163,N,1,1,107393,16474534,27980567,100938,15289934,24519132
2017-03-13,2017,164,N,1,1,105221,16579755,27980567,98252,15388186,24519132
2017-03-14,2017,165,N,1,1,102949,16682704,27980567,95005,15483191,24519132
2017-03-15,2017,166,N,1,1,100369,16783073,27980567,95926,15579117,24519132
2017-03-16,2017,167,N,1,1,96709,16879782,27980567,92495,15671612,24519132
2017-03-17,2017,168,N,1,1,93568,16973350,27980567,88471,15760083,24519132
2017-03-18,2017,169,N,1,1,94365,17067715,27980567,89286,15849369,24519132
2017-03-19,2017,170,N,1,1,99776,17167491,27980567,94639,15944008,24519132
2017-03-20,2017,171,N,1,1,106282,17273773,27980567,102957,16046965,24519132
2017-03-21,2017,172,N,1,1,117487,17391260,27980567,117298,16164263,24519132
2017-03-22,2017,173,N,1,1,128913,17520173,27980567,132534,16296797,24519132
2017-03-23,2017,174,N,1,1,135805,17655978,27980567,139404,16436201,24519132
2017-03-24,2017,175,N,1,1,135171,17791149,27980567,139869,16576070,24519132
2017-03-25,2017,176,N,1,1,133231,17924380,27980567,136092,16712162,24519132
2017-03-26,2017,177,N,1,1,134537,18058917,27980567,134363,16846525,24519132
2017-03-27,2017,178,N,1,1,135255,18194172,27980567,131167,16977692,24519132
2017-03-28,2017,179,N,1,1,134161,18328333,27980567,130063,17107755,24519132
2017-03-29,2017,180,N,1,1,128507,18456840,27980567,123231,17230986,24519132
2017-03-30,2017,181,N,1,1,115598,18572438,27980567,110317,17341303,24519132
2017-03-31,2017,182,N,1,1,105592,18678030,27980567,100033,17441336,24519132
2017-04-01,2017,183,N,1,1,100682,18778712,27980567,94978,17536314,24519132
2017-04-02,2017,184,N,1,1,95508,18874220,27980567,89806,17626120,24519132
2017-04-03,2017,185,N,1,1,90409,18964629,27980567,84695,17710815,24519132
2017-04-04,2017,186,N,1,1,86612,19051241,27980567,80859,17791674,24519132
2017-04-05,2017,187,N,1,1,82660,19133901,27980567,76877,17868551,24519132
2017-04-06,2017,188,N,1,1,80255,19214156,27980567,76794,17945345,24519132
2017-04-07,2017,189,N,1,1,83098,19297254,27980567,81452,18026797,24519132
2017-04-08,2017,190,N,1,1,90554,19387808,27980567,90701,18117498,24519132
2017-04-09,2017,191,N,1,1,98368,19486176,27980567,98519,18216017,24519132
2017-04-10,2017,192,N,1,1,105836,19592012,27980567,105987,18322004,24519132
2017-04-11,2017,193,N,1,1,105284,19697296,27980567,103147,18425151,24519132
2017-04-12,2017,194,N,1,1,102362,19799658,27980567,98364,18523515,24519132
2017-04-13,2017,195,N,1,1,102284,19901942,27980567,97086,18620601,24519132
2017-04-14,2017,196,N,1,1,101977,20003919,27980567,96796,18717397,24519132
2017-04-15,2017,197,N,1,1,107199,20111118,27980567,102031,18819428,24519132
2017-04-16,2017,198,N,1,1,119273,20230391,27980567,115703,18935131,24519132
2017-04-17,2017,199,N,1,1,124110,20354501,27980567,119450,19054581,24519132
2017-04-18,2017,200,N,1,1,127529,20482030,27980567,123270,19177851,24519132
2017-04-19,2017,201,N,1,1,130473,20612503,27980567,126196,19304047,24519132
2017-04-20,2017,202,N,1,1,133007,20745510,27980567,128432,19432479,24519132
2017-04-21,2017,203,N,1,1,134165,20879675,27980567,127653,19560132,24519132
2017-04-22,2017,204,N,1,1,134251,21013926,27980567,126925,19687057,24519132
2017-04-23,2017,205,N,1,1,133569,21147495,27980567,124892,19811949,24519132
2017-04-24,2017,206,N,1,1,132701,21280196,27980567,124252,19936201,24519132
2017-04-25,2017,207,N,1,1,131852,21412048,27980567,123152,20059353,24519132
2017-04-26,2017,208,N,1,1,131047,21543095,27980567,122021,20181374,24519132
2017-04-27,2017,209,N,1,1,129366,21672461,27980567,120013,20301387,24519132
2017-04-28,2017,210,N,1,1,128560,21801021,27980567,117532,20418919,24519132
2017-04-29,2017,211,N,1,1,128440,21929461,27980567,117414,20536333,24519132
2017-04-30,2017,212,N,1,1,125950,22055411,27980567,114927,20651260,24519132
2017-05-01,2017,213,N,1,1,119420,22174831,27980567,110221,20761481,24519132
2017-05-02,2017,214,N,1,1,111297,22286128,27980567,101161,20862642,24519132
2017-05-03,2017,215,N,1,1,102387,22388515,27980567,91997,20954639,24519132
2017-05-04,2017,216,N,1,1,96931,22485446,27980567,86531,21041170,24519132
2017-05-05,2017,217,N,1,1,91425,22576871,27980567,80007,21121177,24519132
2017-05-06,2017,218,N,1,1,85153,22662024,27980567,73735,21194912,24519132
2017-05-07,2017,219,N,1,1,79425,22741449,27980567,67962,21262874,24519132
2017-05-08,2017,220,N,1,1,74042,22815491,27980567,62568,21325442,24519132
2017-05-09,2017,221,N,1,1,69491,22884982,27980567,56933,21382375,24519132
2017-05-10,2017,222,N,1,1,67775,22952757,27980567,55241,21437616,24519132
2017-05-11,2017,223,N,1,1,71267,23024024,27980567,58674,21496290,24519132
2017-05-12,2017,224,N,1,1,76563,23100587,27980567,63929,21560219,24519132
2017-05-13,2017,225,N,1,1,80115,23180702,27980567,67470,21627689,24519132
2017-05-14,2017,226,N,1,1,82034,23262736,27980567,69331,21697020,24519132
2017-05-15,2017,227,N,1,1,82245,23344981,27980567,74575,21771595,24519132
2017-05-16,2017,228,N,1,1,80732,23425713,27980567,73047,21844642,24519132
2017-05-17,2017,229,N,1,1,78097,23503810,27980567,70323,21914965,24519132
2017-05-18,2017,230,N,1,1,75600,23579410,27980567,67838,21982803,24519132
2017-05-19,2017,231,N,1,1,73644,23653054,27980567,65915,22048718,24519132
2017-05-20,2017,232,N,1,1,70409,23723463,27980567,62812,22111530,24519132
2017-05-21,2017,233,N,1,1,65938,23789401,27980567,58530,22170060,24519132
2017-05-22,2017,234,N,1,1,63048,23852449,27980567,55739,22225799,24519132
2017-05-23,2017,235,N,1,1,61231,23913680,27980567,53980,22279779,24519132
2017-05-24,2017,236,N,1,1,59743,23973423,27980567,52703,22332482,24519132
2017-05-25,2017,237,N,1,1,58591,24032014,27980567,51799,22384281,24519132
2017-05-26,2017,238,N,1,1,57258,24089272,27980567,50518,22434799,24519132
2017-05-27,2017,239,N,1,1,55392,24144664,27980567,48751,22483550,24519132
2017-05-28,2017,240,N,1,1,53984,24198648,27980567,47381,22530931,24519132
2017-05-29,2017,241,N,1,1,53397,24252045,27980567,46802,22577733,24519132
2017-05-30,2017,242,N,1,1,53296,24305341,27980567,46441,22624174,24519132
2017-05-31,2017,243,N,1,1,53477,24358818,27980567,46715,22670889,24519132
2017-06-01,2017,244,N,1,1,53350,24412168,27980567,39558,22710447,24519132
2017-06-02,2017,245,N,1,1,52981,24465149,27980567,39030,22749477,24519132
2017-06-03,2017,246,N,1,1,54282,24519431,27980567,40305,22789782,24519132
2017-06-04,2017,247,N,1,1,56842,24576273,27980567,42646,22832428,24519132
2017-06-05,2017,248,N,1,1,57591,24633864,27980567,43097,22875525,24519132
2017-06-06,2017,249,N,1,1,57615,24691479,27980567,43106,22918631,24519132
2017-06-07,2017,250,N,1,1,56763,24748242,27980567,42230,22960861,24519132
2017-06-08,2017,251,N,1,1,54272,24802514,27980567,39693,23000554,24519132
2017-06-09,2017,252,N,1,1,51550,24854064,27980567,36930,23037484,24519132
2017-06-10,2017,253,N,1,1,48910,24902974,27980567,34240,23071724,24519132
2017-06-11,2017,254,N,1,1,46390,24949364,27980567,32810,23104534,24519132
2017-06-12,2017,255,N,1,1,44707,24994071,27980567,31062,23135596,24519132
2017-06-13,2017,256,N,1,1,42534,25036605,27980567,28827,23164423,24519132
2017-06-14,2017,257,N,1,1,40910,25077515,27980567,27146,23191569,24519132
2017-06-15,2017,258,N,1,1,39673,25117188,27980567,25830,23217399,24519132
2017-06-16,2017,259,N,1,1,38229,25155417,27980567,23188,23240587,24519132
2017-06-17,2017,260,N,1,1,36806,25192223,27980567,21725,23262312,24519132
2017-06-18,2017,261,N,1,1,35824,25228047,27980567,20692,23283004,24519132
2017-06-19,2017,262,N,1,1,35340,25263387,27980567,20139,23303143,24519132
2017-06-20,2017,263,N,1,1,34715,25298102,27980567,19471,23322614,24519132
2017-06-21,2017,264,N,1,1,34505,25332607,27980567,19208,23341822,24519132
2017-06-22,2017,265,N,1,1,34232,25366839,27980567,18851,23360673,24519132
2017-06-23,2017,266,N,1,1,34423,25401262,27980567,19029,23379702,24519132
2017-06-24,2017,267,N,1,1,34525,25435787,27980567,19065,23398767,24519132
2017-06-25,2017,268,N,1,1,34494,25470281,27980567,19005,23417772,24519132
2017-06-26,2017,269,N,1,1,34722,25505003,27980567,19275,23437047,24519132
2017-06-27,2017,270,N,1,1,35262,25540265,27980567,19813,23456860,24519132
2017-06-28,2017,271,N,1,1,35491,25575756,27980567,19999,23476859,24519132
2017-06-29,2017,272,N,1,1,34958,25610714,27980567,19463,23496322,24519132
2017-06-30,2017,273,N,1,1,33721,25644435,27980567,18206,23514528,24519132
2017-07-01,2017,274,N,1,1,32641,25677076,27980567,16639,23531167,24519132
2017-07-02,2017,275,N,1,1,31058,25708134,27980567,15049,23546216,24519132
2017-07-03,2017,276,N,1,1,29563,25737697,27980567,13499,23559715,24519132
2017-07-04,2017,277,N,1,1,28438,25766135,27980567,12370,23572085,24519132
2017-07-05,2017,278,N,1,1,27687,25793822,27980567,11567,23583652,24519132
2017-07-06,2017,279,N,1,1,27079,25820901,27980567,16647,23600299,24519132
2017-07-07,2017,280,N,1,1,26160,25847061,27980567,17160,23617459,24519132
2017-07-08,2017,281,N,1,1,25274,25872335,27980567,13686,23631145,24519132
2017-07-09,2017,282,N,1,1,24619,25896954,27980567,8723,23639868,24519132
2017-07-10,2017,283,N,1,1,24365,25921319,27980567,8298,23648166,24519132
2017-07-11,2017,284,N,1,1,24062,25945381,27980567,8169,23656335,24519132
2017-07-12,2017,285,N,1,1,23237,25968618,27980567,7192,23663527,24519132
2017-07-13,2017,286,N,1,1,22699,25991317,27980567,6846,23670373,24519132
2017-07-14,2017,287,N,1,1,22949,26014266,27980567,6867,23677240,24519132
2017-07-15,2017,288,N,1,1,23555,26037821,27980567,7493,23684733,24519132
2017-07-16,2017,289,N,1,1,23697,26061518,27980567,8118,23692851,24519132
2017-07-17,2017,290,N,1,1,23408,26084926,27980567,7389,23700240,24519132
2017-07-18,2017,291,N,1,1,23068,26107994,27980567,7004,23707244,24519132
2017-07-19,2017,292,N,1,1,22939,26130933,27980567,6973,23714217,24519132
2017-07-20,2017,293,N,1,1,22805,26153738,27980567,6749,23720966,24519132
2017-07-21,2017,294,N,1,1,22949,26176687,27980567,7003,23727969,24519132
2017-07-22,2017,295,N,1,1,23277,26199964,27980567,7191,23735160,24519132
2017-07-23,2017,296,N,1,1,23454,26223418,27980567,8294,23743454,24519132
2017-07-24,2017,297,N,1,1,23920,26247338,27980567,8671,23752125,24519132
2017-07-25,2017,298,N,1,1,24473,26271811,27980567,8919,23761044,24519132
2017-07-26,2017,299,N,1,1,24584,26296395,27980567,8550,23769594,24519132
2017-07-27,2017,300,N,1,1,24446,26320841,27980567,8507,23778101,24519132
2017-07-28,2017,301,N,1,1,24753,26345594,27980567,8738,23786839,24519132
2017-07-29,2017,302,N,1,1,24998,26370592,27980567,8985,23795824,24519132
2017-07-30,2017,303,N,1,1,24981,26395573,27980567,9295,23805119,24519132
2017-07-31,2017,304,N,1,1,24546,26420119,27980567,8597,23813716,24519132
2017-08-01,2017,305,N,1,1,24101,26444220,27980567,8132,23821848,24519132
2017-08-02,2017,306,N,1,1,23947,26468167,27980567,8149,23829997,24519132
2017-08-03,2017,307,N,1,1,24237,26492404,27980567,8294,23838291,24519132
2017-08-04,2017,308,N,1,1,24274,26516678,27980567,8319,23846610,24519132
2017-08-05,2017,309,N,1,1,24017,26540695,27980567,8239,23854849,24519132
2017-08-06,2017,310,N,1,1,24707,26565402,27980567,8857,23863706,24519132
2017-08-07,2017,311,N,1,1,25179,26590581,27980567,9388,23873094,24519132
2017-08-08,2017,312,N,1,1,25055,26615636,27980567,9278,23882372,24519132
2017-08-09,2017,313,N,1,1,25048,26640684,27980567,9302,23891674,24519132
2017-08-10,2017,314,N,1,1,25387,26666071,27980567,9601,23901275,24519132
2017-08-11,2017,315,N,1,1,25662,26691733,27980567,10019,23911294,24519132
2017-08-12,2017,316,N,1,1,25620,26717353,27980567,9885,23921179,24519132
2017-08-13,2017,317,N,1,1,25501,26742854,27980567,10539,23931718,24519132
2017-08-14,2017,318,N,1,1,25472,26768326,27980567,9843,23941561,24519132
2017-08-15,2017,319,N,1,1,25473,26793799,27980567,9839,23951400,24519132
2017-08-16,2017,320,N,1,1,25562,26819361,27980567,9975,23961375,24519132
2017-08-17,2017,321,N,1,1,25701,26845062,27980567,10107,23971482,24519132
2017-08-18,2017,322,N,1,1,25810,26870872,27980567,10282,23981764,24519132
2017-08-19,2017,323,N,1,1,25948,26896820,27980567,10424,23992188,24519132
2017-08-20,2017,324,N,1,1,26149,26922969,27980567,10733,24002921,24519132
2017-08-21,2017,325,N,1,1,26504,26949473,27980567,11013,24013934,24519132
2017-08-22,2017,326,N,1,1,26466,26975939,27980567,11051,24024985,24519132
2017-08-23,2017,327,N,1,1,26554,27002493,27980567,11155,24036140,24519132
2017-08-24,2017,328,N,1,1,26945,27029438,27980567,11578,24047718,24519132
2017-08-25,2017,329,N,1,1,27244,27056682,27980567,11997,24059715,24519132
2017-08-26,2017,330,N,1,1,27369,27084051,27980567,12317,24072032,24519132
2017-08-27,2017,331,N,1,1,27375,27111426,27980567,12104,24084136,24519132
2017-08-28,2017,332,N,1,1,27214,27138640,27980567,11976,24096112,24519132
2017-08-29,2017,333,N,1,1,26924,27165564,27980567,11732,24107844,24519132
2017-08-30,2017,334,N,1,1,26854,27192418,27980567,11731,24119575,24519132
2017-08-31,2017,335,N,1,1,26497,27218915,27980567,11455,24131030,24519132
2017-09-01,2017,336,N,1,1,25879,27244794,27980567,10906,24141936,24519132
2017-09-02,2017,337,N,1,1,25542,27270336,27980567,10556,24152492,24519132
2017-09-03,2017,338,N,1,1,25724,27296060,27980567,12260,24164752,24519132
2017-09-04,2017,339,N,1,1,25946,27322006,27980567,12232,24176984,24519132
2017-09-05,2017,340,N,1,1,26117,27348123,27980567,12455,24189439,24519132
2017-09-06,2017,341,N,1,1,26038,27374161,27980567,12433,24201872,24519132
2017-09-07,2017,342,N,1,1,26225,27400386,27980567,12711,24214583,24519132
2017-09-08,2017,343,N,1,1,26361,27426747,27980567,12832,24227415,24519132
2017-09-09,2017,344,N,1,1,26581,27453328,27980567,13571,24240986,24519132
2017-09-10,2017,345,N,1,1,26865,27480193,27980567,13983,24254969,24519132
2017-09-11,2017,346,N,1,1,26974,27507167,27980567,14042,24269011,24519132
2017-09-12,2017,347,N,1,1,26534,27533701,27980567,13844,24282855,24519132
2017-09-13,2017,348,N,1,1,26021,27559722,27980567,13772,24296627,24519132
2017-09-14,2017,349,N,1,1,26534,27586256,27980567,14678,24311305,24519132
2017-09-15,2017,350,N,1,1,26480,27612736,27980567,14850,24326155,24519132
2017-09-16,2017,351,N,1,1,26119,27638855,27980567,14489,24340644,24519132
2017-09-17,2017,352,N,1,1,25924,27664779,27980567,14355,24354999,24519132
2017-09-18,2017,353,N,1,1,25584,27690363,27980567,14107,24369106,24519132
2017-09-19,2017,354,N,1,1,25289,27715652,27980567,14607,24383713,24519132
2017-09-20,2017,355,N,1,1,24816,27740468,27980567,14143,24397856,24519132
2017-09-21,2017,356,N,1,1,24142,27764610,27980567,13492,24411348,24519132
2017-09-22,2017,357,N,1,1,24224,27788834,27980567,13644,24424992,24519132
2017-09-23,2017,358,N,1,1,24170,27813004,27980567,13581,24438573,24519132
2017-09-24,2017,359,N,1,1,23682,27836686,27980567,13146,24451719,24519132
2017-09-25,2017,360,N,1,1,23572,27860258,27980567,12620,24464339,24519132
2017-09-26,2017,361,N,1,1,23872,27884130,27980567,11992,24476331,24519132
2017-09-27,2017,362,N,1,1,24376,27908506,27980567,11267,24487598,24519132
2017-09-28,2017,363,N,1,1,24505,27933011,27980567,10538,24498136,24519132
2017-09-29,2017,364,N,1,1,24063,27957074,27980567,10639,24508775,24519132
2017-09-30,2017,365,N,1,1,23493,27980567,27980567,10357,24519132,24519132
2017-10-01,2018,1,N,2,2,23127,23127,7788067,9666,9666,4934837
2017-10-02,2018,2,N,2,2,22718,45845,7788067,9359,19025,4934837
2017-10-03,2018,3,N,2,2,22396,68241,7788067,13778,32803,4934837
2017-10-04,2018,4,N,2,2,21738,89979,7788067,15069,47872,4934837
2017-10-05,2018,5,N,2,2,21044,111023,7788067,14162,62034,4934837
2017-10-06,2018,6,N,2,2,19918,130941,7788067,10283,72317,4934837
2017-10-07,2018,7,N,2,2,18611,149552,7788067,9029,81346,4934837
2017-10-08,2018,8,N,2,2,17765,167317,7788067,10159,91505,4934837
2017-10-09,2018,9,N,2,2,17173,184490,7788067,10281,101786,4934837
2017-10-10,2018,10,N,2,2,16930,201420,7788067,10127,111913,4934837
2017-10-11,2018,11,N,2,2,17222,218642,7788067,10435,122348,4934837
2017-10-12,2018,12,N,2,2,16980,235622,7788067,10211,132559,4934837
2017-10-13,2018,13,N,2,2,16698,252320,7788067,9966,142525,4934837
2017-10-14,2018,14,N,2,2,15904,268224,7788067,9194,151719,4934837
2017-10-15,2018,15,N,2,2,15550,283774,7788067,8835,160554,4934837
2017-10-16,2018,16,N,2,2,15360,299134,7788067,8637,169191,4934837
2017-10-17,2018,17,N,2,2,15584,314718,7788067,8874,178065,4934837
2017-10-18,2018,18,N,2,2,15554,330272,7788067,8891,186956,4934837
2017-10-19,2018,19,N,2,2,15718,345990,7788067,9040,195996,4934837
2017-10-20,2018,20,N,2,2,16054,362044,7788067,10514,206510,4934837
2017-10-21,2018,21,N,2,2,15648,377692,7788067,10130,216640,4934837
2017-10-22,2018,22,N,2,2,15501,393193,7788067,9796,226436,4934837
2017-10-23,2018,23,N,2,2,15384,408577,7788067,9217,235653,4934837
2017-10-24,2018,24,N,2,2,15607,424184,7788067,9451,245104,4934837
2017-10-25,2018,25,N,2,2,15858,440042,7788067,8555,253659,4934837
2017-10-26,2018,26,N,2,2,15660,455702,7788067,7339,260998,4934837
2017-10-27,2018,27,N,2,2,14989,470691,7788067,6169,267167,4934837
2017-10-28,2018,28,N,2,2,14332,485023,7788067,5487,272654,4934837
2017-10-29,2018,29,N,2,2,14067,499090,7788067,5257,277911,4934837
2017-10-30,2018,30,N,2,2,13905,512995,7788067,5690,283601,4934837
2017-10-31,2018,31,N,2,2,14106,527101,7788067,5957,289558,4934837
2017-11-01,2018,32,N,2,2,14437,541538,7788067,7817,297375,4934837
2017-11-02,2018,33,N,2,2,14519,556057,7788067,8390,305765,4934837
2017-11-03,2018,34,N,2,2,14101,570158,7788067,7959,313724,4934837
2017-11-04,2018,35,N,2,2,14093,584251,7788067,7987,321711,4934837
2017-11-05,2018,36,N,2,2,14757,599008,7788067,8642,330353,4934837
2017-11-06,2018,37,N,2,2,15172,614180,7788067,9162,339515,4934837
2017-11-07,2018,38,N,2,2,15394,629574,7788067,9388,348903,4934837
2017-11-08,2018,39,N,2,2,14832,644406,7788067,9032,357935,4934837
2017-11-09,2018,40,N,2,2,14557,658963,7788067,8398,366333,4934837
2017-11-10,2018,41,N,2,2,14832,673795,7788067,8357,374690,4934837
2017-11-11,2018,42,N,2,2,15204,688999,7788067,8737,383427,4934837
2017-11-12,2018,43,N,2,2,15164,704163,7788067,8701,392128,4934837
2017-11-13,2018,44,N,2,2,14774,718937,7788067,8773,400901,4934837
2017-11-14,2018,45,N,2,2,14645,733582,7788067,8454,409355,4934837
2017-11-15,2018,46,N,2,2,14233,747815,7788067,6939,416294,4934837
2017-11-16,2018,47,N,2,2,15781,763596,7788067,12234,428528,4934837
2017-11-17,2018,48,N,2,2,19276,782872,7788067,12722,441250,4934837
2017-11-18,2018,49,N,2,2,22002,804874,7788067,14980,456230,4934837
2017-11-19,2018,50,N,2,2,22932,827806,7788067,15306,471536,4934837
2017-11-20,2018,51,N,2,2,20729,848535,7788067,12711,484247,4934837
2017-11-21,2018,52,N,2,2,18964,867499,7788067,6138,490385,4934837
2017-11-22,2018,53,N,2,2,17830,885329,7788067,5018,495403,4934837
2017-11-23,2018,54,N,2,2,18888,904217,7788067,6058,501461,4934837
2017-11-24,2018,55,N,2,2,20175,924392,7788067,7343,508804,4934837
2017-11-25,2018,56,N,2,2,20004,944396,7788067,7120,515924,4934837
2017-11-26,2018,57,N,2,2,19434,963830,7788067,7202,523126,4934837
2017-11-27,2018,58,N,2,2,19648,983478,7788067,9197,532323,4934837
2017-11-28,2018,59,N,2,2,20377,1003855,7788067,9011,541334,4934837
2017-11-29,2018,60,N,2,2,21256,1025111,7788067,9878,551212,4934837
2017-11-30,2018,61,N,2,2,21162,1046273,7788067,9737,560949,4934837
2017-12-01,2018,62,N,2,2,20553,1066826,7788067,9078,570027,4934837
2017-12-02,2018,63,N,2,2,20030,1086856,7788067,6916,576943,4934837
2017-12-03,2018,64,N,2,2,19704,1106560,7788067,6629,583572,4934837
2017-12-04,2018,65,N,2,2,19481,1126041,7788067,6338,589910,4934837
2017-12-05,2018,66,N,2,2,19162,1145203,7788067,5971,595881,4934837
2017-12-06,2018,67,N,2,2,18777,1163980,7788067,5596,601477,4934837
2017-12-07,2018,68,N,2,2,18822,1182802,7788067,5550,607027,4934837
2017-12-08,2018,69,N,2,2,18245,1201047,7788067,6084,613111,4934837
2017-12-09,2018,70,N,2,2,18074,1219121,7788067,5949,619060,4934837
2017-12-10,2018,71,N,2,2,17756,1236877,7788067,5609,624669,4934837
2017-12-11,2018,72,N,2,2,17758,1254635,7788067,5664,630333,4934837
2017-12-12,2018,73,N,2,2,17260,1271895,7788067,6162,636495,4934837
2017-12-13,2018,74,N,2,2,16727,1288622,7788067,6628,643123,4934837
2017-12-14,2018,75,N,2,2,16573,1305195,7788067,6497,649620,4934837
2017-12-15,2018,76,N,2,2,16475,1321670,7788067,6404,656024,4934837
2017-12-16,2018,77,N,2,2,16735,1338405,7788067,7161,663185,4934837
2017-12-17,2018,78,N,2,2,16547,1354952,7788067,6992,670177,4934837
2017-12-18,2018,79,N,2,2,16319,1371271,7788067,6773,676950,4934837
2017-12-19,2018,80,N,2,2,16148,1387419,7788067,6624,683574,4934837
2017-12-20,2018,81,N,2,2,16240,1403659,7788067,6953,690527,4934837
2017-12-21,2018,82,N,2,2,16435,1420094,7788067,7155,697682,4934837
2017-12-22,2018,83,N,2,2,16433,1436527,7788067,7672,705354,4934837
2017-12-23,2018,84,N,2,2,16233,1452760,7788067,7565,712919,4934837
2017-12-24,2018,85,N,2,2,15937,1468697,7788067,7971,720890,4934837
2017-12-25,2018,86,N,2,2,15848,1484545,7788067,7708,728598,4934837
2017-12-26,2018,87,N,2,2,15848,1500393,7788067,7658,736256,4934837
2017-12-27,2018,88,N,2,2,16112,1516505,7788067,7954,744210,4934837
2017-12-28,2018,89,N,2,2,16645,1533150,7788067,8497,752707,4934837
2017-12-29,2018,90,N,2,2,16387,1549537,7788067,6787,759494,4934837
2017-12-30,2018,91,N,2,2,16431,1565968,7788067,6854,766348,4934837
2017-12-31,2018,92,N,2,2,16210,1582178,7788067,6676,773024,4934837
2018-01-01,2018,93,N,2,2,16431,1598609,7788067,8015,781039,4934837
2018-01-02,2018,94,N,2,2,16034,1614643,7788067,7676,788715,4934837
2018-01-03,2018,95,N,2,2,15740,1630383,7788067,9269,797984,4934837
2018-01-04,2018,96,N,2,2,15369,1645752,7788067,9829,807813,4934837
2018-01-05,2018,97,N,2,2,15212,1660964,7788067,9954,817767,4934837
2018-01-06,2018,98,N,2,2,15338,1676302,7788067,10909,828676,4934837
2018-01-07,2018,99,N,2,2,15473,1691775,7788067,11090,839766,4934837
2018-01-08,2018,100,N,2,2,17334,1709109,7788067,19366,859132,4934837
2018-01-09,2018,101,N,2,2,24202,1733311,7788067,31000,890132,4934837
2018-01-10,2018,102,N,2,2,29204,1762515,7788067,35730,925862,4934837
2018-01-11,2018,103,N,2,2,31071,1793586,7788067,36943,962805,4934837
2018-01-12,2018,104,N,2,2,29717,1823303,7788067,35549,998354,4934837
2018-01-13,2018,105,N,2,2,27160,1850463,7788067,24836,1023190,4934837
2018-01-14,2018,106,N,2,2,24398,1874861,7788067,16626,1039816,4934837
2018-01-15,2018,107,N,2,2,22758,1897619,7788067,14974,1054790,4934837
2018-01-16,2018,108,N,2,2,21406,1919025,7788067,13577,1068367,4934837
2018-01-17,2018,109,N,2,2,20659,1939684,7788067,12829,1081196,4934837
2018-01-18,2018,110,N,2,2,19758,1959442,7788067,13371,1094567,4934837
2018-01-19,2018,111,N,2,2,19653,1979095,7788067,13266,1107833,4934837
2018-01-20,2018,112,N,2,2,19945,1999040,7788067,13672,1121505,4934837
2018-01-21,2018,113,N,2,2,21308,2020348,7788067,15192,1136697,4934837
2018-01-22,2018,114,N,2,2,21664,2042012,7788067,16237,1152934,4934837
2018-01-23,2018,115,N,2,2,21241,2063253,7788067,14395,1167329,4934837
2018-01-24,2018,116,N,2,2,21470,2084723,7788067,16414,1183743,4934837
2018-01-25,2018,117,N,2,2,22700,2107423,7788067,17885,1201628,4934837
2018-01-26,2018,118,N,2,2,22964,2130387,7788067,18168,1219796,4934837
2018-01-27,2018,119,N,2,2,23869,2154256,7788067,18558,1238354,4934837
2018-01-28,2018,120,N,2,2,23935,2178191,7788067,18680,1257034,4934837
2018-01-29,2018,121,N,2,2,22584,2200775,7788067,15593,1272627,4934837
2018-01-30,2018,122,N,2,2,21183,2221958,7788067,13954,1286581,4934837
2018-01-31,2018,123,N,2,2,20352,2242310,7788067,13195,1299776,4934837
2018-02-01,2018,124,N,2,2,20039,2262349,7788067,12903,1312679,4934837
2018-02-02,2018,125,N,2,2,19535,2281884,7788067,12427,1325106,4934837
2018-02-03,2018,126,N,2,2,19196,2301080,7788067,12064,1337170,4934837
2018-02-04,2018,127,N,2,2,18620,2319700,7788067,11456,1348626,4934837
2018-02-05,2018,128,N,2,2,18211,2337911,7788067,11062,1359688,4934837
2018-02-06,2018,129,N,2,2,18032,2355943,7788067,10840,1370528,4934837
2018-02-07,2018,130,N,2,2,17950,2373893,7788067,10763,1381291,4934837
2018-02-08,2018,131,N,2,2,17686,2391579,7788067,10540,1391831,4934837
2018-02-09,2018,132,N,2,2,17159,2408738,7788067,9997,1401828,4934837
2018-02-10,2018,133,N,2,2,16995,2425733,7788067,9847,1411675,4934837
2018-02-11,2018,134,N,2,2,16534,2442267,7788067,9388,1421063,4934837
2018-02-12,2018,135,N,2,2,16563,2458830,7788067,10867,1431930,4934837
2018-02-13,2018,136,N,2,2,16186,2475016,7788067,14319,1446249,4934837
2018-02-14,2018,137,N,2,2,15971,2490987,7788067,11695,1457944,4934837
2018-02-15,2018,138,N,2,2,16076,2507063,7788067,11983,1469927,4934837
2018-02-16,2018,139,N,2,2,15668,2522731,7788067,11244,1481171,4934837
2018-02-17,2018,140,N,2,2,14841,2537572,7788067,10707,1491878,4934837
2018-02-18,2018,141,N,2,2,14216,2551788,7788067,10576,1502454,4934837
2018-02-19,2018,142,N,2,2,14402,2566190,7788067,12218,1514672,4934837
2018-02-20,2018,143,N,2,2,14297,2580487,7788067,11628,1526300,4934837
2018-02-21,2018,144,N,2,2,14171,2594658,7788067,11771,1538071,4934837
2018-02-22,2018,145,N,2,2,14325,2608983,7788067,11817,1549888,4934837
2018-02-23,2018,146,N,2,2,14565,2623548,7788067,12053,1561941,4934837
2018-02-24,2018,147,N,2,2,14361,2637909,7788067,11185,1573126,4934837
2018-02-25,2018,148,N,2,2,14495,2652404,7788067,11968,1585094,4934837
2018-02-26,2018,149,N,2,2,15155,2667559,7788067,14134,1599228,4934837
2018-02-27,2018,150,N,2,2,15994,2683553,7788067,12975,1612203,4934837
2018-02-28,2018,151,N,2,2,15809,2699362,7788067,11540,1623743,4934837
2018-03-01,2018,152,N,2,2,16805,2716167,7788067,17457,1641200,4934837
2018-03-02,2018,153,N,2,2,19707,2735874,7788067,21163,1662363,4934837
2018-03-03,2018,154,N,2,2,21508,2757382,7788067,23407,1685770,4934837
2018-03-04,2018,155,N,2,2,20665,2778047,7788067,22538,1708308,4934837
2018-03-05,2018,156,N,2,2,19080,2797127,7788067,20614,1728922,4934837
2018-03-06,2018,157,N,2,2,17490,2814617,7788067,14392,1743314,4934837
2018-03-07,2018,158,N,2,2,16251,2830868,7788067,11945,1755259,4934837
2018-03-08,2018,159,N,2,2,15290,2846158,7788067,9628,1764887,4934837
2018-03-09,2018,160,N,2,2,14841,2860999,7788067,8927,1773814,4934837
2018-03-10,2018,161,N,2,2,14771,2875770,7788067,8865,1782679,4934837
2018-03-11,2018,162,N,2,2,14657,2890427,7788067,8835,1791514,4934837
2018-03-12,2018,163,N,2,2,14316,2904743,7788067,8703,1800217,4934837
2018-03-13,2018,164,N,2,2,15171,2919914,7788067,9309,1809526,4934837
2018-03-14,2018,165,N,2,2,22948,2942862,7788067,17999,1827525,4934837
2018-03-15,2018,166,N,2,2,27434,2970296,7788067,22351,1849876,4934837
2018-03-16,2018,167,N,2,2,35241,3005537,7788067,31619,1881495,4934837
2018-03-17,2018,168,N,2,2,34568,3040105,7788067,30668,1912163,4934837
2018-03-18,2018,169,N,2,2,33160,3073265,7788067,28267,1940430,4934837
2018-03-19,2018,170,N,2,2,30045,3103310,7788067,23893,1964323,4934837
2018-03-20,2018,171,N,2,2,27253,3130563,7788067,22475,1986798,4934837
2018-03-21,2018,172,N,2,2,31465,3162028,7788067,25827,2012625,4934837
2018-03-22,2018,173,N,2,2,54367,3216395,7788067,52177,2064802,4934837
2018-03-23,2018,174,N,2,2,64736,3281131,7788067,62596,2127398,4934837
2018-03-24,2018,175,N,2,2,68680,3349811,7788067,66726,2194124,4934837
2018-03-25,2018,176,N,2,2,68122,3417933,7788067,63999,2258123,4934837
2018-03-26,2018,177,N,2,2,61347,3479280,7788067,56255,2314378,4934837
2018-03-27,2018,178,N,2,2,54890,3534170,7788067,45202,2359580,4934837
2018-03-28,2018,179,N,2,2,50444,3584614,7788067,39968,2399548,4934837
2018-03-29,2018,180,N,2,2,46488,3631102,7788067,37409,2436957,4934837
2018-03-30,2018,181,N,2,2,43165,3674267,7788067,31583,2468540,4934837
2018-03-31,2018,182,N,2,2,40286,3714553,7788067,29176,2497716,4934837
2018-04-01,2018,183,N,2,2,38454,3753007,7788067,29681,2527397,4934837
2018-04-02,2018,184,N,2,2,37918,3790925,7788067,29401,2556798,4934837
2018-04-03,2018,185,N,2,2,39078,3830003,7788067,30048,2586846,4934837
2018-04-04,2018,186,N,2,2,43696,3873699,7788067,34527,2621373,4934837
2018-04-05,2018,187,N,2,2,53751,3927450,7788067,44518,2665891,4934837
2018-04-06,2018,188,N,2,2,67175,3994625,7788067,64947,2730838,4934837
2018-04-07,2018,189,N,2,2,83104,4077729,7788067,83218,2814056,4934837
2018-04-08,2018,190,N,2,2,91348,4169077,7788067,91175,2905231,4934837
2018-04-09,2018,191,N,2,2,95896,4264973,7788067,96213,3001444,4934837
2018-04-10,2018,192,N,2,2,93915,4358888,7788067,97294,3098738,4934837
2018-04-11,2018,193,N,2,2,85020,4443908,7788067,83169,3181907,4934837
2018-04-12,2018,194,N,2,2,73309,4517217,7788067,68642,3250549,4934837
2018-04-13,2018,195,N,2,2,62698,4579915,7788067,57474,3308023,4934837
2018-04-14,2018,196,N,2,2,54886,4634801,7788067,49667,3357690,4934837
2018-04-15,2018,197,N,2,2,48806,4683607,7788067,43798,3401488,4934837
2018-04-16,2018,198,N,2,2,44212,4727819,7788067,40204,3441692,4934837
2018-04-17,2018,199,N,2,2,40507,4768326,7788067,36469,3478161,4934837
2018-04-18,2018,200,N,2,2,36573,4804899,7788067,33796,3511957,4934837
2018-04-19,2018,201,N,2,2,32774,4837673,7788067,30195,3542152,4934837
2018-04-20,2018,202,N,2,2,30177,4867850,7788067,27603,3569755,4934837
2018-04-21,2018,203,N,2,2,28109,4895959,7788067,24397,3594152,4934837
2018-04-22,2018,204,N,2,2,26064,4922023,7788067,22344,3616496,4934837
2018-04-23,2018,205,N,2,2,24544,4946567,7788067,20822,3637318,4934837
2018-04-24,2018,206,N,2,2,22931,4969498,7788067,19054,3656372,4934837
2018-04-25,2018,207,N,2,2,21618,4991116,7788067,17754,3674126,4934837
2018-04-26,2018,208,N,2,2,20666,5011782,7788067,16885,3691011,4934837
2018-04-27,2018,209,N,2,2,20352,5032134,7788067,16559,3707570,4934837
2018-04-28,2018,210,N,2,2,19995,5052129,7788067,16177,3723747,4934837
2018-04-29,2018,211,N,2,2,19470,5071599,7788067,15654,3739401,4934837
2018-04-30,2018,212,N,2,2,19206,5090805,7788067,15498,3754899,4934837
2018-05-01,2018,213,N,2,2,18520,5109325,7788067,14153,3769052,4934837
2018-05-02,2018,214,N,2,2,18526,5127851,7788067,14831,3783883,4934837
2018-05-03,2018,215,N,2,2,18792,5146643,7788067,15066,3798949,4934837
2018-05-04,2018,216,N,2,2,19140,5165783,7788067,15374,3814323,4934837
2018-05-05,2018,217,N,2,2,18745,5184528,7788067,14977,3829300,4934837
2018-05-06,2018,218,N,2,2,18545,5203073,7788067,14723,3844023,4934837
2018-05-07,2018,219,N,2,2,18900,5221973,7788067,13965,3857988,4934837
2018-05-08,2018,220,N,2,2,18663,5240636,7788067,13823,3871811,4934837
2018-05-09,2018,221,N,2,2,18708,5259344,7788067,13934,3885745,4934837
2018-05-10,2018,222,N,2,2,19345,5278689,7788067,14591,3900336,4934837
2018-05-11,2018,223,N,2,2,19627,5298316,7788067,14599,3914935,4934837
2018-05-12,2018,224,N,2,2,18184,5316500,7788067,11981,3926916,4934837
2018-05-13,2018,225,N,2,2,17169,5333669,7788067,10948,3937864,4934837
2018-05-14,2018,226,N,2,2,16148,5349817,7788067,10565,3948429,4934837
2018-05-15,2018,227,N,2,2,15143,5364960,7788067,9443,3957872,4934837
2018-05-16,2018,228,N,2,2,14822,5379782,7788067,10018,3967890,4934837
2018-05-17,2018,229,N,2,2,14629,5394411,7788067,9753,3977643,4934837
2018-05-18,2018,230,N,2,2,14961,5409372,7788067,10073,3987716,4934837
2018-05-19,2018,231,N,2,2,15258,5424630,7788067,8670,3996386,4934837
2018-05-20,2018,232,N,2,2,15681,5440311,7788067,9034,4005420,4934837
2018-05-21,2018,233,N,2,2,15741,5456052,7788067,9095,4014515,4934837
2018-05-22,2018,234,N,2,2,15651,5471703,7788067,9702,4024217,4934837
2018-05-23,2018,235,N,2,2,16411,5488114,7788067,10417,4034634,4934837
2018-05-24,2018,236,N,2,2,17135,5505249,7788067,11818,4046452,4934837
2018-05-25,2018,237,N,2,2,18026,5523275,7788067,13885,4060337,4934837
2018-05-26,2018,238,N,2,2,18675,5541950,7788067,14529,4074866,4934837
2018-05-27,2018,239,N,2,2,19394,5561344,7788067,15187,4090053,4934837
2018-05-28,2018,240,N,2,2,19985,5581329,7788067,15708,4105761,4934837
2018-05-29,2018,241,N,2,2,19878,5601207,7788067,15605,4121366,4934837
2018-05-30,2018,242,N,2,2,19294,5620501,7788067,14085,4135451,4934837
2018-05-31,2018,243,N,2,2,18898,5639399,7788067,12751,4148202,4934837
2018-06-01,2018,244,N,2,2,18009,5657408,7788067,11739,4159941,4934837
2018-06-02,2018,245,N,2,2,16950,5674358,7788067,9830,4169771,4934837
2018-06-03,2018,246,N,2,2,15933,5690291,7788067,8737,4178508,4934837
2018-06-04,2018,247,N,2,2,15312,5705603,7788067,7774,4186282,4934837
2018-06-05,2018,248,N,2,2,15303,5720906,7788067,7784,4194066,4934837
2018-06-06,2018,249,N,2,2,15331,5736237,7788067,7811,4201877,4934837
2018-06-07,2018,250,N,2,2,15282,5751519,7788067,7975,4209852,4934837
2018-06-08,2018,251,N,2,2,15213,5766732,7788067,7178,4217030,4934837
2018-06-09,2018,252,N,2,2,15224,5781956,7788067,7466,4224496,4934837
2018-06-10,2018,253,N,2,2,15002,5796958,7788067,7219,4231715,4934837
2018-06-11,2018,254,N,2,2,14601,5811559,7788067,6804,4238519,4934837
2018-06-12,2018,255,N,2,2,14290,5825849,7788067,6346,4244865,4934837
2018-06-13,2018,256,N,2,2,14197,5840046,7788067,6704,4251569,4934837
2018-06-14,2018,257,N,2,2,13962,5854008,7788067,6365,4257934,4934837
2018-06-15,2018,258,N,2,2,13566,5867574,7788067,5918,4263852,4934837
2018-06-16,2018,259,N,2,2,13181,5880755,7788067,5453,4269305,4934837
2018-06-17,2018,260,N,2,2,13470,5894225,7788067,5603,4274908,4934837
2018-06-18,2018,261,N,2,2,13902,5908127,7788067,6061,4280969,4934837
2018-06-19,2018,262,N,2,2,13742,5921869,7788067,7574,4288543,4934837
2018-06-20,2018,263,N,2,2,13956,5935825,7788067,7748,4296291,4934837
2018-06-21,2018,264,N,2,2,14313,5950138,7788067,7597,4303888,4934837
2018-06-22,2018,265,N,2,2,14605,5964743,7788067,7364,4311252,4934837
2018-06-23,2018,266,N,2,2,15193,5979936,7788067,7955,4319207,4934837
2018-06-24,2018,267,N,2,2,15410,5995346,7788067,7314,4326521,4934837
2018-06-25,2018,268,N,2,2,15810,6011156,7788067,7636,4334157,4934837
2018-06-26,2018,269,N,2,2,15502,6026658,7788067,6737,4340894,4934837
2018-06-27,2018,270,N,2,2,14955,6041613,7788067,6540,4347434,4934837
2018-06-28,2018,271,N,2,2,14558,6056171,7788067,6943,4354377,4934837
2018-06-29,2018,272,N,2,2,14336,6070507,7788067,7095,4361472,4934837
2018-06-30,2018,273,N,2,2,13807,6084314,7788067,6258,4367730,4934837
2018-07-01,2018,274,N,2,2,13389,6097703,7788067,4912,4372642,4934837
2018-07-02,2018,275,N,2,2,13769,6111472,7788067,5334,4377976,4934837
2018-07-03,2018,276,N,2,2,13770,6125242,7788067,5289,4383265,4934837
2018-07-04,2018,277,N,2,2,13833,6139075,7788067,5381,4388646,4934837
2018-07-05,2018,278,N,2,2,14016,6153091,7788067,5571,4394217,4934837
2018-07-06,2018,279,N,2,2,14346,6167437,7788067,5942,4400159,4934837
2018-07-07,2018,280,N,2,2,14595,6182032,7788067,6047,4406206,4934837
2018-07-08,2018,281,N,2,2,14717,6196749,7788067,6175,4412381,4934837
2018-07-09,2018,282,N,2,2,15187,6211936,7788067,6644,4419025,4934837
2018-07-10,2018,283,N,2,2,15404,6227340,7788067,6868,4425893,4934837
2018-07-11,2018,284,N,2,2,16056,6243396,7788067,7502,4433395,4934837
2018-07-12,2018,285,N,2,2,17069,6260465,7788067,8153,4441548,4934837
2018-07-13,2018,286,N,2,2,17678,6278143,7788067,7933,4449481,4934837
2018-07-14,2018,287,N,2,2,17755,6295898,7788067,7015,4456496,4934837
2018-07-15,2018,288,N,2,2,17863,6313761,7788067,7187,4463683,4934837
2018-07-16,2018,289,N,2,2,18273,6332034,7788067,7709,4471392,4934837
2018-07-17,2018,290,N,2,2,18291,6350325,7788067,7479,4478871,4934837
2018-07-18,2018,291,N,2,2,18380,6368705,7788067,7561,4486432,4934837
2018-07-19,2018,292,N,2,2,18210,6386915,7788067,6794,4493226,4934837
2018-07-20,2018,293,N,2,2,18090,6405005,7788067,6726,4499952,4934837
2018-07-21,2018,294,N,2,2,18073,6423078,7788067,6675,4506627,4934837
2018-07-22,2018,295,N,2,2,17967,6441045,7788067,6582,4513209,4934837
2018-07-23,2018,296,N,2,2,17945,6458990,7788067,6700,4519909,4934837
2018-07-24,2018,297,N,2,2,17826,6476816,7788067,6457,4526366,4934837
2018-07-25,2018,298,N,2,2,17742,6494558,7788067,6454,4532820,4934837
2018-07-26,2018,299,N,2,2,17746,6512304,7788067,6978,4539798,4934837
2018-07-27,2018,300,N,2,2,18028,6530332,7788067,7192,4546990,4934837
2018-07-28,2018,301,N,2,2,18136,6548468,7788067,7363,4554353,4934837
2018-07-29,2018,302,N,2,2,18341,6566809,7788067,7073,4561426,4934837
2018-07-30,2018,303,N,2,2,18697,6585506,7788067,6865,4568291,4934837
2018-07-31,2018,304,N,2,2,19038,6604544,7788067,5644,4573935,4934837
2018-08-01,2018,305,N,2,2,19373,6623917,7788067,6481,4580416,4934837
2018-08-02,2018,306,N,2,2,19733,6643650,7788067,7543,4587959,4934837
2018-08-03,2018,307,N,2,2,19706,6663356,7788067,6556,4594515,4934837
2018-08-04,2018,308,N,2,2,19600,6682956,7788067,6443,4600958,4934837
2018-08-05,2018,309,N,2,2,20354,6703310,7788067,7218,4608176,4934837
2018-08-06,2018,310,N,2,2,20980,6724290,7788067,7375,4615551,4934837
2018-08-07,2018,311,N,2,2,21248,6745538,7788067,6174,4621725,4934837
2018-08-08,2018,312,N,2,2,21332,6766870,7788067,5954,4627679,4934837
2018-08-09,2018,313,N,2,2,21467,6788337,7788067,6402,4634081,4934837
2018-08-10,2018,314,N,2,2,21279,6809616,7788067,5950,4640031,4934837
2018-08-11,2018,315,N,2,2,21102,6830718,7788067,6112,4646143,4934837
2018-08-12,2018,316,N,2,2,21064,6851782,7788067,6169,4652312,4934837
2018-08-13,2018,317,N,2,2,20923,6872705,7788067,6286,4658598,4934837
2018-08-14,2018,318,N,2,2,20499,6893204,7788067,6120,4664718,4934837
2018-08-15,2018,319,N,2,2,20059,6913263,7788067,5892,4670610,4934837
2018-08-16,2018,320,N,2,2,19777,6933040,7788067,5475,4676085,4934837
2018-08-17,2018,321,N,2,2,19404,6952444,7788067,4311,4680396,4934837
2018-08-18,2018,322,N,2,2,18909,6971353,7788067,4150,4684546,4934837
2018-08-19,2018,323,N,2,2,18606,6989959,7788067,3989,4688535,4934837
2018-08-20,2018,324,N,2,2,18578,7008537,7788067,4053,4692588,4934837
2018-08-21,2018,325,N,2,2,18575,7027112,7788067,4623,4697211,4934837
2018-08-22,2018,326,N,2,2,18791,7045903,7788067,4696,4701907,4934837
2018-08-23,2018,327,N,2,2,18775,7064678,7788067,5071,4706978,4934837
2018-08-24,2018,328,N,2,2,19099,7083777,7788067,4943,4711921,4934837
2018-08-25,2018,329,N,2,2,19398,7103175,7788067,5584,4717505,4934837
2018-08-26,2018,330,N,2,2,19270,7122445,7788067,5533,4723038,4934837
2018-08-27,2018,331,N,2,2,19079,7141524,7788067,5370,4728408,4934837
2018-08-28,2018,332,N,2,2,19071,7160595,7788067,5249,4733657,4934837
2018-08-29,2018,333,N,2,2,19233,7179828,7788067,5926,4739583,4934837
2018-08-30,2018,334,N,2,2,19522,7199350,7788067,6436,4746019,4934837
2018-08-31,2018,335,N,2,2,19728,7219078,7788067,6470,4752489,4934837
2018-09-01,2018,336,N,2,2,19738,7238816,7788067,5534,4758023,4934837
2018-09-02,2018,337,N,2,2,19617,7258433,7788067,5192,4763215,4934837
2018-09-03,2018,338,N,2,2,19407,7277840,7788067,5125,4768340,4934837
2018-09-04,2018,339,N,2,2,19263,7297103,7788067,5327,4773667,4934837
2018-09-05,2018,340,N,2,2,19453,7316556,7788067,6577,4780244,4934837
2018-09-06,2018,341,N,2,2,19865,7336421,7788067,7362,4787606,4934837
2018-09-07,2018,342,N,2,2,19741,7356162,7788067,6561,4794167,4934837
2018-09-08,2018,343,N,2,2,19601,7375763,7788067,6381,4800548,4934837
2018-09-09,2018,344,N,2,2,19588,7395351,7788067,6273,4806821,4934837
2018-09-10,2018,345,N,2,2,19626,7414977,7788067,6572,4813393,4934837
2018-09-11,2018,346,N,2,2,19392,7434369,7788067,6100,4819493,4934837
2018-09-12,2018,347,N,2,2,19496,7453865,7788067,6467,4825960,4934837
2018-09-13,2018,348,N,2,2,19806,7473671,7788067,6742,4832702,4934837
2018-09-14,2018,349,N,2,2,19688,7493359,7788067,6269,4838971,4934837
2018-09-15,2018,350,N,2,2,19584,7512943,7788067,6293,4845264,4934837
2018-09-16,2018,351,N,2,2,19643,7532586,7788067,6131,4851395,4934837
2018-09-17,2018,352,N,2,2,19420,7552006,7788067,6087,4857482,4934837
2018-09-18,2018,353,N,2,2,19039,7571045,7788067,5935,4863417,4934837
2018-09-19,2018,354,N,2,2,18846,7589891,7788067,5892,4869309,4934837
2018-09-20,2018,355,N,2,2,18734,7608625,7788067,5904,4875213,4934837
2018-09-21,2018,356,N,2,2,18303,7626928,7788067,5509,4880722,4934837
2018-09-22,2018,357,N,2,2,18099,7645027,7788067,5749,4886471,4934837
2018-09-23,2018,358,N,2,2,17989,7663016,7788067,5636,4892107,4934837
2018-09-24,2018,359,N,2,2,17746,7680762,7788067,5636,4897743,4934837
2018-09-25,2018,360,N,2,2,17547,7698309,7788067,6053,4903796,4934837
2018-09-26,2018,361,N,2,2,17589,7715898,7788067,6265,4910061,4934837
2018-09-27,2018,362,N,2,2,17803,7733701,7788067,6904,4916965,4934837
2018-09-28,2018,363,N,2,2,18161,7751862,7788067,6562,4923527,4934837
2018-09-29,2018,364,N,2,2,18233,7770095,7788067,6082,4929609,4934837
2018-09-30,2018,365,N,2,2,17972,7788067,7788067,5228,4934837,4934837
2018-10-01,2019,1,N,3,3+,17209,17209,16748225,4654,4654,13828737
2018-10-02,2019,2,N,3,3+,16508,33717,16748225,4316,8970,13828737
2018-10-03,2019,3,N,3,3+,16208,49925,16748225,9816,18786,13828737
2018-10-04,2019,4,N,3,3+,16422,66347,16748225,10832,29618,13828737
2018-10-05,2019,5,N,3,3+,16472,82819,16748225,10464,40082,13828737
2018-10-06,2019,6,N,3,3+,16278,99097,16748225,10029,50111,13828737
2018-10-07,2019,7,N,3,3+,15775,114872,16748225,9934,60045,13828737
2018-10-08,2019,8,N,3,3+,14509,129381,16748225,3230,63275,13828737
2018-10-09,2019,9,N,3,3+,13312,142693,16748225,2641,65916,13828737
2018-10-10,2019,10,N,3,3+,13113,155806,16748225,3948,69864,13828737
2018-10-11,2019,11,N,3,3+,13701,169507,16748225,5293,75157,13828737
2018-10-12,2019,12,N,3,3+,13920,183427,16748225,5027,80184,13828737
2018-10-13,2019,13,N,3,3+,13380,196807,16748225,3508,83692,13828737
2018-10-14,2019,14,N,3,3+,13103,209910,16748225,3406,87098,13828737
2018-10-15,2019,15,N,3,3+,12596,222506,16748225,3284,90382,13828737
2018-10-16,2019,16,N,3,3+,12172,234678,16748225,3410,93792,13828737
2018-10-17,2019,17,N,3,3+,12076,246754,16748225,3374,97166,13828737
2018-10-18,2019,18,N,3,3+,12885,259639,16748225,4917,102083,13828737
2018-10-19,2019,19,N,3,3+,13910,273549,16748225,5155,107238,13828737
2018-10-20,2019,20,N,3,3+,13935,287484,16748225,4193,111431,13828737
2018-10-21,2019,21,N,3,3+,14151,301635,16748225,4272,115703,13828737
2018-10-22,2019,22,N,3,3+,13846,315481,16748225,3859,119562,13828737
2018-10-23,2019,23,N,3,3+,13244,328725,16748225,3620,123182,13828737
2018-10-24,2019,24,N,3,3+,12554,341279,16748225,3979,127161,13828737
2018-10-25,2019,25,N,3,3+,12882,354161,16748225,4488,131649,13828737
2018-10-26,2019,26,N,3,3+,13542,367703,16748225,4466,136115,13828737
2018-10-27,2019,27,N,3,3+,12941,380644,16748225,3525,139640,13828737
2018-10-28,2019,28,N,3,3+,12644,393288,16748225,3748,143388,13828737
2018-10-29,2019,29,N,3,3+,12339,405627,16748225,4213,147601,13828737
2018-10-30,2019,30,N,3,3+,11986,417613,16748225,3783,151384,13828737
2018-10-31,2019,31,N,3,3+,11692,429305,16748225,3793,155177,13828737
2018-11-01,2019,32,N,3,3+,12363,441668,16748225,4964,160141,13828737
2018-11-02,2019,33,N,3,3+,13091,454759,16748225,5205,165346,13828737
2018-11-03,2019,34,N,3,3+,12822,467581,16748225,4752,170098,13828737
2018-11-04,2019,35,N,3,3+,12548,480129,16748225,4420,174518,13828737
2018-11-05,2019,36,N,3,3+,11842,491971,16748225,3744,178262,13828737
2018-11-06,2019,37,N,3,3+,11391,503362,16748225,4275,182537,13828737
2018-11-07,2019,38,N,3,3+,10665,514027,16748225,3759,186296,13828737
2018-11-08,2019,39,N,3,3+,10371,524398,16748225,4216,190512,13828737
2018-11-09,2019,40,N,3,3+,9868,534266,16748225,4033,194545,13828737
2018-11-10,2019,41,N,3,3+,9308,543574,16748225,4075,198620,13828737
2018-11-11,2019,42,N,3,3+,9188,552762,16748225,3916,202536,13828737
2018-11-12,2019,43,N,3,3+,9365,562127,16748225,4106,206642,13828737
2018-11-13,2019,44,N,3,3+,9316,571443,16748225,4248,210890,13828737
2018-11-14,2019,45,N,3,3+,9307,580750,16748225,4945,215835,13828737
2018-11-15,2019,46,N,3,3+,9307,590057,16748225,4939,220774,13828737
2018-11-16,2019,47,N,3,3+,9477,599534,16748225,4806,225580,13828737
2018-11-17,2019,48,N,3,3+,9627,609161,16748225,4752,230332,13828737
2018-11-18,2019,49,N,3,3+,9747,618908,16748225,5026,235358,13828737
2018-11-19,2019,50,N,3,3+,9964,628872,16748225,5073,240431,13828737
2018-11-20,2019,51,N,3,3+,10550,639422,16748225,5309,245740,13828737
2018-11-21,2019,52,N,3,3+,11490,650912,16748225,9217,254957,13828737
2018-11-22,2019,53,N,3,3+,12242,663154,16748225,11100,266057,13828737
2018-11-23,2019,54,N,3,3+,13111,676265,16748225,15863,281920,13828737
2018-11-24,2019,55,N,3,3+,13951,690216,16748225,16718,298638,13828737
2018-11-25,2019,56,N,3,3+,14389,704605,16748225,17110,315748,13828737
2018-11-26,2019,57,N,3,3+,14390,718995,16748225,15122,330870,13828737
2018-11-27,2019,58,N,3,3+,14301,733296,16748225,14115,344985,13828737
2018-11-28,2019,59,N,3,3+,14255,747551,16748225,12394,357379,13828737
2018-11-29,2019,60,N,3,3+,15454,763005,16748225,16332,373711,13828737
2018-11-30,2019,61,N,3,3+,18000,781005,16748225,18301,392012,13828737
2018-12-01,2019,62,N,3,3+,19838,800843,16748225,18936,410948,13828737
2018-12-02,2019,63,N,3,3+,21362,822205,16748225,19527,430475,13828737
2018-12-03,2019,64,N,3,3+,20201,842406,16748225,15567,446042,13828737
2018-12-04,2019,65,N,3,3+,17987,860393,16748225,7161,453203,13828737
2018-12-05,2019,66,N,3,3+,16413,876806,16748225,6241,459444,13828737
2018-12-06,2019,67,N,3,3+,15305,892111,16748225,4741,464185,13828737
2018-12-07,2019,68,N,3,3+,14706,906817,16748225,4589,468774,13828737
2018-12-08,2019,69,N,3,3+,14218,921035,16748225,4101,472875,13828737
2018-12-09,2019,70,N,3,3+,13462,934497,16748225,3848,476723,13828737
2018-12-10,2019,71,N,3,3+,12894,947391,16748225,3013,479736,13828737
2018-12-11,2019,72,N,3,3+,12945,960336,16748225,3994,483730,13828737
2018-12-12,2019,73,N,3,3+,12889,973225,16748225,5001,488731,13828737
2018-12-13,2019,74,N,3,3+,12245,985470,16748225,4347,493078,13828737
2018-12-14,2019,75,N,3,3+,11603,997073,16748225,3711,496789,13828737
2018-12-15,2019,76,N,3,3+,11672,1008745,16748225,3811,500600,13828737
2018-12-16,2019,77,N,3,3+,12199,1020944,16748225,8443,509043,13828737
2018-12-17,2019,78,N,3,3+,14479,1035423,16748225,13693,522736,13828737
2018-12-18,2019,79,N,3,3+,18061,1053484,16748225,17325,540061,13828737
2018-12-19,2019,80,N,3,3+,23612,1077096,16748225,20395,560456,13828737
2018-12-20,2019,81,N,3,3+,23864,1100960,16748225,20158,580614,13828737
2018-12-21,2019,82,N,3,3+,20665,1121625,16748225,13092,593706,13828737
2018-12-22,2019,83,N,3,3+,18445,1140070,16748225,8407,602113,13828737
2018-12-23,2019,84,N,3,3+,17578,1157648,16748225,8108,610221,13828737
2018-12-24,2019,85,N,3,3+,17357,1175005,16748225,10426,620647,13828737
2018-12-25,2019,86,N,3,3+,17770,1192775,16748225,13182,633829,13828737
2018-12-26,2019,87,N,3,3+,19425,1212200,16748225,14638,648467,13828737
2018-12-27,2019,88,N,3,3+,22035,1234235,16748225,17273,665740,13828737
2018-12-28,2019,89,N,3,3+,21566,1255801,16748225,16232,681972,13828737
2018-12-29,2019,90,N,3,3+,19154,1274955,16748225,10896,692868,13828737
2018-12-30,2019,91,N,3,3+,17215,1292170,16748225,6572,699440,13828737
2018-12-31,2019,92,N,3,3+,15996,1308166,16748225,4972,704412,13828737
2019-01-01,2019,93,N,3,3+,14763,1322929,16748225,7335,711747,13828737
2019-01-02,2019,94,N,3,3+,14049,1336978,16748225,6445,718192,13828737
2019-01-03,2019,95,N,3,3+,13830,1350808,16748225,6425,724617,13828737
2019-01-04,2019,96,N,3,3+,13435,1364243,16748225,6273,730890,13828737
2019-01-05,2019,97,N,3,3+,13354,1377597,16748225,7534,738424,13828737
2019-01-06,2019,98,N,3,3+,15286,1392883,16748225,17086,755510,13828737
2019-01-07,2019,99,N,3,3+,19296,1412179,16748225,21143,776653,13828737
2019-01-08,2019,100,N,3,3+,25543,1437722,16748225,27350,804003,13828737
2019-01-09,2019,101,N,3,3+,30357,1468079,16748225,33043,837046,13828737
2019-01-10,2019,102,N,3,3+,32939,1501018,16748225,34476,871522,13828737
2019-01-11,2019,103,N,3,3+,36471,1537489,16748225,30476,901998,13828737
2019-01-12,2019,104,N,3,3+,37090,1574579,16748225,31082,933080,13828737
2019-01-13,2019,105,N,3,3+,34060,1608639,16748225,28056,961136,13828737
2019-01-14,2019,106,N,3,3+,30041,1638680,16748225,23061,984197,13828737
2019-01-15,2019,107,N,3,3+,27349,1666029,16748225,21963,1006160,13828737
2019-01-16,2019,108,N,3,3+,29387,1695416,16748225,29871,1036031,13828737
2019-01-17,2019,109,N,3,3+,42029,1737445,16748225,42727,1078758,13828737
2019-01-18,2019,110,N,3,3+,55133,1792578,16748225,55622,1134380,13828737
2019-01-19,2019,111,N,3,3+,60404,1852982,16748225,60820,1195200,13828737
2019-01-20,2019,112,N,3,3+,64138,1917120,16748225,63088,1258288,13828737
2019-01-21,2019,113,N,3,3+,66177,1983297,16748225,59438,1317726,13828737
2019-01-22,2019,114,N,3,3+,64484,2047781,16748225,57455,1375181,13828737
2019-01-23,2019,115,N,3,3+,62900,2110681,16748225,55931,1431112,13828737
2019-01-24,2019,116,N,3,3+,59740,2170421,16748225,52972,1484084,13828737
2019-01-25,2019,117,N,3,3+,53111,2223532,16748225,45970,1530054,13828737
2019-01-26,2019,118,N,3,3+,46526,2270058,16748225,39495,1569549,13828737
2019-01-27,2019,119,N,3,3+,41093,2311151,16748225,34109,1603658,13828737
2019-01-28,2019,120,N,3,3+,37178,2348329,16748225,30192,1633850,13828737
2019-01-29,2019,121,N,3,3+,33940,2382269,16748225,26921,1660771,13828737
2019-01-30,2019,122,N,3,3+,31055,2413324,16748225,23880,1684651,13828737
2019-01-31,2019,123,N,3,3+,28419,2441743,16748225,21333,1705984,13828737
2019-02-01,2019,124,N,3,3+,26542,2468285,16748225,23967,1729951,13828737
2019-02-02,2019,125,N,3,3+,27413,2495698,16748225,23893,1753844,13828737
2019-02-03,2019,126,N,3,3+,34093,2529791,16748225,32316,1786160,13828737
2019-02-04,2019,127,N,3,3+,50875,2580666,16748225,52755,1838915,13828737
2019-02-05,2019,128,N,3,3+,60057,2640723,16748225,60563,1899478,13828737
2019-02-06,2019,129,N,3,3+,66108,2706831,16748225,64958,1964436,13828737
2019-02-07,2019,130,N,3,3+,68316,2775147,16748225,65262,2029698,13828737
2019-02-08,2019,131,N,3,3+,65593,2840740,16748225,64554,2094252,13828737
2019-02-09,2019,132,N,3,3+,61183,2901923,16748225,58571,2152823,13828737
2019-02-10,2019,133,N,3,3+,60480,2962403,16748225,59728,2212551,13828737
2019-02-11,2019,134,N,3,3+,58197,3020600,16748225,57442,2269993,13828737
2019-02-12,2019,135,N,3,3+,59380,3079980,16748225,59357,2329350,13828737
2019-02-13,2019,136,N,3,3+,68769,3148749,16748225,71463,2400813,13828737
2019-02-14,2019,137,N,3,3+,93972,3242721,16748225,94752,2495565,13828737
2019-02-15,2019,138,N,3,3+,129533,3372254,16748225,130451,2626016,13828737
2019-02-16,2019,139,N,3,3+,153043,3525297,16748225,153887,2779903,13828737
2019-02-17,2019,140,N,3,3+,155139,3680436,16748225,154067,2933970,13828737
2019-02-18,2019,141,N,3,3+,143046,3823482,16748225,134533,3068503,13828737
2019-02-19,2019,142,N,3,3+,122718,3946200,16748225,112538,3181041,13828737
2019-02-20,2019,143,N,3,3+,107109,4053309,16748225,95024,3276065,13828737
2019-02-21,2019,144,N,3,3+,96748,4150057,16748225,84077,3360142,13828737
2019-02-22,2019,145,N,3,3+,89755,4239812,16748225,76770,3436912,13828737
2019-02-23,2019,146,N,3,3+,83554,4323366,16748225,71831,3508743,13828737
2019-02-24,2019,147,N,3,3+,77448,4400814,16748225,65469,3574212,13828737
2019-02-25,2019,148,N,3,3+,73911,4474725,16748225,62167,3636379,13828737
2019-02-26,2019,149,N,3,3+,85530,4560255,16748225,78853,3715232,13828737
2019-02-27,2019,150,N,3,3+,124338,4684593,16748225,121730,3836962,13828737
2019-02-28,2019,151,N,3,3+,164835,4849428,16748225,162975,3999937,13828737
2019-03-01,2019,152,N,3,3+,166315,5015743,16748225,164480,4164417,13828737
2019-03-02,2019,153,N,3,3+,175383,5191126,16748225,176826,4341243,13828737
2019-03-03,2019,154,N,3,3+,183147,5374273,16748225,180911,4522154,13828737
2019-03-04,2019,155,N,3,3+,177618,5551891,16748225,173084,4695238,13828737
2019-03-05,2019,156,N,3,3+,166953,5718844,16748225,162147,4857385,13828737
2019-03-06,2019,157,N,3,3+,163987,5882831,16748225,160863,5018248,13828737
2019-03-07,2019,158,N,3,3+,175463,6058294,16748225,168886,5187134,13828737
2019-03-08,2019,159,N,3,3+,174544,6232838,16748225,166914,5354048,13828737
2019-03-09,2019,160,N,3,3+,168009,6400847,16748225,160567,5514615,13828737
2019-03-10,2019,161,N,3,3+,163217,6564064,16748225,156722,5671337,13828737
2019-03-11,2019,162,N,3,3+,157642,6721706,16748225,150039,5821376,13828737
2019-03-12,2019,163,N,3,3+,149142,6870848,16748225,141576,5962952,13828737
2019-03-13,2019,164,N,3,3+,139238,7010086,16748225,134831,6097783,13828737
2019-03-14,2019,165,N,3,3+,129444,7139530,16748225,121805,6219588,13828737
2019-03-15,2019,166,N,3,3+,121064,7260594,16748225,115167,6334755,13828737
2019-03-16,2019,167,N,3,3+,115346,7375940,16748225,106554,6441309,13828737
2019-03-17,2019,168,N,3,3+,110731,7486671,16748225,101891,6543200,13828737
2019-03-18,2019,169,N,3,3+,105932,7592603,16748225,97089,6640289,13828737
2019-03-19,2019,170,N,3,3+,100478,7693081,16748225,91791,6732080,13828737
2019-03-20,2019,171,N,3,3+,94974,7788055,16748225,85735,6817815,13828737
2019-03-21,2019,172,N,3,3+,91364,7879419,16748225,82054,6899869,13828737
2019-03-22,2019,173,N,3,3+,87634,7967053,16748225,79414,6979283,13828737
2019-03-23,2019,174,N,3,3+,86280,8053333,16748225,81727,7061010,13828737
2019-03-24,2019,175,N,3,3+,84249,8137582,16748225,79425,7140435,13828737
2019-03-25,2019,176,N,3,3+,82851,8220433,16748225,78125,7218560,13828737
2019-03-26,2019,177,N,3,3+,83305,8303738,16748225,80160,7298720,13828737
2019-03-27,2019,178,N,3,3+,86282,8390020,16748225,81508,7380228,13828737
2019-03-28,2019,179,N,3,3+,91312,8481332,16748225,82310,7462538,13828737
2019-03-29,2019,180,N,3,3+,97628,8578960,16748225,88575,7551113,13828737
2019-03-30,2019,181,N,3,3+,104665,8683625,16748225,95438,7646551,13828737
2019-03-31,2019,182,N,3,3+,104920,8788545,16748225,96014,7742565,13828737
2019-04-01,2019,183,N,3,3+,101965,8890510,16748225,96640,7839205,13828737
2019-04-02,2019,184,N,3,3+,98396,8988906,16748225,93495,7932700,13828737
2019-04-03,2019,185,N,3,3+,96917,9085823,16748225,91620,8024320,13828737
2019-04-04,2019,186,N,3,3+,100489,9186312,16748225,95058,8119378,13828737
2019-04-05,2019,187,N,3,3+,105390,9291702,16748225,100990,8220368,13828737
2019-04-06,2019,188,N,3,3+,107852,9399554,16748225,103226,8323594,13828737
2019-04-07,2019,189,N,3,3+,110798,9510352,16748225,106086,8429680,13828737
2019-04-08,2019,190,N,3,3+,111108,9621460,16748225,106646,8536326,13828737
2019-04-09,2019,191,N,3,3+,109382,9730842,16748225,104902,8641228,13828737
2019-04-10,2019,192,N,3,3+,106459,9837301,16748225,101233,8742461,13828737
2019-04-11,2019,193,N,3,3+,104555,9941856,16748225,99430,8841891,13828737
2019-04-12,2019,194,N,3,3+,104882,10046738,16748225,100003,8941894,13828737
2019-04-13,2019,195,N,3,3+,106732,10153470,16748225,101857,9043751,13828737
2019-04-14,2019,196,N,3,3+,105842,10259312,16748225,101072,9144823,13828737
2019-04-15,2019,197,N,3,3+,103564,10362876,16748225,98867,9243690,13828737
2019-04-16,2019,198,N,3,3+,100417,10463293,16748225,96212,9339902,13828737
2019-04-17,2019,199,N,3,3+,96620,10559913,16748225,92425,9432327,13828737
2019-04-18,2019,200,N,3,3+,91315,10651228,16748225,87213,9519540,13828737
2019-04-19,2019,201,N,3,3+,87289,10738517,16748225,83209,9602749,13828737
2019-04-20,2019,202,N,3,3+,83566,10822083,16748225,79352,9682101,13828737
2019-04-21,2019,203,N,3,3+,79631,10901714,16748225,75036,9757137,13828737
2019-04-22,2019,204,N,3,3+,76746,10978460,16748225,72172,9829309,13828737
2019-04-23,2019,205,N,3,3+,73927,11052387,16748225,69351,9898660,13828737
2019-04-24,2019,206,N,3,3+,71077,11123464,16748225,66546,9965206,13828737
2019-04-25,2019,207,N,3,3+,68464,11191928,16748225,63949,10029155,13828737
2019-04-26,2019,208,N,3,3+,65797,11257725,16748225,61365,10090520,13828737
2019-04-27,2019,209,N,3,3+,63340,11321065,16748225,58922,10149442,13828737
2019-04-28,2019,210,N,3,3+,61169,11382234,16748225,56698,10206140,13828737
2019-04-29,2019,211,N,3,3+,59111,11441345,16748225,54716,10260856,13828737
2019-04-30,2019,212,N,3,3+,56544,11497889,16748225,52156,10313012,13828737
2019-05-01,2019,213,N,3,3+,54170,11552059,16748225,50006,10363018,13828737
2019-05-02,2019,214,N,3,3+,52188,11604247,16748225,47993,10411011,13828737
2019-05-03,2019,215,N,3,3+,50211,11654458,16748225,45926,10456937,13828737
2019-05-04,2019,216,N,3,3+,48175,11702633,16748225,43857,10500794,13828737
2019-05-05,2019,217,N,3,3+,46331,11748964,16748225,42007,10542801,13828737
2019-05-06,2019,218,N,3,3+,45916,11794880,16748225,41572,10584373,13828737
2019-05-07,2019,219,N,3,3+,46321,11841201,16748225,42002,10626375,13828737
2019-05-08,2019,220,N,3,3+,46424,11887625,16748225,42011,10668386,13828737
2019-05-09,2019,221,N,3,3+,46385,11934010,16748225,41791,10710177,13828737
2019-05-10,2019,222,N,3,3+,46310,11980320,16748225,41640,10751817,13828737
2019-05-11,2019,223,N,3,3+,45071,12025391,16748225,40246,10792063,13828737
2019-05-12,2019,224,N,3,3+,44061,12069452,16748225,39239,10831302,13828737
2019-05-13,2019,225,N,3,3+,43897,12113349,16748225,39493,10870795,13828737
2019-05-14,2019,226,N,3,3+,43764,12157113,16748225,39303,10910098,13828737
2019-05-15,2019,227,N,3,3+,44461,12201574,16748225,41425,10951523,13828737
2019-05-16,2019,228,N,3,3+,46959,12248533,16748225,46814,10998337,13828737
2019-05-17,2019,229,N,3,3+,50496,12299029,16748225,50336,11048673,13828737
2019-05-18,2019,230,N,3,3+,54171,12353200,16748225,56911,11105584,13828737
2019-05-19,2019,231,N,3,3+,58678,12411878,16748225,72728,11178312,13828737
2019-05-20,2019,232,N,3,3+,60979,12472857,16748225,72701,11251013,13828737
2019-05-21,2019,233,N,3,3+,62375,12535232,16748225,70922,11321935,13828737
2019-05-22,2019,234,N,3,3+,64008,12599240,16748225,72656,11394591,13828737
2019-05-23,2019,235,N,3,3+,62379,12661619,16748225,67864,11462455,13828737
2019-05-24,2019,236,N,3,3+,60619,12722238,16748225,54621,11517076,13828737
2019-05-25,2019,237,N,3,3+,57642,12779880,16748225,51702,11568778,13828737
2019-05-26,2019,238,N,3,3+,55347,12835227,16748225,49721,11618499,13828737
2019-05-27,2019,239,N,3,3+,55213,12890440,16748225,49422,11667921,13828737
2019-05-28,2019,240,N,3,3+,56223,12946663,16748225,50889,11718810,13828737
2019-05-29,2019,241,N,3,3+,57076,13003739,16748225,50691,11769501,13828737
2019-05-30,2019,242,N,3,3+,55709,13059448,16748225,49125,11818626,13828737
2019-05-31,2019,243,N,3,3+,54792,13114240,16748225,48005,11866631,13828737
2019-06-01,2019,244,N,3,3+,57472,13171712,16748225,43251,11909882,13828737
2019-06-02,2019,245,N,3,3+,61325,13233037,16748225,47074,11956956,13828737
2019-06-03,2019,246,N,3,3+,63608,13296645,16748225,49387,12006343,13828737
2019-06-04,2019,247,N,3,3+,66005,13362650,16748225,51676,12058019,13828737
2019-06-05,2019,248,N,3,3+,68198,13430848,16748225,53720,12111739,13828737
2019-06-06,2019,249,N,3,3+,68931,13499779,16748225,54421,12166160,13828737
2019-06-07,2019,250,N,3,3+,68058,13567837,16748225,53513,12219673,13828737
2019-06-08,2019,251,N,3,3+,67459,13635296,16748225,52884,12272557,13828737
2019-06-09,2019,252,N,3,3+,65956,13701252,16748225,51343,12323900,13828737
2019-06-10,2019,253,N,3,3+,63823,13765075,16748225,49223,12373123,13828737
2019-06-11,2019,254,N,3,3+,60495,13825570,16748225,48342,12421465,13828737
2019-06-12,2019,255,N,3,3+,55943,13881513,16748225,43842,12465307,13828737
2019-06-13,2019,256,N,3,3+,51429,13932942,16748225,36559,12501866,13828737
2019-06-14,2019,257,N,3,3+,46914,13979856,16748225,31980,12533846,13828737
2019-06-15,2019,258,N,3,3+,43799,14023655,16748225,28823,12562669,13828737
2019-06-16,2019,259,N,3,3+,41763,14065418,16748225,26737,12589406,13828737
2019-06-17,2019,260,N,3,3+,40425,14105843,16748225,25377,12614783,13828737
2019-06-18,2019,261,N,3,3+,38980,14144823,16748225,26594,12641377,13828737
2019-06-19,2019,262,N,3,3+,37338,14182161,16748225,24894,12666271,13828737
2019-06-20,2019,263,N,3,3+,35991,14218152,16748225,23258,12689529,13828737
2019-06-21,2019,264,N,3,3+,34703,14252855,16748225,21291,12710820,13828737
2019-06-22,2019,265,N,3,3+,33250,14286105,16748225,19142,12729962,13828737
2019-06-23,2019,266,N,3,3+,32040,14318145,16748225,18465,12748427,13828737
2019-06-24,2019,267,N,3,3+,31163,14349308,16748225,17935,12766362,13828737
2019-06-25,2019,268,N,3,3+,29670,14378978,16748225,16226,12782588,13828737
2019-06-26,2019,269,N,3,3+,28037,14407015,16748225,14804,12797392,13828737
2019-06-27,2019,270,N,3,3+,26567,14433582,16748225,13291,12810683,13828737
2019-06-28,2019,271,N,3,3+,25047,14458629,16748225,16262,12826945,13828737
2019-06-29,2019,272,N,3,3+,23825,14482454,16748225,14950,12841895,13828737
2019-06-30,2019,273,N,3,3+,23600,14506054,16748225,13747,12855642,13828737
2019-07-01,2019,274,N,3,3+,24577,14530631,16748225,9812,12865454,13828737
2019-07-02,2019,275,N,3,3+,25564,14556195,16748225,10848,12876302,13828737
2019-07-03,2019,276,N,3,3+,25584,14581779,16748225,10267,12886569,13828737
2019-07-04,2019,277,N,3,3+,24915,14606694,16748225,10114,12896683,13828737
2019-07-05,2019,278,N,3,3+,24342,14631036,16748225,9655,12906338,13828737
2019-07-06,2019,279,N,3,3+,24099,14655135,16748225,9129,12915467,13828737
2019-07-07,2019,280,N,3,3+,23797,14678932,16748225,8270,12923737,13828737
2019-07-08,2019,281,N,3,3+,23720,14702652,16748225,8611,12932348,13828737
2019-07-09,2019,282,N,3,3+,23443,14726095,16748225,7847,12940195,13828737
2019-07-10,2019,283,N,3,3+,23821,14749916,16748225,8215,12948410,13828737
2019-07-11,2019,284,N,3,3+,23865,14773781,16748225,8238,12956648,13828737
2019-07-12,2019,285,N,3,3+,23643,14797424,16748225,8005,12964653,13828737
2019-07-13,2019,286,N,3,3+,23301,14820725,16748225,7639,12972292,13828737
2019-07-14,2019,287,N,3,3+,22709,14843434,16748225,7069,12979361,13828737
2019-07-15,2019,288,N,3,3+,22240,14865674,16748225,6795,12986156,13828737
2019-07-16,2019,289,N,3,3+,22217,14887891,16748225,6599,12992755,13828737
2019-07-17,2019,290,N,3,3+,22412,14910303,16748225,6847,12999602,13828737
2019-07-18,2019,291,N,3,3+,22039,14932342,16748225,6437,13006039,13828737
2019-07-19,2019,292,N,3,3+,21939,14954281,16748225,6335,13012374,13828737
2019-07-20,2019,293,N,3,3+,21975,14976256,16748225,6371,13018745,13828737
2019-07-21,2019,294,N,3,3+,22011,14998267,16748225,6444,13025189,13828737
2019-07-22,2019,295,N,3,3+,22063,15020330,16748225,6486,13031675,13828737
2019-07-23,2019,296,N,3,3+,22044,15042374,16748225,6478,13038153,13828737
2019-07-24,2019,297,N,3,3+,22575,15064949,16748225,7013,13045166,13828737
2019-07-25,2019,298,N,3,3+,22569,15087518,16748225,7055,13052221,13828737
2019-07-26,2019,299,N,3,3+,22477,15109995,16748225,6973,13059194,13828737
2019-07-27,2019,300,N,3,3+,22373,15132368,16748225,6343,13065537,13828737
2019-07-28,2019,301,N,3,3+,22314,15154682,16748225,6323,13071860,13828737
2019-07-29,2019,302,N,3,3+,22348,15177030,16748225,6347,13078207,13828737
2019-07-30,2019,303,N,3,3+,22666,15199696,16748225,6779,13084986,13828737
2019-07-31,2019,304,N,3,3+,23263,15222959,16748225,7300,13092286,13828737
2019-08-01,2019,305,N,3,3+,23701,15246660,16748225,7746,13100032,13828737
2019-08-02,2019,306,N,3,3+,23807,15270467,16748225,7837,13107869,13828737
2019-08-03,2019,307,N,3,3+,23668,15294135,16748225,7773,13115642,13828737
2019-08-04,2019,308,N,3,3+,23284,15317419,16748225,7378,13123020,13828737
2019-08-05,2019,309,N,3,3+,23129,15340548,16748225,8275,13131295,13828737
2019-08-06,2019,310,N,3,3+,23337,15363885,16748225,10654,13141949,13828737
2019-08-07,2019,311,N,3,3+,24259,15388144,16748225,11654,13153603,13828737
2019-08-08,2019,312,N,3,3+,24738,15412882,16748225,13632,13167235,13828737
2019-08-09,2019,313,N,3,3+,24885,15437767,16748225,15747,13182982,13828737
2019-08-10,2019,314,N,3,3+,24590,15462357,16748225,17108,13200090,13828737
2019-08-11,2019,315,N,3,3+,24095,15486452,16748225,16683,13216773,13828737
2019-08-12,2019,316,N,3,3+,24020,15510472,16748225,16609,13233382,13828737
2019-08-13,2019,317,N,3,3+,24178,15534650,16748225,15260,13248642,13828737
2019-08-14,2019,318,N,3,3+,24687,15559337,16748225,12304,13260946,13828737
2019-08-15,2019,319,N,3,3+,24796,15584133,16748225,12398,13273344,13828737
2019-08-16,2019,320,N,3,3+,24838,15608971,16748225,10468,13283812,13828737
2019-08-17,2019,321,N,3,3+,25319,15634290,16748225,10919,13294731,13828737
2019-08-18,2019,322,N,3,3+,25646,15659936,16748225,11298,13306029,13828737
2019-08-19,2019,323,N,3,3+,25847,15685783,16748225,11594,13317623,13828737
2019-08-20,2019,324,N,3,3+,25904,15711687,16748225,11706,13329329,13828737
2019-08-21,2019,325,N,3,3+,26142,15737829,16748225,12158,13341487,13828737
2019-08-22,2019,326,N,3,3+,26194,15764023,16748225,11359,13352846,13828737
2019-08-23,2019,327,N,3,3+,26174,15790197,16748225,10831,13363677,13828737
2019-08-24,2019,328,N,3,3+,26395,15816592,16748225,11081,13374758,13828737
2019-08-25,2019,329,N,3,3+,26518,15843110,16748225,11227,13385985,13828737
2019-08-26,2019,330,N,3,3+,26110,15869220,16748225,10909,13396894,13828737
2019-08-27,2019,331,N,3,3+,25633,15894853,16748225,10438,13407332,13828737
2019-08-28,2019,332,N,3,3+,25387,15920240,16748225,10748,13418080,13828737
2019-08-29,2019,333,N,3,3+,25549,15945789,16748225,12150,13430230,13828737
2019-08-30,2019,334,N,3,3+,25567,15971356,16748225,12205,13442435,13828737
2019-08-31,2019,335,N,3,3+,25461,15996817,16748225,12150,13454585,13828737
2019-09-01,2019,336,N,3,3+,26051,16022868,16748225,12966,13467551,13828737
2019-09-02,2019,337,N,3,3+,26053,16048921,16748225,12812,13480363,13828737
2019-09-03,2019,338,N,3,3+,25810,16074731,16748225,12132,13492495,13828737
2019-09-04,2019,339,N,3,3+,25687,16100418,16748225,12074,13504569,13828737
2019-09-05,2019,340,N,3,3+,25918,16126336,16748225,12350,13516919,13828737
2019-09-06,2019,341,N,3,3+,26186,16152522,16748225,12658,13529577,13828737
2019-09-07,2019,342,N,3,3+,25569,16178091,16748225,12091,13541668,13828737
2019-09-08,2019,343,N,3,3+,25781,16203872,16748225,12336,13554004,13828737
2019-09-09,2019,344,N,3,3+,25513,16229385,16748225,12176,13566180,13828737
2019-09-10,2019,345,N,3,3+,25237,16254622,16748225,13122,13579302,13828737
2019-09-11,2019,346,N,3,3+,25048,16279670,16748225,13447,13592749,13828737
2019-09-12,2019,347,N,3,3+,24910,16304580,16748225,14893,13607642,13828737
2019-09-13,2019,348,N,3,3+,24588,16329168,16748225,11367,13619009,13828737
2019-09-14,2019,349,N,3,3+,24744,16353912,16748225,10539,13629548,13828737
2019-09-15,2019,350,N,3,3+,25076,16378988,16748225,10892,13640440,13828737
2019-09-16,2019,351,N,3,3+,25381,16404369,16748225,13088,13653528,13828737
2019-09-17,2019,352,N,3,3+,25725,16430094,16748225,17681,13671209,13828737
2019-09-18,2019,353,N,3,3+,25965,16456059,16748225,15853,13687062,13828737
2019-09-19,2019,354,N,3,3+,26041,16482100,16748225,14280,13701342,13828737
2019-09-20,2019,355,N,3,3+,25978,16508078,16748225,13866,13715208,13828737
2019-09-21,2019,356,N,3,3+,25606,16533684,16748225,11653,13726861,13828737
2019-09-22,2019,357,N,3,3+,25109,16558793,16748225,11200,13738061,13828737
2019-09-23,2019,358,N,3,3+,24615,16583408,16748225,11206,13749267,13828737
2019-09-24,2019,359,N,3,3+,24046,16607454,16748225,10199,13759466,13828737
2019-09-25,2019,360,N,3,3+,23596,16631050,16748225,10290,13769756,13828737
2019-09-26,2019,361,N,3,3+,23105,16654155,16748225,9301,13779057,13828737
2019-09-27,2019,362,N,3,3+,23254,16677409,16748225,10569,13789626,13828737
2019-09-28,2019,363,N,3,3+,23500,16700909,16748225,13710,13803336,13828737
2019-09-29,2019,364,N,3,3+,23641,16724550,16748225,13914,13817250,13828737
2019-09-30,2019,365,N,3,3+,23675,16748225,16748225,11487,13828737,13828737
2019-10-01,2020,1,D,1,1,23614,23614,5796208,10984,10984,3334366
2019-10-02,2020,2,D,1,1,23745,47359,5796208,11970,22954,3334366
2019-10-03,2020,3,D,1,1,24152,71511,5796208,13442,36396,3334366
2019-10-04,2020,4,D,1,1,23528,95039,5796208,14809,51205,3334366
2019-10-05,2020,5,D,1,1,22330,117369,5796208,14637,65842,3334366
2019-10-06,2020,6,D,1,1,21258,138627,5796208,15231,81073,3334366
2019-10-07,2020,7,D,1,1,20457,159084,5796208,15428,96501,3334366
2019-10-08,2020,8,D,1,1,19471,178555,5796208,14456,110957,3334366
2019-10-09,2020,9,D,1,1,18676,197231,5796208,14579,125536,3334366
2019-10-10,2020,10,D,1,1,18127,215358,5796208,14550,140086,3334366
2019-10-11,2020,11,D,1,1,17778,233136,5796208,14211,154297,3334366
2019-10-12,2020,12,D,1,1,16988,250124,5796208,13384,167681,3334366
2019-10-13,2020,13,D,1,1,16188,266312,5796208,12568,180249,3334366
2019-10-14,2020,14,D,1,1,15504,281816,5796208,11962,192211,3334366
2019-10-15,2020,15,D,1,1,14885,296701,5796208,11374,203585,3334366
2019-10-16,2020,16,D,1,1,14454,311155,5796208,10937,214522,3334366
2019-10-17,2020,17,D,1,1,15677,326832,5796208,12160,226682,3334366
2019-10-18,2020,18,D,1,1,17162,343994,5796208,13722,240404,3334366
2019-10-19,2020,19,D,1,1,17152,361146,5796208,13902,254306,3334366
2019-10-20,2020,20,D,1,1,16523,377669,5796208,13270,267576,3334366
2019-10-21,2020,21,D,1,1,16679,394348,5796208,13442,281018,3334366
2019-10-22,2020,22,D,1,1,16446,410794,5796208,13313,294331,3334366
2019-10-23,2020,23,D,1,1,15845,426639,5796208,12756,307087,3334366
2019-10-24,2020,24,D,1,1,16074,442713,5796208,12994,320081,3334366
2019-10-25,2020,25,D,1,1,16827,459540,5796208,13718,333799,3334366
2019-10-26,2020,26,D,1,1,17321,476861,5796208,14207,348006,3334366
2019-10-27,2020,27,D,1,1,16812,493673,5796208,13730,361736,3334366
2019-10-28,2020,28,D,1,1,15592,509265,5796208,12511,374247,3334366
2019-10-29,2020,29,D,1,1,15429,524694,5796208,12393,386640,3334366
2019-10-30,2020,30,D,1,1,15081,539775,5796208,12054,398694,3334366
2019-10-31,2020,31,D,1,1,14359,554134,5796208,11332,410026,3334366
2019-11-01,2020,32,D,1,1,14069,568203,5796208,8144,418170,3334366
2019-11-02,2020,33,D,1,1,14446,582649,5796208,9533,427703,3334366
2019-11-03,2020,34,D,1,1,14086,596735,5796208,9396,437099,3334366
2019-11-04,2020,35,D,1,1,13387,610122,5796208,7479,444578,3334366
2019-11-05,2020,36,D,1,1,12634,622756,5796208,7124,451702,3334366
2019-11-06,2020,37,D,1,1,12123,634879,5796208,7261,458963,3334366
2019-11-07,2020,38,D,1,1,11916,646795,5796208,7304,466267,3334366
2019-11-08,2020,39,D,1,1,11938,658733,5796208,7476,473743,3334366
2019-11-09,2020,40,D,1,1,11759,670492,5796208,6990,480733,3334366
2019-11-10,2020,41,D,1,1,11762,682254,5796208,7114,487847,3334366
2019-11-11,2020,42,D,1,1,11868,694122,5796208,7021,494868,3334366
2019-11-12,2020,43,D,1,1,12068,706190,5796208,7000,501868,3334366
2019-11-13,2020,44,D,1,1,12292,718482,5796208,6833,508701,3334366
2019-11-14,2020,45,D,1,1,12414,730896,5796208,4047,512748,3334366
2019-11-15,2020,46,D,1,1,12565,743461,5796208,4165,516913,3334366
2019-11-16,2020,47,D,1,1,12671,756132,5796208,4297,521210,3334366
2019-11-17,2020,48,D,1,1,12652,768784,5796208,4289,525499,3334366
2019-11-18,2020,49,D,1,1,12521,781305,5796208,7830,533329,3334366
2019-11-19,2020,50,D,1,1,12839,794144,5796208,9527,542856,3334366
2019-11-20,2020,51,D,1,1,13264,807408,5796208,10339,553195,3334366
2019-11-21,2020,52,D,1,1,13071,820479,5796208,6992,560187,3334366
2019-11-22,2020,53,D,1,1,13053,833532,5796208,4520,564707,3334366
2019-11-23,2020,54,D,1,1,12857,846389,5796208,4870,569577,3334366
2019-11-24,2020,55,D,1,1,12867,859256,5796208,4918,574495,3334366
2019-11-25,2020,56,D,1,1,13031,872287,5796208,5002,579497,3334366
2019-11-26,2020,57,D,1,1,12742,885029,5796208,6938,586435,3334366
2019-11-27,2020,58,D,1,1,13078,898107,5796208,5889,592324,3334366
2019-11-28,2020,59,D,1,1,13764,911871,5796208,6741,599065,3334366
2019-11-29,2020,60,D,1,1,14189,926060,5796208,6758,605823,3334366
2019-11-30,2020,61,D,1,1,14621,940681,5796208,7832,613655,3334366
2019-12-01,2020,62,D,1,1,15858,956539,5796208,13023,626678,3334366
2019-12-02,2020,63,D,1,1,20343,976882,5796208,18708,645386,3334366
2019-12-03,2020,64,D,1,1,23430,1000312,5796208,21568,666954,3334366
2019-12-04,2020,65,D,1,1,25326,1025638,5796208,25178,692132,3334366
2019-12-05,2020,66,D,1,1,26285,1051923,5796208,25397,717529,3334366
2019-12-06,2020,67,D,1,1,25630,1077553,5796208,20149,737678,3334366
2019-12-07,2020,68,D,1,1,25841,1103394,5796208,20054,757732,3334366
2019-12-08,2020,69,D,1,1,27651,1131045,5796208,23914,781646,3334366
2019-12-09,2020,70,D,1,1,28778,1159823,5796208,21848,803494,3334366
2019-12-10,2020,71,D,1,1,30568,1190391,5796208,24261,827755,3334366
2019-12-11,2020,72,D,1,1,30131,1220522,5796208,22871,850626,3334366
2019-12-12,2020,73,D,1,1,28138,1248660,5796208,18982,869608,3334366
2019-12-13,2020,74,D,1,1,26607,1275267,5796208,14735,884343,3334366
2019-12-14,2020,75,D,1,1,25812,1301079,5796208,13862,898205,3334366
2019-12-15,2020,76,D,1,1,25435,1326514,5796208,11946,910151,3334366
2019-12-16,2020,77,D,1,1,25080,1351594,5796208,11468,921619,3334366
2019-12-17,2020,78,D,1,1,24102,1375696,5796208,11059,932678,3334366
2019-12-18,2020,79,D,1,1,22944,1398640,5796208,10260,942938,3334366
2019-12-19,2020,80,D,1,1,21913,1420553,5796208,9605,952543,3334366
2019-12-20,2020,81,D,1,1,20979,1441532,5796208,8499,961042,3334366
2019-12-21,2020,82,D,1,1,20285,1461817,5796208,7871,968913,3334366
2019-12-22,2020,83,D,1,1,20434,1482251,5796208,7788,976701,3334366
2019-12-23,2020,84,D,1,1,21359,1503610,5796208,8660,985361,3334366
2019-12-24,2020,85,D,1,1,22594,1526204,5796208,9417,994778,3334366
2019-12-25,2020,86,D,1,1,23708,1549912,5796208,11583,1006361,3334366
2019-12-26,2020,87,D,1,1,23527,1573439,5796208,11124,1017485,3334366
2019-12-27,2020,88,D,1,1,22600,1596039,5796208,9980,1027465,3334366
2019-12-28,2020,89,D,1,1,21793,1617832,5796208,8951,1036416,3334366
2019-12-29,2020,90,D,1,1,21168,1639000,5796208,9513,1045929,3334366
2019-12-30,2020,91,D,1,1,20648,1659648,5796208,9046,1054975,3334366
2019-12-31,2020,92,D,1,1,20224,1679872,5796208,8415,1063390,3334366
2020-01-01,2020,93,D,1,1,19586,1699458,5796208,12106,1075496,3334366
2020-01-02,2020,94,D,1,1,18956,1718414,5796208,12219,1087715,3334366
2020-01-03,2020,95,D,1,1,18537,1736951,5796208,10717,1098432,3334366
2020-01-04,2020,96,D,1,1,17910,1754861,5796208,10076,1108508,3334366
2020-01-05,2020,97,D,1,1,17594,1772455,5796208,9796,1118304,3334366
2020-01-06,2020,98,D,1,1,17318,1789773,5796208,9505,1127809,3334366
2020-01-07,2020,99,D,1,1,17074,1806847,5796208,9264,1137073,3334366
2020-01-08,2020,100,D,1,1,17275,1824122,5796208,9429,1146502,3334366
2020-01-09,2020,101,D,1,1,17838,1841960,5796208,11985,1158487,3334366
2020-01-10,2020,102,D,1,1,18037,1859997,5796208,12273,1170760,3334366
2020-01-11,2020,103,D,1,1,17875,1877872,5796208,12182,1182942,3334366
2020-01-12,2020,104,D,1,1,17849,1895721,5796208,12217,1195159,3334366
2020-01-13,2020,105,D,1,1,17636,1913357,5796208,11996,1207155,3334366
2020-01-14,2020,106,D,1,1,17522,1930879,5796208,10377,1217532,3334366
2020-01-15,2020,107,D,1,1,17423,1948302,5796208,10175,1227707,3334366
2020-01-16,2020,108,D,1,1,17180,1965482,5796208,12801,1240508,3334366
2020-01-17,2020,109,D,1,1,17765,1983247,5796208,13475,1253983,3334366
2020-01-18,2020,110,D,1,1,18181,2001428,5796208,13933,1267916,3334366
2020-01-19,2020,111,D,1,1,19754,2021182,5796208,14900,1282816,3334366
2020-01-20,2020,112,D,1,1,19648,2040830,5796208,14599,1297415,3334366
2020-01-21,2020,113,D,1,1,18918,2059748,5796208,11447,1308862,3334366
2020-01-22,2020,114,D,1,1,18368,2078116,5796208,11579,1320441,3334366
2020-01-23,2020,115,D,1,1,17954,2096070,5796208,11172,1331613,3334366
2020-01-24,2020,116,D,1,1,18747,2114817,5796208,11901,1343514,3334366
2020-01-25,2020,117,D,1,1,19905,2134722,5796208,13052,1356566,3334366
2020-01-26,2020,118,D,1,1,20358,2155080,5796208,14427,1370993,3334366
2020-01-27,2020,119,D,1,1,21937,2177017,5796208,15697,1386690,3334366
2020-01-28,2020,120,D,1,1,25324,2202341,5796208,19107,1405797,3334366
2020-01-29,2020,121,D,1,1,27516,2229857,5796208,21279,1427076,3334366
2020-01-30,2020,122,D,1,1,26338,2256195,5796208,19976,1447052,3334366
2020-01-31,2020,123,D,1,1,24271,2280466,5796208,16785,1463837,3334366
2020-02-01,2020,124,D,1,1,22329,2302795,5796208,14889,1478726,3334366
2020-02-02,2020,125,D,1,1,20982,2323777,5796208,13558,1492284,3334366
2020-02-03,2020,126,D,1,1,20379,2344156,5796208,12959,1505243,3334366
2020-02-04,2020,127,D,1,1,19891,2364047,5796208,12460,1517703,3334366
2020-02-05,2020,128,D,1,1,19976,2384023,5796208,12693,1530396,3334366
2020-02-06,2020,129,D,1,1,20110,2404133,5796208,12653,1543049,3334366
2020-02-07,2020,130,D,1,1,19385,2423518,5796208,11355,1554404,3334366
2020-02-08,2020,131,D,1,1,18574,2442092,5796208,10916,1565320,3334366
2020-02-09,2020,132,D,1,1,17763,2459855,5796208,11278,1576598,3334366
2020-02-10,2020,133,D,1,1,16543,2476398,5796208,10045,1586643,3334366
2020-02-11,2020,134,D,1,1,15836,2492234,5796208,10982,1597625,3334366
2020-02-12,2020,135,D,1,1,15548,2507782,5796208,11599,1609224,3334366
2020-02-13,2020,136,D,1,1,15109,2522891,5796208,11209,1620433,3334366
2020-02-14,2020,137,D,1,1,15088,2537979,5796208,11723,1632156,3334366
2020-02-15,2020,138,D,1,1,15155,2553134,5796208,11781,1643937,3334366
2020-02-16,2020,139,D,1,1,15086,2568220,5796208,11506,1655443,3334366
2020-02-17,2020,140,D,1,1,14753,2582973,5796208,11369,1666812,3334366
2020-02-18,2020,141,D,1,1,13995,2596968,5796208,10693,1677505,3334366
2020-02-19,2020,142,D,1,1,13640,2610608,5796208,11047,1688552,3334366
2020-02-20,2020,143,D,1,1,13435,2624043,5796208,11536,1700088,3334366
2020-02-21,2020,144,D,1,1,13666,2637709,5796208,11905,1711993,3334366
2020-02-22,2020,145,D,1,1,13848,2651557,5796208,11429,1723422,3334366
2020-02-23,2020,146,D,1,1,14577,2666134,5796208,12139,1735561,3334366
2020-02-24,2020,147,D,1,1,15140,2681274,5796208,12414,1747975,3334366
2020-02-25,2020,148,D,1,1,15139,2696413,5796208,11523,1759498,3334366
2020-02-26,2020,149,D,1,1,15239,2711652,5796208,11541,1771039,3334366
2020-02-27,2020,150,D,1,1,15192,2726844,5796208,11473,1782512,3334366
2020-02-28,2020,151,D,1,1,14936,2741780,5796208,11212,1793724,3334366
2020-02-29,2020,152,D,1,1,14886,2756666,5796208,11387,1805111,3334366
2020-03-01,2020,153,D,1,1,15382,2772048,5796208,11985,1817096,3334366
2020-03-02,2020,154,D,1,1,15347,2787395,5796208,11734,1828830,3334366
2020-03-03,2020,155,D,1,1,15170,2802565,5796208,11222,1840052,3334366
2020-03-04,2020,156,D,1,1,15371,2817936,5796208,11947,1851999,3334366
2020-03-05,2020,157,D,1,1,15229,2833165,5796208,11473,1863472,3334366
2020-03-06,2020,158,D,1,1,15148,2848313,5796208,11692,1875164,3334366
2020-03-07,2020,159,D,1,1,15305,2863618,5796208,11542,1886706,3334366
2020-03-08,2020,160,D,1,1,15262,2878880,5796208,9572,1896278,3334366
2020-03-09,2020,161,D,1,1,14862,2893742,5796208,9144,1905422,3334366
2020-03-10,2020,162,D,1,1,14092,2907834,5796208,8569,1913991,3334366
2020-03-11,2020,163,D,1,1,13487,2921321,5796208,8011,1922002,3334366
2020-03-12,2020,164,D,1,1,13029,2934350,5796208,7181,1929183,3334366
2020-03-13,2020,165,D,1,1,12709,2947059,5796208,7007,1936190,3334366
2020-03-14,2020,166,D,1,1,13070,2960129,5796208,8531,1944721,3334366
2020-03-15,2020,167,D,1,1,15059,2975188,5796208,12556,1957277,3334366
2020-03-16,2020,168,D,1,1,18410,2993598,5796208,19000,1976277,3334366
2020-03-17,2020,169,D,1,1,17188,3010786,5796208,17390,1993667,3334366
2020-03-18,2020,170,D,1,1,16427,3027213,5796208,16333,2010000,3334366
2020-03-19,2020,171,D,1,1,16326,3043539,5796208,15617,2025617,3334366
2020-03-20,2020,172,D,1,1,16905,3060444,5796208,13449,2039066,3334366
2020-03-21,2020,173,D,1,1,16961,3077405,5796208,9869,2048935,3334366
2020-03-22,2020,174,D,1,1,15992,3093397,5796208,9279,2058214,3334366
2020-03-23,2020,175,D,1,1,15100,3108497,5796208,8464,2066678,3334366
2020-03-24,2020,176,D,1,1,14726,3123223,5796208,7743,2074421,3334366
2020-03-25,2020,177,D,1,1,14552,3137775,5796208,7317,2081738,3334366
2020-03-26,2020,178,D,1,1,14469,3152244,5796208,7677,2089415,3334366
2020-03-27,2020,179,D,1,1,14297,3166541,5796208,7099,2096514,3334366
2020-03-28,2020,180,D,1,1,14262,3180803,5796208,7147,2103661,3334366
2020-03-29,2020,181,D,1,1,14062,3194865,5796208,7361,2111022,3334366
2020-03-30,2020,182,D,1,1,13988,3208853,5796208,6874,2117896,3334366
2020-03-31,2020,183,D,1,1,14142,3222995,5796208,7305,2125201,3334366
2020-04-01,2020,184,D,1,1,14664,3237659,5796208,9742,2134943,3334366
2020-04-02,2020,185,D,1,1,14733,3252392,5796208,9563,2144506,3334366
2020-04-03,2020,186,D,1,1,14354,3266746,5796208,8381,2152887,3334366
2020-04-04,2020,187,D,1,1,14349,3281095,5796208,9220,2162107,3334366
2020-04-05,2020,188,D,1,1,17216,3298311,5796208,16179,2178286,3334366
2020-04-06,2020,189,D,1,1,22799,3321110,5796208,21745,2200031,3334366
2020-04-07,2020,190,D,1,1,23960,3345070,5796208,22910,2222941,3334366
2020-04-08,2020,191,D,1,1,23032,3368102,5796208,21872,2244813,3334366
2020-04-09,2020,192,D,1,1,20804,3388906,5796208,18676,2263489,3334366
2020-04-10,2020,193,D,1,1,19122,3408028,5796208,14938,2278427,3334366
2020-04-11,2020,194,D,1,1,17804,3425832,5796208,13624,2292051,3334366
2020-04-12,2020,195,D,1,1,16961,3442793,5796208,12781,2304832,3334366
2020-04-13,2020,196,D,1,1,16456,3459249,5796208,12417,2317249,3334366
2020-04-14,2020,197,D,1,1,15994,3475243,5796208,12054,2329303,3334366
2020-04-15,2020,198,D,1,1,15279,3490522,5796208,11308,2340611,3334366
2020-04-16,2020,199,D,1,1,14088,3504610,5796208,10039,2350650,3334366
2020-04-17,2020,200,D,1,1,13192,3517802,5796208,9448,2360098,3334366
2020-04-18,2020,201,D,1,1,13402,3531204,5796208,9838,2369936,3334366
2020-04-19,2020,202,D,1,1,13773,3544977,5796208,10016,2379952,3334366
2020-04-20,2020,203,D,1,1,13677,3558654,5796208,9308,2389260,3334366
2020-04-21,2020,204,D,1,1,12962,3571616,5796208,8183,2397443,3334366
2020-04-22,2020,205,D,1,1,12265,3583881,5796208,7923,2405366,3334366
2020-04-23,2020,206,D,1,1,11888,3595769,5796208,7924,2413290,3334366
2020-04-24,2020,207,D,1,1,11705,3607474,5796208,7865,2421155,3334366
2020-04-25,2020,208,D,1,1,11621,3619095,5796208,7772,2428927,3334366
2020-04-26,2020,209,D,1,1,11692,3630787,5796208,7739,2436666,3334366
2020-04-27,2020,210,D,1,1,12190,3642977,5796208,8136,2444802,3334366
2020-04-28,2020,211,D,1,1,11846,3654823,5796208,7673,2452475,3334366
2020-04-29,2020,212,D,1,1,11706,3666529,5796208,7120,2459595,3334366
2020-04-30,2020,213,D,1,1,11532,3678061,5796208,7114,2466709,3334366
2020-05-01,2020,214,D,1,1,11165,3689226,5796208,7160,2473869,3334366
2020-05-02,2020,215,D,1,1,10849,3700075,5796208,7067,2480936,3334366
2020-05-03,2020,216,D,1,1,11357,3711432,5796208,7617,2488553,3334366
2020-05-04,2020,217,D,1,1,11575,3723007,5796208,7389,2495942,3334366
2020-05-05,2020,218,D,1,1,10969,3733976,5796208,6406,2502348,3334366
2020-05-06,2020,219,D,1,1,11049,3745025,5796208,6905,2509253,3334366
2020-05-07,2020,220,D,1,1,10605,3755630,5796208,6742,2515995,3334366
2020-05-08,2020,221,D,1,1,10320,3765950,5796208,6518,2522513,3334366
2020-05-09,2020,222,D,1,1,10246,3776196,5796208,6351,2528864,3334366
2020-05-10,2020,223,D,1,1,10424,3786620,5796208,6532,2535396,3334366
2020-05-11,2020,224,D,1,1,11089,3797709,5796208,7040,2542436,3334366
2020-05-12,2020,225,D,1,1,11643,3809352,5796208,7609,2550045,3334366
2020-05-13,2020,226,D,1,1,12754,3822106,5796208,8760,2558805,3334366
2020-05-14,2020,227,D,1,1,13534,3835640,5796208,9503,2568308,3334366
2020-05-15,2020,228,D,1,1,13731,3849371,5796208,9683,2577991,3334366
2020-05-16,2020,229,D,1,1,13891,3863262,5796208,9807,2587798,3334366
2020-05-17,2020,230,D,1,1,14441,3877703,5796208,11588,2599386,3334366
2020-05-18,2020,231,D,1,1,15645,3893348,5796208,12780,2612166,3334366
2020-05-19,2020,232,D,1,1,16611,3909959,5796208,13120,2625286,3334366
2020-05-20,2020,233,D,1,1,17634,3927593,5796208,14169,2639455,3334366
2020-05-21,2020,234,D,1,1,18395,3945988,5796208,14865,2654320,3334366
2020-05-22,2020,235,D,1,1,17723,3963711,5796208,13427,2667747,3334366
2020-05-23,2020,236,D,1,1,16309,3980020,5796208,11970,2679717,3334366
2020-05-24,2020,237,D,1,1,15059,3995079,5796208,10621,2690338,3334366
2020-05-25,2020,238,D,1,1,13820,4008899,5796208,9347,2699685,3334366
2020-05-26,2020,239,D,1,1,12784,4021683,5796208,8337,2708022,3334366
2020-05-27,2020,240,D,1,1,11976,4033659,5796208,7486,2715508,3334366
2020-05-28,2020,241,D,1,1,11621,4045280,5796208,7073,2722581,3334366
2020-05-29,2020,242,D,1,1,11893,4057173,5796208,7306,2729887,3334366
2020-05-30,2020,243,D,1,1,12859,4070032,5796208,8432,2738319,3334366
2020-05-31,2020,244,D,1,1,13550,4083582,5796208,9062,2747381,3334366
2020-06-01,2020,245,D,1,1,14155,4097737,5796208,9650,2757031,3334366
2020-06-02,2020,246,D,1,1,14645,4112382,5796208,10063,2767094,3334366
2020-06-03,2020,247,D,1,1,14815,4127197,5796208,9278,2776372,3334366
2020-06-04,2020,248,D,1,1,14371,4141568,5796208,7765,2784137,3334366
2020-06-05,2020,249,D,1,1,13747,4155315,5796208,7339,2791476,3334366
2020-06-06,2020,250,D,1,1,13978,4169293,5796208,6444,2797920,3334366
2020-06-07,2020,251,D,1,1,14121,4183414,5796208,7299,2805219,3334366
2020-06-08,2020,252,D,1,1,13810,4197224,5796208,6924,2812143,3334366
2020-06-09,2020,253,D,1,1,13446,4210670,5796208,6656,2818799,3334366
2020-06-10,2020,254,D,1,1,13497,4224167,5796208,6749,2825548,3334366
2020-06-11,2020,255,D,1,1,13567,4237734,5796208,6802,2832350,3334366
2020-06-12,2020,256,D,1,1,13497,4251231,5796208,6723,2839073,3334366
2020-06-13,2020,257,D,1,1,13911,4265142,5796208,7042,2846115,3334366
2020-06-14,2020,258,D,1,1,14105,4279247,5796208,7172,2853287,3334366
2020-06-15,2020,259,D,1,1,14165,4293412,5796208,7009,2860296,3334366
2020-06-16,2020,260,D,1,1,14866,4308278,5796208,7676,2867972,3334366
2020-06-17,2020,261,D,1,1,15185,4323463,5796208,7096,2875068,3334366
2020-06-18,2020,262,D,1,1,15062,4338525,5796208,6382,2881450,3334366
2020-06-19,2020,263,D,1,1,14794,4353319,5796208,6569,2888019,3334366
2020-06-20,2020,264,D,1,1,14708,4368027,5796208,6627,2894646,3334366
2020-06-21,2020,265,D,1,1,14600,4382627,5796208,6451,2901097,3334366
2020-06-22,2020,266,D,1,1,14177,4396804,5796208,6430,2907527,3334366
2020-06-23,2020,267,D,1,1,14128,4410932,5796208,6556,2914083,3334366
2020-06-24,2020,268,D,1,1,14385,4425317,5796208,6847,2920930,3334366
2020-06-25,2020,269,D,1,1,14319,4439636,5796208,6558,2927488,3334366
2020-06-26,2020,270,D,1,1,14099,4453735,5796208,6441,2933929,3334366
2020-06-27,2020,271,D,1,1,13734,4467469,5796208,6449,2940378,3334366
2020-06-28,2020,272,D,1,1,14092,4481561,5796208,6962,2947340,3334366
2020-06-29,2020,273,D,1,1,14315,4495876,5796208,7318,2954658,3334366
2020-06-30,2020,274,D,1,1,13874,4509750,5796208,5971,2960629,3334366
2020-07-01,2020,275,D,1,1,13610,4523360,5796208,4118,2964747,3334366
2020-07-02,2020,276,D,1,1,13947,4537307,5796208,5143,2969890,3334366
2020-07-03,2020,277,D,1,1,14551,4551858,5796208,5672,2975562,3334366
2020-07-04,2020,278,D,1,1,14437,4566295,5796208,4561,2980123,3334366
2020-07-05,2020,279,D,1,1,14282,4580577,5796208,4350,2984473,3334366
2020-07-06,2020,280,D,1,1,14421,4594998,5796208,5610,2990083,3334366
2020-07-07,2020,281,D,1,1,14822,4609820,5796208,5882,2995965,3334366
2020-07-08,2020,282,D,1,1,14896,4624716,5796208,4690,3000655,3334366
2020-07-09,2020,283,D,1,1,14888,4639604,5796208,4583,3005238,3334366
2020-07-10,2020,284,D,1,1,14995,4654599,5796208,4583,3009821,3334366
2020-07-11,2020,285,D,1,1,15050,4669649,5796208,4613,3014434,3334366
2020-07-12,2020,286,D,1,1,15103,4684752,5796208,4662,3019096,3334366
2020-07-13,2020,287,D,1,1,15278,4700030,5796208,4759,3023855,3334366
2020-07-14,2020,288,D,1,1,15472,4715502,5796208,4669,3028524,3334366
2020-07-15,2020,289,D,1,1,15630,4731132,5796208,4534,3033058,3334366
2020-07-16,2020,290,D,1,1,15927,4747059,5796208,4862,3037920,3334366
2020-07-17,2020,291,D,1,1,16102,4763161,5796208,4627,3042547,3334366
2020-07-18,2020,292,D,1,1,16240,4779401,5796208,4053,3046600,3334366
2020-07-19,2020,293,D,1,1,16455,4795856,5796208,3991,3050591,3334366
2020-07-20,2020,294,D,1,1,16838,4812694,5796208,4412,3055003,3334366
2020-07-21,2020,295,D,1,1,16772,4829466,5796208,4126,3059129,3334366
2020-07-22,2020,296,D,1,1,16594,4846060,5796208,3663,3062792,3334366
2020-07-23,2020,297,D,1,1,16454,4862514,5796208,4426,3067218,3334366
2020-07-24,2020,298,D,1,1,16154,4878668,5796208,3811,3071029,3334366
2020-07-25,2020,299,D,1,1,15387,4894055,5796208,4298,3075327,3334366
2020-07-26,2020,300,D,1,1,14695,4908750,5796208,3588,3078915,3334366
2020-07-27,2020,301,D,1,1,14049,4922799,5796208,4800,3083715,3334366
2020-07-28,2020,302,D,1,1,13718,4936517,5796208,4980,3088695,3334366
2020-07-29,2020,303,D,1,1,13641,4950158,5796208,4919,3093614,3334366
2020-07-30,2020,304,D,1,1,13705,4963863,5796208,4056,3097670,3334366
2020-07-31,2020,305,D,1,1,13421,4977284,5796208,3284,3100954,3334366
2020-08-01,2020,306,D,1,1,13309,4990593,5796208,2974,3103928,3334366
2020-08-02,2020,307,D,1,1,13468,5004061,5796208,3189,3107117,3334366
2020-08-03,2020,308,D,1,1,13428,5017489,5796208,3934,3111051,3334366
2020-08-04,2020,309,D,1,1,13221,5030710,5796208,4160,3115211,3334366
2020-08-05,2020,310,D,1,1,13223,5043933,5796208,3120,3118331,3334366
2020-08-06,2020,311,D,1,1,13231,5057164,5796208,2994,3121325,3334366
2020-08-07,2020,312,D,1,1,13125,5070289,5796208,3044,3124369,3334366
2020-08-08,2020,313,D,1,1,13141,5083430,5796208,2917,3127286,3334366
2020-08-09,2020,314,D,1,1,13210,5096640,5796208,3246,3130532,3334366
2020-08-10,2020,315,D,1,1,12953,5109593,5796208,2991,3133523,3334366
2020-08-11,2020,316,D,1,1,12686,5122279,5796208,2799,3136322,3334366
2020-08-12,2020,317,D,1,1,12670,5134949,5796208,2731,3139053,3334366
2020-08-13,2020,318,D,1,1,12889,5147838,5796208,3316,3142369,3334366
2020-08-14,2020,319,D,1,1,13120,5160958,5796208,3428,3145797,3334366
2020-08-15,2020,320,D,1,1,13211,5174169,5796208,3217,3149014,3334366
2020-08-16,2020,321,D,1,1,13353,5187522,5796208,3434,3152448,3334366
2020-08-17,2020,322,D,1,1,13884,5201406,5796208,3753,3156201,3334366
2020-08-18,2020,323,D,1,1,13975,5215381,5796208,3631,3159832,3334366
2020-08-19,2020,324,D,1,1,14413,5229794,5796208,3518,3163350,3334366
2020-08-20,2020,325,D,1,1,15525,5245319,5796208,4278,3167628,3334366
2020-08-21,2020,326,D,1,1,16617,5261936,5796208,4642,3172270,3334366
2020-08-22,2020,327,D,1,1,17152,5279088,5796208,3618,3175888,3334366
2020-08-23,2020,328,D,1,1,17213,5296301,5796208,3740,3179628,3334366
2020-08-24,2020,329,D,1,1,16885,5313186,5796208,3458,3183086,3334366
2020-08-25,2020,330,D,1,1,16572,5329758,5796208,3181,3186267,3334366
2020-08-26,2020,331,D,1,1,16120,5345878,5796208,2722,3188989,3334366
2020-08-27,2020,332,D,1,1,15938,5361816,5796208,3164,3192153,3334366
2020-08-28,2020,333,D,1,1,15453,5377269,5796208,3541,3195694,3334366
2020-08-29,2020,334,D,1,1,15231,5392500,5796208,3591,3199285,3334366
2020-08-30,2020,335,D,1,1,14996,5407496,5796208,3704,3202989,3334366
2020-08-31,2020,336,D,1,1,14501,5421997,5796208,3229,3206218,3334366
2020-09-01,2020,337,D,1,1,14085,5436082,5796208,4156,3210374,3334366
2020-09-02,2020,338,D,1,1,14016,5450098,5796208,5633,3216007,3334366
2020-09-03,2020,339,D,1,1,13799,5463897,5796208,4572,3220579,3334366
2020-09-04,2020,340,D,1,1,13667,5477564,5796208,4695,3225274,3334366
2020-09-05,2020,341,D,1,1,13499,5491063,5796208,6243,3231517,3334366
2020-09-06,2020,342,D,1,1,13397,5504460,5796208,6211,3237728,3334366
2020-09-07,2020,343,D,1,1,13261,5517721,5796208,6947,3244675,3334366
2020-09-08,2020,344,D,1,1,13070,5530791,5796208,6745,3251420,3334366
2020-09-09,2020,345,D,1,1,13126,5543917,5796208,5092,3256512,3334366
2020-09-10,2020,346,D,1,1,13203,5557120,5796208,5266,3261778,3334366
2020-09-11,2020,347,D,1,1,12977,5570097,5796208,4844,3266622,3334366
2020-09-12,2020,348,D,1,1,12894,5582991,5796208,4721,3271343,3334366
2020-09-13,2020,349,D,1,1,13025,5596016,5796208,4857,3276200,3334366
2020-09-14,2020,350,D,1,1,13223,5609239,5796208,5140,3281340,3334366
2020-09-15,2020,351,D,1,1,13127,5622366,5796208,4538,3285878,3334366
2020-09-16,2020,352,D,1,1,12730,5635096,5796208,3658,3289536,3334366
2020-09-17,2020,353,D,1,1,12139,5647235,5796208,3127,3292663,3334366
2020-09-18,2020,354,D,1,1,12071,5659306,5796208,3253,3295916,3334366
2020-09-19,2020,355,D,1,1,12271,5671577,5796208,3483,3299399,3334366
2020-09-20,2020,356,D,1,1,12016,5683593,5796208,3269,3302668,3334366
2020-09-21,2020,357,D,1,1,11527,5695120,5796208,3931,3306599,3334366
2020-09-22,2020,358,D,1,1,11235,5706355,5796208,4558,3311157,3334366
2020-09-23,2020,359,D,1,1,11043,5717398,5796208,2657,3313814,3334366
2020-09-24,2020,360,D,1,1,10826,5728224,5796208,2480,3316294,3334366
2020-09-25,2020,361,D,1,1,11125,5739349,5796208,2819,3319113,3334366
2020-09-26,2020,362,D,1,1,11442,5750791,5796208,3154,3322267,3334366
2020-09-27,2020,363,D,1,1,11461,5762252,5796208,3507,3325774,3334366
2020-09-28,2020,364,D,1,1,11453,5773705,5796208,3504,3329278,3334366
2020-09-29,2020,365,D,1,1,11193,5784898,5796208,2559,3331837,3334366
2020-09-30,2020,366,D,1,1,11310,5796208,5796208,2529,3334366,3334366
2020-10-01,2021,1,D,2,2,11276,11276,3559988,4271,4271,2071421
2020-10-02,2021,2,D,2,2,11094,22370,3559988,3529,7800,2071421
2020-10-03,2021,3,D,2,2,10899,33269,3559988,3592,11392,2071421
2020-10-04,2021,4,D,2,2,10778,44047,3559988,3482,14874,2071421
2020-10-05,2021,5,D,2,2,10681,54728,3559988,3488,18362,2071421
2020-10-06,2021,6,D,2,2,10364,65092,3559988,3591,21953,2071421
2020-10-07,2021,7,D,2,2,10203,75295,3559988,4333,26286,2071421
2020-10-08,2021,8,D,2,2,10203,85498,3559988,3858,30144,2071421
2020-10-09,2021,9,D,2,2,9979,95477,3559988,4113,34257,2071421
2020-10-10,2021,10,D,2,2,9888,105365,3559988,4213,38470,2071421
2020-10-11,2021,11,D,2,2,10114,115479,3559988,4263,42733,2071421
2020-10-12,2021,12,D,2,2,9758,125237,3559988,3939,46672,2071421
2020-10-13,2021,13,D,2,2,9712,134949,3559988,3509,50181,2071421
2020-10-14,2021,14,D,2,2,9888,144837,3559988,4139,54320,2071421
2020-10-15,2021,15,D,2,2,9744,154581,3559988,3999,58319,2071421
2020-10-16,2021,16,D,2,2,9600,164181,3559988,3841,62160,2071421
2020-10-17,2021,17,D,2,2,9826,174007,3559988,4096,66256,2071421
2020-10-18,2021,18,D,2,2,10410,184417,3559988,4721,70977,2071421
2020-10-19,2021,19,D,2,2,10482,194899,3559988,4713,75690,2071421
2020-10-20,2021,20,D,2,2,10042,204941,3559988,4311,80001,2071421
2020-10-21,2021,21,D,2,2,9471,214412,3559988,4458,84459,2071421
2020-10-22,2021,22,D,2,2,9232,223644,3559988,4227,88686,2071421
2020-10-23,2021,23,D,2,2,9099,232743,3559988,4153,92839,2071421
2020-10-24,2021,24,D,2,2,9279,242022,3559988,4319,97158,2071421
2020-10-25,2021,25,D,2,2,10521,252543,3559988,5579,102737,2071421
2020-10-26,2021,26,D,2,2,10572,263115,3559988,6439,109176,2071421
2020-10-27,2021,27,D,2,2,9494,272609,3559988,4720,113896,2071421
2020-10-28,2021,28,D,2,2,9134,281743,3559988,4355,118251,2071421
2020-10-29,2021,29,D,2,2,9451,291194,3559988,5009,123260,2071421
2020-10-30,2021,30,D,2,2,9772,300966,3559988,5521,128781,2071421
2020-10-31,2021,31,D,2,2,10078,311044,3559988,5298,134079,2071421
2020-11-01,2021,32,D,2,2,10274,321318,3559988,5924,140003,2071421
2020-11-02,2021,33,D,2,2,9555,330873,3559988,5747,145750,2071421
2020-11-03,2021,34,D,2,2,9288,340161,3559988,5501,151251,2071421
2020-11-04,2021,35,D,2,2,9275,349436,3559988,5519,156770,2071421
2020-11-05,2021,36,D,2,2,9099,358535,3559988,4854,161624,2071421
2020-11-06,2021,37,D,2,2,9082,367617,3559988,4890,166514,2071421
2020-11-07,2021,38,D,2,2,9378,376995,3559988,5121,171635,2071421
2020-11-08,2021,39,D,2,2,9622,386617,3559988,6234,177869,2071421
2020-11-09,2021,40,D,2,2,9461,396078,3559988,6115,183984,2071421
2020-11-10,2021,41,D,2,2,8918,404996,3559988,5605,189589,2071421
2020-11-11,2021,42,D,2,2,9049,414045,3559988,4711,194300,2071421
2020-11-12,2021,43,D,2,2,9147,423192,3559988,4824,199124,2071421
2020-11-13,2021,44,D,2,2,9267,432459,3559988,4345,203469,2071421
2020-11-14,2021,45,D,2,2,9454,441913,3559988,5023,208492,2071421
2020-11-15,2021,46,D,2,2,9482,451395,3559988,5001,213493,2071421
2020-11-16,2021,47,D,2,2,9417,460812,3559988,4949,218442,2071421
2020-11-17,2021,48,D,2,2,9412,470224,3559988,5128,223570,2071421
2020-11-18,2021,49,D,2,2,10356,480580,3559988,5351,228921,2071421
2020-11-19,2021,50,D,2,2,10946,491526,3559988,5947,234868,2071421
2020-11-20,2021,51,D,2,2,10814,502340,3559988,5767,240635,2071421
2020-11-21,2021,52,D,2,2,10703,513043,3559988,5658,246293,2071421
2020-11-22,2021,53,D,2,2,10617,523660,3559988,4398,250691,2071421
2020-11-23,2021,54,D,2,2,10452,534112,3559988,4604,255295,2071421
2020-11-24,2021,55,D,2,2,10326,544438,3559988,4457,259752,2071421
2020-11-25,2021,56,D,2,2,10730,555168,3559988,4787,264539,2071421
2020-11-26,2021,57,D,2,2,10869,566037,3559988,4945,269484,2071421
2020-11-27,2021,58,D,2,2,10393,576430,3559988,4420,273904,2071421
2020-11-28,2021,59,D,2,2,10329,586759,3559988,4296,278200,2071421
2020-11-29,2021,60,D,2,2,10133,596892,3559988,4089,282289,2071421
2020-11-30,2021,61,D,2,2,9978,606870,3559988,3864,286153,2071421
2020-12-01,2021,62,D,2,2,9771,616641,3559988,4116,290269,2071421
2020-12-02,2021,63,D,2,2,9741,626382,3559988,4588,294857,2071421
2020-12-03,2021,64,D,2,2,9744,636126,3559988,4591,299448,2071421
2020-12-04,2021,65,D,2,2,9611,645737,3559988,4734,304182,2071421
2020-12-05,2021,66,D,2,2,9516,655253,3559988,4810,308992,2071421
2020-12-06,2021,67,D,2,2,9553,664806,3559988,5045,314037,2071421
2020-12-07,2021,68,D,2,2,9429,674235,3559988,5198,319235,2071421
2020-12-08,2021,69,D,2,2,9024,683259,3559988,5073,324308,2071421
2020-12-09,2021,70,D,2,2,9025,692284,3559988,5094,329402,2071421
2020-12-10,2021,71,D,2,2,8973,701257,3559988,4994,334396,2071421
2020-12-11,2021,72,D,2,2,9102,710359,3559988,6986,341382,2071421
2020-12-12,2021,73,D,2,2,9277,719636,3559988,7607,348989,2071421
2020-12-13,2021,74,D,2,2,9540,729176,3559988,12922,361911,2071421
2020-12-14,2021,75,D,2,2,10334,739510,3559988,13732,375643,2071421
2020-12-15,2021,76,D,2,2,10711,750221,3559988,14119,389762,2071421
2020-12-16,2021,77,D,2,2,10621,760842,3559988,12196,401958,2071421
2020-12-17,2021,78,D,2,2,10870,771712,3559988,13584,415542,2071421
2020-12-18,2021,79,D,2,2,11429,783141,3559988,8951,424493,2071421
2020-12-19,2021,80,D,2,2,11552,794693,3559988,9102,433595,2071421
2020-12-20,2021,81,D,2,2,11294,805987,3559988,8829,442424,2071421
2020-12-21,2021,82,D,2,2,11029,817016,3559988,8328,450752,2071421
2020-12-22,2021,83,D,2,2,10884,827900,3559988,6065,456817,2071421
2020-12-23,2021,84,D,2,2,10684,838584,3559988,4918,461735,2071421
2020-12-24,2021,85,D,2,2,10135,848719,3559988,3883,465618,2071421
2020-12-25,2021,86,D,2,2,9578,858297,3559988,3393,469011,2071421
2020-12-26,2021,87,D,2,2,9646,867943,3559988,3231,472242,2071421
2020-12-27,2021,88,D,2,2,9753,877696,3559988,3892,476134,2071421
2020-12-28,2021,89,D,2,2,9908,887604,3559988,4045,480179,2071421
2020-12-29,2021,90,D,2,2,10250,897854,3559988,5418,485597,2071421
2020-12-30,2021,91,D,2,2,10095,907949,3559988,6033,491630,2071421
2020-12-31,2021,92,D,2,2,10026,917975,3559988,6259,497889,2071421
2021-01-01,2021,93,D,2,2,9853,927828,3559988,6183,504072,2071421
2021-01-02,2021,94,D,2,2,9672,937500,3559988,6056,510128,2071421
2021-01-03,2021,95,D,2,2,9385,946885,3559988,5830,515958,2071421
2021-01-04,2021,96,D,2,2,9325,956210,3559988,5540,521498,2071421
2021-01-05,2021,97,D,2,2,9916,966126,3559988,5970,527468,2071421
2021-01-06,2021,98,D,2,2,10007,976133,3559988,5624,533092,2071421
2021-01-07,2021,99,D,2,2,10304,986437,3559988,5729,538821,2071421
2021-01-08,2021,100,D,2,2,10586,997023,3559988,5244,544065,2071421
2021-01-09,2021,101,D,2,2,10503,1007526,3559988,4750,548815,2071421
2021-01-10,2021,102,D,2,2,10189,1017715,3559988,5173,553988,2071421
2021-01-11,2021,103,D,2,2,10009,1027724,3559988,5004,558992,2071421
2021-01-12,2021,104,D,2,2,10016,1037740,3559988,6354,565346,2071421
2021-01-13,2021,105,D,2,2,10114,1047854,3559988,6451,571797,2071421
2021-01-14,2021,106,D,2,2,10025,1057879,3559988,6389,578186,2071421
2021-01-15,2021,107,D,2,2,9669,1067548,3559988,6046,584232,2071421
2021-01-16,2021,108,D,2,2,9599,1077147,3559988,6021,590253,2071421
2021-01-17,2021,109,D,2,2,9908,1087055,3559988,6340,596593,2071421
2021-01-18,2021,110,D,2,2,10306,1097361,3559988,6784,603377,2071421
2021-01-19,2021,111,D,2,2,9880,1107241,3559988,6356,609733,2071421
2021-01-20,2021,112,D,2,2,9042,1116283,3559988,4690,614423,2071421
2021-01-21,2021,113,D,2,2,8816,1125099,3559988,4495,618918,2071421
2021-01-22,2021,114,D,2,2,8825,1133924,3559988,5185,624103,2071421
2021-01-23,2021,115,D,2,2,8945,1142869,3559988,5364,629467,2071421
2021-01-24,2021,116,D,2,2,8749,1151618,3559988,5866,635333,2071421
2021-01-25,2021,117,D,2,2,9216,1160834,3559988,6354,641687,2071421
2021-01-26,2021,118,D,2,2,8970,1169804,3559988,6322,648009,2071421
2021-01-27,2021,119,D,2,2,10240,1180044,3559988,14066,662075,2071421
2021-01-28,2021,120,D,2,2,13881,1193925,3559988,25043,687118,2071421
2021-01-29,2021,121,D,2,2,16762,1210687,3559988,27475,714593,2071421
2021-01-30,2021,122,D,2,2,18460,1229147,3559988,29186,743779,2071421
2021-01-31,2021,123,D,2,2,19654,1248801,3559988,30212,773991,2071421
2021-02-01,2021,124,D,2,2,18540,1267341,3559988,22092,796083,2071421
2021-02-02,2021,125,D,2,2,17017,1284358,3559988,14949,811032,2071421
2021-02-03,2021,126,D,2,2,16081,1300439,3559988,13310,824342,2071421
2021-02-04,2021,127,D,2,2,16418,1316857,3559988,13418,837760,2071421
2021-02-05,2021,128,D,2,2,17308,1334165,3559988,14317,852077,2071421
2021-02-06,2021,129,D,2,2,16591,1350756,3559988,13594,865671,2071421
2021-02-07,2021,130,D,2,2,14622,1365378,3559988,9773,875444,2071421
2021-02-08,2021,131,D,2,2,13191,1378569,3559988,8350,883794,2071421
2021-02-09,2021,132,D,2,2,12695,1391264,3559988,6179,889973,2071421
2021-02-10,2021,133,D,2,2,12533,1403797,3559988,7750,897723,2071421
2021-02-11,2021,134,D,2,2,12633,1416430,3559988,10025,907748,2071421
2021-02-12,2021,135,D,2,2,13221,1429651,3559988,10315,918063,2071421
2021-02-13,2021,136,D,2,2,13297,1442948,3559988,10400,928463,2071421
2021-02-14,2021,137,D,2,2,13940,1456888,3559988,11020,939483,2071421
2021-02-15,2021,138,D,2,2,14773,1471661,3559988,11886,951369,2071421
2021-02-16,2021,139,D,2,2,15496,1487157,3559988,8605,959974,2071421
2021-02-17,2021,140,D,2,2,15383,1502540,3559988,8828,968802,2071421
2021-02-18,2021,141,D,2,2,14967,1517507,3559988,8026,976828,2071421
2021-02-19,2021,142,D,2,2,14205,1531712,3559988,7226,984054,2071421
2021-02-20,2021,143,D,2,2,13430,1545142,3559988,6484,990538,2071421
2021-02-21,2021,144,D,2,2,12988,1558130,3559988,6210,996748,2071421
2021-02-22,2021,145,D,2,2,12229,1570359,3559988,6690,1003438,2071421
2021-02-23,2021,146,D,2,2,11925,1582284,3559988,7222,1010660,2071421
2021-02-24,2021,147,D,2,2,11765,1594049,3559988,7006,1017666,2071421
2021-02-25,2021,148,D,2,2,10948,1604997,3559988,6703,1024369,2071421
2021-02-26,2021,149,D,2,2,10561,1615558,3559988,6477,1030846,2071421
2021-02-27,2021,150,D,2,2,10447,1626005,3559988,7276,1038122,2071421
2021-02-28,2021,151,D,2,2,9837,1635842,3559988,7057,1045179,2071421
2021-03-01,2021,152,D,2,2,9397,1645239,3559988,6454,1051633,2071421
2021-03-02,2021,153,D,2,2,9275,1654514,3559988,7016,1058649,2071421
2021-03-03,2021,154,D,2,2,8977,1663491,3559988,6713,1065362,2071421
2021-03-04,2021,155,D,2,2,9116,1672607,3559988,7298,1072660,2071421
2021-03-05,2021,156,D,2,2,8831,1681438,3559988,6971,1079631,2071421
2021-03-06,2021,157,D,2,2,8992,1690430,3559988,7569,1087200,2071421
2021-03-07,2021,158,D,2,2,9275,1699705,3559988,7691,1094891,2071421
2021-03-08,2021,159,D,2,2,9224,1708929,3559988,7046,1101937,2071421
2021-03-09,2021,160,D,2,2,9325,1718254,3559988,8196,1110133,2071421
2021-03-10,2021,161,D,2,2,9670,1727924,3559988,9439,1119572,2071421
2021-03-11,2021,162,D,2,2,11129,1739053,3559988,10377,1129949,2071421
2021-03-12,2021,163,D,2,2,12137,1751190,3559988,11960,1141909,2071421
2021-03-13,2021,164,D,2,2,12311,1763501,3559988,12108,1154017,2071421
2021-03-14,2021,165,D,2,2,12044,1775545,3559988,10889,1164906,2071421
2021-03-15,2021,166,D,2,2,11518,1787063,3559988,8418,1173324,2071421
2021-03-16,2021,167,D,2,2,11258,1798321,3559988,6989,1180313,2071421
2021-03-17,2021,168,D,2,2,11424,1809745,3559988,7212,1187525,2071421
2021-03-18,2021,169,D,2,2,12319,1822064,3559988,10041,1197566,2071421
2021-03-19,2021,170,D,2,2,12870,1834934,3559988,11626,1209192,2071421
2021-03-20,2021,171,D,2,2,13149,1848083,3559988,12607,1221799,2071421
2021-03-21,2021,172,D,2,2,13723,1861806,3559988,13140,1234939,2071421
2021-03-22,2021,173,D,2,2,14056,1875862,3559988,13411,1248350,2071421
2021-03-23,2021,174,D,2,2,13468,1889330,3559988,10931,1259281,2071421
2021-03-24,2021,175,D,2,2,11876,1901206,3559988,9087,1268368,2071421
2021-03-25,2021,176,D,2,2,11114,1912320,3559988,8340,1276708,2071421
2021-03-26,2021,177,D,2,2,10909,1923229,3559988,8103,1284811,2071421
2021-03-27,2021,178,D,2,2,10449,1933678,3559988,7671,1292482,2071421
2021-03-28,2021,179,D,2,2,10175,1943853,3559988,7350,1299832,2071421
2021-03-29,2021,180,D,2,2,10239,1954092,3559988,7389,1307221,2071421
2021-03-30,2021,181,D,2,2,10083,1964175,3559988,7223,1314444,2071421
2021-03-31,2021,182,D,2,2,9646,1973821,3559988,7112,1321556,2071421
2021-04-01,2021,183,D,2,2,9548,1983369,3559988,7205,1328761,2071421
2021-04-02,2021,184,D,2,2,9520,1992889,3559988,7214,1335975,2071421
2021-04-03,2021,185,D,2,2,9771,2002660,3559988,7459,1343434,2071421
2021-04-04,2021,186,D,2,2,10150,2012810,3559988,7768,1351202,2071421
2021-04-05,2021,187,D,2,2,10241,2023051,3559988,7370,1358572,2071421
2021-04-06,2021,188,D,2,2,10405,2033456,3559988,7584,1366156,2071421
2021-04-07,2021,189,D,2,2,10360,2043816,3559988,7357,1373513,2071421
2021-04-08,2021,190,D,2,2,10562,2054378,3559988,7487,1381000,2071421
2021-04-09,2021,191,D,2,2,10383,2064761,3559988,6972,1387972,2071421
2021-04-10,2021,192,D,2,2,10427,2075188,3559988,7293,1395265,2071421
2021-04-11,2021,193,D,2,2,10502,2085690,3559988,7353,1402618,2071421
2021-04-12,2021,194,D,2,2,10560,2096250,3559988,7247,1409865,2071421
2021-04-13,2021,195,D,2,2,10638,2106888,3559988,7108,1416973,2071421
2021-04-14,2021,196,D,2,2,10652,2117540,3559988,7338,1424311,2071421
2021-04-15,2021,197,D,2,2,10421,2127961,3559988,7078,1431389,2071421
2021-04-16,2021,198,D,2,2,10442,2138403,3559988,6952,1438341,2071421
2021-04-17,2021,199,D,2,2,10949,2149352,3559988,7697,1446038,2071421
2021-04-18,2021,200,D,2,2,10211,2159563,3559988,6931,1452969,2071421
2021-04-19,2021,201,D,2,2,9584,2169147,3559988,6299,1459268,2071421
2021-04-20,2021,202,D,2,2,9554,2178701,3559988,6272,1465540,2071421
2021-04-21,2021,203,D,2,2,9498,2188199,3559988,6228,1471768,2071421
2021-04-22,2021,204,D,2,2,8834,2197033,3559988,5599,1477367,2071421
2021-04-23,2021,205,D,2,2,8707,2205740,3559988,5432,1482799,2071421
2021-04-24,2021,206,D,2,2,8610,2214350,3559988,5262,1488061,2071421
2021-04-25,2021,207,D,2,2,8269,2222619,3559988,5410,1493471,2071421
2021-04-26,2021,208,D,2,2,8214,2230833,3559988,5348,1498819,2071421
2021-04-27,2021,209,D,2,2,8292,2239125,3559988,5452,1504271,2071421
2021-04-28,2021,210,D,2,2,8334,2247459,3559988,5438,1509709,2071421
2021-04-29,2021,211,D,2,2,7766,2255225,3559988,4841,1514550,2071421
2021-04-30,2021,212,D,2,2,7171,2262396,3559988,3776,1518326,2071421
2021-05-01,2021,213,D,2,2,7056,2269452,3559988,3645,1521971,2071421
2021-05-02,2021,214,D,2,2,7727,2277179,3559988,4315,1526286,2071421
2021-05-03,2021,215,D,2,2,7647,2284826,3559988,4205,1530491,2071421
2021-05-04,2021,216,D,2,2,7108,2291934,3559988,3663,1534154,2071421
2021-05-05,2021,217,D,2,2,6712,2298646,3559988,3263,1537417,2071421
2021-05-06,2021,218,D,2,2,6429,2305075,3559988,2986,1540403,2071421
2021-05-07,2021,219,D,2,2,7088,2312163,3559988,3514,1543917,2071421
2021-05-08,2021,220,D,2,2,7635,2319798,3559988,4071,1547988,2071421
2021-05-09,2021,221,D,2,2,8044,2327842,3559988,4492,1552480,2071421
2021-05-10,2021,222,D,2,2,8922,2336764,3559988,5397,1557877,2071421
2021-05-11,2021,223,D,2,2,8837,2345601,3559988,5265,1563142,2071421
2021-05-12,2021,224,D,2,2,8698,2354299,3559988,5120,1568262,2071421
2021-05-13,2021,225,D,2,2,8946,2363245,3559988,5378,1573640,2071421
2021-05-14,2021,226,D,2,2,9082,2372327,3559988,5467,1579107,2071421
2021-05-15,2021,227,D,2,2,9186,2381513,3559988,5839,1584946,2071421
2021-05-16,2021,228,D,2,2,9139,2390652,3559988,5715,1590661,2071421
2021-05-17,2021,229,D,2,2,9435,2400087,3559988,5700,1596361,2071421
2021-05-18,2021,230,D,2,2,9257,2409344,3559988,5544,1601905,2071421
2021-05-19,2021,231,D,2,2,9316,2418660,3559988,5557,1607462,2071421
2021-05-20,2021,232,D,2,2,9987,2428647,3559988,6160,1613622,2071421
2021-05-21,2021,233,D,2,2,9625,2438272,3559988,5783,1619405,2071421
2021-05-22,2021,234,D,2,2,9376,2447648,3559988,5455,1624860,2071421
2021-05-23,2021,235,D,2,2,9558,2457206,3559988,5583,1630443,2071421
2021-05-24,2021,236,D,2,2,9530,2466736,3559988,5524,1635967,2071421
2021-05-25,2021,237,D,2,2,9363,2476099,3559988,5336,1641303,2071421
2021-05-26,2021,238,D,2,2,9046,2485145,3559988,5011,1646314,2071421
2021-05-27,2021,239,D,2,2,8766,2493911,3559988,4683,1650997,2071421
2021-05-28,2021,240,D,2,2,8423,2502334,3559988,4252,1655249,2071421
2021-05-29,2021,241,D,2,2,8041,2510375,3559988,3805,1659054,2071421
2021-05-30,2021,242,D,2,2,7753,2518128,3559988,3471,1662525,2071421
2021-05-31,2021,243,D,2,2,7338,2525466,3559988,3006,1665531,2071421
2021-06-01,2021,244,D,2,2,6908,2532374,3559988,2548,1668079,2071421
2021-06-02,2021,245,D,2,2,6969,2539343,3559988,2600,1670679,2071421
2021-06-03,2021,246,D,2,2,6667,2546010,3559988,2246,1672925,2071421
2021-06-04,2021,247,D,2,2,6666,2552676,3559988,2158,1675083,2071421
2021-06-05,2021,248,D,2,2,7114,2559790,3559988,2511,1677594,2071421
2021-06-06,2021,249,D,2,2,7269,2567059,3559988,2618,1680212,2071421
2021-06-07,2021,250,D,2,2,7187,2574246,3559988,2510,1682722,2071421
2021-06-08,2021,251,D,2,2,7515,2581761,3559988,2806,1685528,2071421
2021-06-09,2021,252,D,2,2,8066,2589827,3559988,3334,1688862,2071421
2021-06-10,2021,253,D,2,2,8482,2598309,3559988,3815,1692677,2071421
2021-06-11,2021,254,D,2,2,8382,2606691,3559988,3766,1696443,2071421
2021-06-12,2021,255,D,2,2,8257,2614948,3559988,3578,1700021,2071421
2021-06-13,2021,256,D,2,2,8359,2623307,3559988,3648,1703669,2071421
2021-06-14,2021,257,D,2,2,8497,2631804,3559988,3753,1707422,2071421
2021-06-15,2021,258,D,2,2,8576,2640380,3559988,3755,1711177,2071421
2021-06-16,2021,259,D,2,2,8460,2648840,3559988,3583,1714760,2071421
2021-06-17,2021,260,D,2,2,7780,2656620,3559988,2972,1717732,2071421
2021-06-18,2021,261,D,2,2,7637,2664257,3559988,2702,1720434,2071421
2021-06-19,2021,262,D,2,2,7853,2672110,3559988,2797,1723231,2071421
2021-06-20,2021,263,D,2,2,8194,2680304,3559988,3091,1726322,2071421
2021-06-21,2021,264,D,2,2,8323,2688627,3559988,3172,1729494,2071421
2021-06-22,2021,265,D,2,2,8479,2697106,3559988,3306,1732800,2071421
2021-06-23,2021,266,D,2,2,8451,2705557,3559988,3272,1736072,2071421
2021-06-24,2021,267,D,2,2,8495,2714052,3559988,3272,1739344,2071421
2021-06-25,2021,268,D,2,2,8623,2722675,3559988,3342,1742686,2071421
2021-06-26,2021,269,D,2,2,8647,2731322,3559988,3365,1746051,2071421
2021-06-27,2021,270,D,2,2,8541,2739863,3559988,3187,1749238,2071421
2021-06-28,2021,271,D,2,2,8594,2748457,3559988,3346,1752584,2071421
2021-06-29,2021,272,D,2,2,8507,2756964,3559988,3144,1755728,2071421
2021-06-30,2021,273,D,2,2,7455,2764419,3559988,2122,1757850,2071421
2021-07-01,2021,274,D,2,2,7702,2772121,3559988,2249,1760099,2071421
2021-07-02,2021,275,D,2,2,8660,2780781,3559988,3370,1763469,2071421
2021-07-03,2021,276,D,2,2,8222,2789003,3559988,2481,1765950,2071421
2021-07-04,2021,277,D,2,2,8467,2797470,3559988,3102,1769052,2071421
2021-07-05,2021,278,D,2,2,8975,2806445,3559988,3602,1772654,2071421
2021-07-06,2021,279,D,2,2,9037,2815482,3559988,3676,1776330,2071421
2021-07-07,2021,280,D,2,2,9159,2824641,3559988,3793,1780123,2071421
2021-07-08,2021,281,D,2,2,9350,2833991,3559988,3966,1784089,2071421
2021-07-09,2021,282,D,2,2,9151,2843142,3559988,3744,1787833,2071421
2021-07-10,2021,283,D,2,2,8979,2852121,3559988,3549,1791382,2071421
2021-07-11,2021,284,D,2,2,9082,2861203,3559988,3638,1795020,2071421
2021-07-12,2021,285,D,2,2,9062,2870265,3559988,3656,1798676,2071421
2021-07-13,2021,286,D,2,2,8916,2879181,3559988,3573,1802249,2071421
2021-07-14,2021,287,D,2,2,8924,2888105,3559988,3586,1805835,2071421
2021-07-15,2021,288,D,2,2,9012,2897117,3559988,3676,1809511,2071421
2021-07-16,2021,289,D,2,2,9064,2906181,3559988,3405,1812916,2071421
2021-07-17,2021,290,D,2,2,9018,2915199,3559988,3316,1816232,2071421
2021-07-18,2021,291,D,2,2,9184,2924383,3559988,3463,1819695,2071421
2021-07-19,2021,292,D,2,2,9183,2933566,3559988,3476,1823171,2071421
2021-07-20,2021,293,D,2,2,9019,2942585,3559988,3382,1826553,2071421
2021-07-21,2021,294,D,2,2,9041,2951626,3559988,3430,1829983,2071421
2021-07-22,2021,295,D,2,2,9238,2960864,3559988,3604,1833587,2071421
2021-07-23,2021,296,D,2,2,9274,2970138,3559988,3608,1837195,2071421
2021-07-24,2021,297,D,2,2,9062,2979200,3559988,3391,1840586,2071421
2021-07-25,2021,298,D,2,2,9103,2988303,3559988,3437,1844023,2071421
2021-07-26,2021,299,D,2,2,9395,2997698,3559988,3756,1847779,2071421
2021-07-27,2021,300,D,2,2,9686,3007384,3559988,4046,1851825,2071421
2021-07-28,2021,301,D,2,2,9056,3016440,3559988,3449,1855274,2071421
2021-07-29,2021,302,D,2,2,8902,3025342,3559988,3306,1858580,2071421
2021-07-30,2021,303,D,2,2,8792,3034134,3559988,3213,1861793,2071421
2021-07-31,2021,304,D,2,2,8634,3042768,3559988,3080,1864873,2071421
2021-08-01,2021,305,D,2,2,8676,3051444,3559988,3173,1868046,2071421
2021-08-02,2021,306,D,2,2,8775,3060219,3559988,3281,1871327,2071421
2021-08-03,2021,307,D,2,2,8702,3068921,3559988,3306,1874633,2071421
2021-08-04,2021,308,D,2,2,8584,3077505,3559988,3168,1877801,2071421
2021-08-05,2021,309,D,2,2,8836,3086341,3559988,3489,1881290,2071421
2021-08-06,2021,310,D,2,2,8972,3095313,3559988,3612,1884902,2071421
2021-08-07,2021,311,D,2,2,8848,3104161,3559988,3555,1888457,2071421
2021-08-08,2021,312,D,2,2,8855,3113016,3559988,3171,1891628,2071421
2021-08-09,2021,313,D,2,2,8844,3121860,3559988,3957,1895585,2071421
2021-08-10,2021,314,D,2,2,8825,3130685,3559988,3652,1899237,2071421
2021-08-11,2021,315,D,2,2,8787,3139472,3559988,3717,1902954,2071421
2021-08-12,2021,316,D,2,2,8803,3148275,3559988,3698,1906652,2071421
2021-08-13,2021,317,D,2,2,8887,3157162,3559988,3776,1910428,2071421
2021-08-14,2021,318,D,2,2,8753,3165915,3559988,3678,1914106,2071421
2021-08-15,2021,319,D,2,2,8511,3174426,3559988,3444,1917550,2071421
2021-08-16,2021,320,D,2,2,8682,3183108,3559988,3660,1921210,2071421
2021-08-17,2021,321,D,2,2,8896,3192004,3559988,3829,1925039,2071421
2021-08-18,2021,322,D,2,2,9024,3201028,3559988,4036,1929075,2071421
2021-08-19,2021,323,D,2,2,9079,3210107,3559988,4147,1933222,2071421
2021-08-20,2021,324,D,2,2,8917,3219024,3559988,3828,1937050,2071421
2021-08-21,2021,325,D,2,2,8922,3227946,3559988,3817,1940867,2071421
2021-08-22,2021,326,D,2,2,8956,3236902,3559988,3950,1944817,2071421
2021-08-23,2021,327,D,2,2,8843,3245745,3559988,3829,1948646,2071421
2021-08-24,2021,328,D,2,2,8892,3254637,3559988,3904,1952550,2071421
2021-08-25,2021,329,D,2,2,8787,3263424,3559988,3856,1956406,2071421
2021-08-26,2021,330,D,2,2,8841,3272265,3559988,3992,1960398,2071421
2021-08-27,2021,331,D,2,2,8729,3280994,3559988,4033,1964431,2071421
2021-08-28,2021,332,D,2,2,8302,3289296,3559988,3742,1968173,2071421
2021-08-29,2021,333,D,2,2,8104,3297400,3559988,3611,1971784,2071421
2021-08-30,2021,334,D,2,2,7997,3305397,3559988,3537,1975321,2071421
2021-08-31,2021,335,D,2,2,7927,3313324,3559988,3495,1978816,2071421
2021-09-01,2021,336,D,2,2,8002,3321326,3559988,2931,1981747,2071421
2021-09-02,2021,337,D,2,2,8374,3329700,3559988,3095,1984842,2071421
2021-09-03,2021,338,D,2,2,8500,3338200,3559988,3331,1988173,2071421
2021-09-04,2021,339,D,2,2,8596,3346796,3559988,3416,1991589,2071421
2021-09-05,2021,340,D,2,2,8688,3355484,3559988,3611,1995200,2071421
2021-09-06,2021,341,D,2,2,8589,3364073,3559988,3575,1998775,2071421
2021-09-07,2021,342,D,2,2,8290,3372363,3559988,3339,2002114,2071421
2021-09-08,2021,343,D,2,2,8113,3380476,3559988,3244,2005358,2071421
2021-09-09,2021,344,D,2,2,8125,3388601,3559988,3254,2008612,2071421
2021-09-10,2021,345,D,2,2,8406,3397007,3559988,3893,2012505,2071421
2021-09-11,2021,346,D,2,2,8375,3405382,3559988,3765,2016270,2071421
2021-09-12,2021,347,D,2,2,8281,3413663,3559988,3769,2020039,2071421
2021-09-13,2021,348,D,2,2,8223,3421886,3559988,3741,2023780,2071421
2021-09-14,2021,349,D,2,2,8129,3430015,3559988,3667,2027447,2071421
2021-09-15,2021,350,D,2,2,8127,3438142,3559988,2576,2030023,2071421
2021-09-16,2021,351,D,2,2,8271,3446413,3559988,2727,2032750,2071421
2021-09-17,2021,352,D,2,2,8380,3454793,3559988,2780,2035530,2071421
2021-09-18,2021,353,D,2,2,8435,3463228,3559988,2875,2038405,2071421
2021-09-19,2021,354,D,2,2,8656,3471884,3559988,3004,2041409,2071421
2021-09-20,2021,355,D,2,2,8465,3480349,3559988,2824,2044233,2071421
2021-09-21,2021,356,D,2,2,8166,3488515,3559988,2573,2046806,2071421
2021-09-22,2021,357,D,2,2,7965,3496480,3559988,2411,2049217,2071421
2021-09-23,2021,358,D,2,2,8039,3504519,3559988,2440,2051657,2071421
2021-09-24,2021,359,D,2,2,7909,3512428,3559988,2326,2053983,2071421
2021-09-25,2021,360,D,2,2,7825,3520253,3559988,2298,2056281,2071421
2021-09-26,2021,361,D,2,2,7796,3528049,3559988,2260,2058541,2071421
2021-09-27,2021,362,D,2,2,7803,3535852,3559988,2319,2060860,2071421
2021-09-28,2021,363,D,2,2,8129,3543981,3559988,2754,2063614,2071421
2021-09-29,2021,364,D,2,2,7999,3551980,3559988,3610,2067224,2071421
2021-09-30,2021,365,D,2,2,8008,3559988,3559988,4197,2071421,2071421
